zcta,total,crowded,not.crowded,pct.crowded,zval
ZCTA5 90011,24160,8369,15791,0.34639900662251655,270.507488673524
ZCTA5 90057,17031,6648,10383,0.39034701426809937,259.0126442508348
ZCTA5 90006,19419,6997,12422,0.36031721509861475,253.30414414559118
ZCTA5 11368,28502,8451,20051,0.2965055083853765,246.9682929812055
ZCTA5 92701,13053,5466,7587,0.41875430935417146,244.80337048729427
ZCTA5 92703,13589,5184,8405,0.3814850246522923,225.61841586839955
ZCTA5 90255,18500,5956,12544,0.32194594594594594,218.21385879869544
ZCTA5 90201,24065,6811,17254,0.28302514024516934,215.30296448358826
ZCTA5 92704,20269,5846,14423,0.2884207410331047,201.8656464019151
ZCTA5 93458,13230,4514,8716,0.3411942554799698,196.84619640777134
ZCTA5 90001,13815,4613,9202,0.3339124140427072,196.39146147208774
ZCTA5 11219,24430,6265,18165,0.25644699140401145,193.82759570619427
ZCTA5 11220,28083,6532,21551,0.2325962325962326,185.5870742348914
ZCTA5 93033,17109,4800,12309,0.28055409433631423,179.74132273965535
ZCTA5 90744,14638,4386,10252,0.29963109714441866,179.0912205596649
ZCTA5 93905,12899,4024,8875,0.31196216760989226,175.905215306076
ZCTA5 75220,14476,4283,10193,0.29586902459242886,175.58027254059678
ZCTA5 90280,23926,5652,18274,0.23622837080999748,174.42580056242792
ZCTA5 90813,17148,4555,12593,0.2656286447399114,169.0768733198594
ZCTA5 91331,23367,5414,17953,0.23169426969658063,168.5217499225635
ZCTA5 90005,16442,4421,12021,0.26888456392166404,167.88150433176173
ZCTA5 90003,17127,4493,12634,0.26233432591814093,166.57575341289657
ZCTA5 90017,10869,3464,7405,0.3187045726377772,165.38041864189924
ZCTA5 11373,30285,6116,24169,0.20194815915469705,163.06514622693152
ZCTA5 11208,32181,6329,25852,0.1966688418632112,162.82530488220777
ZCTA5 92335,24837,5438,19399,0.21894753794741717,162.57019131127686
ZCTA5 92805,19113,4511,14602,0.23601737037618375,155.73562031029758
ZCTA5 90004,21971,4841,17130,0.22033589731919348,154.04752122833972
ZCTA5 90262,15551,3892,11659,0.25027329432190853,150.362568282668
ZCTA5 90037,17334,4124,13210,0.23791392638744663,149.69945314270038
ZCTA5 07055,19672,4387,15285,0.22300732004880033,147.84894483258634
ZCTA5 91402,19476,4355,15121,0.2236085438488396,147.57716674886126
ZCTA5 90029,14018,3609,10409,0.25745470109858754,147.48745081339146
ZCTA5 92707,13931,3596,10335,0.25812935180532626,147.47188850724748
ZCTA5 95116,14407,3607,10800,0.25036440619143474,144.7870814011385
ZCTA5 90023,11519,3162,8357,0.27450299505165376,143.87171229139616
ZCTA5 92801,17826,4030,13796,0.22607427353304163,143.01827364689944
ZCTA5 90805,27034,5105,21929,0.18883628023969815,142.07546807463413
ZCTA5 90270,6679,2303,4376,0.3448120976194041,141.50724842662555
ZCTA5 90033,13236,3340,9896,0.25234209731036567,140.04357150231542
ZCTA5 10452,26126,4868,21258,0.18632779606522237,137.41430637188438
ZCTA5 10467,36732,5839,30893,0.15896221278449307,133.76938105914437
ZCTA5 90250,31978,5367,26611,0.16783413596847832,133.63587656735353
ZCTA5 10468,26338,4765,21573,0.18091730579390994,133.08765570233984
ZCTA5 91405,18009,3813,14196,0.21172746959853406,133.04362080861668
ZCTA5 91343,17850,3718,14132,0.20829131652661065,129.90197985529295
ZCTA5 90044,28160,4848,23312,0.1721590909090909,129.44077159979017
ZCTA5 92105,21777,4158,17619,0.1909353905496625,129.238148070064
ZCTA5 90650,27180,4705,22475,0.17310522442972773,128.0359257342614
ZCTA5 90221,12228,2938,9290,0.24026823683349688,127.18057098331349
ZCTA5 10457,24634,4410,20224,0.17902086547048796,127.05518773257812
ZCTA5 95122,12741,2998,9743,0.23530335138529157,126.70440880465598
ZCTA5 10458,27282,4673,22609,0.17128509640055714,126.60407214560051
ZCTA5 92376,21468,4031,17437,0.18776784050680081,125.73700713032858
ZCTA5 95076,23480,4195,19285,0.17866269165247017,123.73827581338179
ZCTA5 90015,9423,2472,6951,0.262336835402738,123.55789322974644
ZCTA5 93307,22006,4015,17991,0.18245024084340633,122.91596246584177
ZCTA5 94601,15430,3243,12187,0.2101749837977965,122.07693534855075
ZCTA5 91706,18172,3566,14606,0.1962359674224081,122.03099131657991
ZCTA5 11432,18547,3579,14968,0.1929692133498679,120.80959084468891
ZCTA5 94544,22991,4016,18975,0.17467704754034188,119.08221121105498
ZCTA5 11355,27606,4462,23144,0.16163152937767153,118.43387540956671
ZCTA5 92804,24572,4156,20416,0.1691356014976396,118.27788868179569
ZCTA5 90020,16396,3246,13150,0.19797511588192243,117.15291262498246
ZCTA5 91732,15904,3180,12724,0.1999496981891348,116.76661686213788
ZCTA5 90002,12706,2787,9919,0.21934519124822918,116.52679477106031
ZCTA5 91770,16977,3295,13682,0.19408611651057311,116.39258915306016
ZCTA5 77036,26917,4327,22590,0.16075342720213992,116.14541587114097
ZCTA5 92706,9189,2305,6884,0.250843399717053,115.8871115173459
ZCTA5 92113,13088,2821,10267,0.21554095354523228,115.84519518218038
ZCTA5 11204,23601,3952,19649,0.16745053175712893,114.47775374053138
ZCTA5 90022,17444,3296,14148,0.18894748910800274,114.20830829708912
ZCTA5 11230,30572,4594,25978,0.15026821928562084,113.58470553437097
ZCTA5 92173,7998,2086,5912,0.26081520380095025,113.07581611757155
ZCTA5 10453,27266,4268,22998,0.15653194454632144,113.0194572447516
ZCTA5 96792,12058,2632,9426,0.21827832144634268,112.86500926455035
ZCTA5 91766,17906,3313,14593,0.18502178040880152,112.7894849963268
ZCTA5 95111,15783,3061,12722,0.19394284990179306,112.12491210275451
ZCTA5 92410,12482,2660,9822,0.2131068738984137,111.6191735552667
ZCTA5 91605,15774,3041,12733,0.19278559655128694,111.28465757213752
ZCTA5 91733,11150,2484,8666,0.22278026905829595,111.1759593180149
ZCTA5 34142,6701,1859,4842,0.2774212804059096,111.06164386957846
ZCTA5 90038,11601,2527,9074,0.21782604947849324,110.43464937721687
ZCTA5 10977,16126,3001,13125,0.1860969862334119,107.79599345150861
ZCTA5 11226,36733,4933,31800,0.1342934146407862,107.47825057007013
ZCTA5 93305,10844,2371,8473,0.21864625599409812,107.24576198445918
ZCTA5 96819,12066,2509,9557,0.20793966517487153,106.5869268226472
ZCTA5 90026,25785,3934,21851,0.1525693232499515,106.36859913852082
ZCTA5 90304,6430,1748,4682,0.271850699844479,106.30860483305828
ZCTA5 78542,16670,3015,13655,0.18086382723455308,105.84166174149581
ZCTA5 90723,14452,2769,11683,0.19159977857735955,105.72654557807304
ZCTA5 85017,11584,2431,9153,0.20985842541436464,105.58477135814721
ZCTA5 91335,24085,3742,20343,0.1553664106290222,105.21641573502022
ZCTA5 10456,30774,4347,26427,0.1412556053811659,105.1669662170068
ZCTA5 90063,13675,2655,11020,0.19414990859232176,104.50352995132015
ZCTA5 94063,10092,2209,7883,0.21888624653190647,103.59443928353437
ZCTA5 78046,16145,2902,13243,0.179746051409105,103.37181975603602
ZCTA5 92509,18963,3191,15772,0.16827506196276962,103.24608920505284
ZCTA5 10472,21887,3470,18417,0.15854160003655138,102.91286308088468
ZCTA5 91744,18895,3159,15736,0.16718708653082825,102.22912740210694
ZCTA5 78574,15443,2771,12672,0.1794340477886421,100.88387205441921
ZCTA5 11214,31933,4307,27626,0.13487614693264022,100.7893720987222
ZCTA5 77081,18656,3098,15558,0.1660591766723842,100.72379389186082
ZCTA5 96797,18708,3100,15608,0.1657045114389566,100.59429916657697
ZCTA5 90019,24756,3663,21093,0.14796412990790112,100.19506837135079
ZCTA5 90220,13509,2546,10963,0.18846694796061886,100.19407151437147
ZCTA5 93927,4133,1286,2847,0.3111541253326881,99.282232822102
ZCTA5 92843,11761,2320,9441,0.1972621375733356,98.79161469517624
ZCTA5 90706,23517,3505,20012,0.1490411191903729,98.57405216276713
ZCTA5 93030,14954,2632,12322,0.17600641968704026,96.94282453410635
ZCTA5 78521,25264,3608,21656,0.142811906269791,96.66369677789196
ZCTA5 90007,11884,2286,9598,0.19235947492426791,96.33467753832834
ZCTA5 90018,16426,2764,13662,0.16826981614513575,96.08798771920846
ZCTA5 90810,9334,1980,7354,0.21212770516391685,95.99687220162002
ZCTA5 75211,21846,3264,18582,0.14940950288382313,95.31023530614453
ZCTA5 11377,31400,4086,27314,0.13012738853503183,95.26509231051493
ZCTA5 90806,12821,2366,10455,0.18454098744247718,95.13721685611041
ZCTA5 91911,24928,3528,21400,0.1415275994865212,94.89109965616424
ZCTA5 90042,20622,3135,17487,0.1520221123072447,94.68812806234246
ZCTA5 91303,9823,2012,7811,0.2048254097526214,94.4545659818573
ZCTA5 92802,11503,2192,9311,0.19055898461270973,93.70396809445
ZCTA5 93906,16920,2756,14164,0.1628841607565012,93.6263257875297
ZCTA5 90059,10628,2090,8538,0.19665035754610463,93.56183219790621
ZCTA5 78537,12137,2249,9888,0.18530114525830108,93.03036858887333
ZCTA5 93638,12275,2247,10028,0.1830549898167006,92.17383152257366
ZCTA5 85033,15952,2624,13328,0.16449348044132397,92.03903442153907
ZCTA5 11218,24866,3434,21432,0.13810021716399903,91.7674387969343
ZCTA5 78040,11731,2179,9552,0.1857471656295286,91.72978335549479
ZCTA5 91340,8870,1849,7021,0.2084554678692221,91.65708262290553
ZCTA5 76010,17389,2750,14639,0.1581459543389499,91.44037835653631
ZCTA5 90222,7985,1722,6263,0.21565435190983093,90.54182094515423
ZCTA5 91731,8085,1723,6362,0.21311069882498454,89.83508269931987
ZCTA5 94303,14004,2380,11624,0.1699514424450157,89.82824587175833
ZCTA5 94621,9602,1904,7698,0.19829202249531347,89.82572619724401
ZCTA5 92025,15760,2518,13242,0.1597715736040609,88.18691931721996
ZCTA5 92553,18331,2750,15581,0.15001909333915225,87.76549624082448
ZCTA5 93454,11695,2094,9601,0.17905087644292433,87.56177858812235
ZCTA5 93702,11894,2111,9783,0.17748444593912896,87.35357185726059
ZCTA5 85301,21934,3059,18875,0.13946384608370566,87.31065560275984
ZCTA5 20783,12148,2120,10028,0.17451432334540665,86.46087895665507
ZCTA5 91406,18126,2697,15429,0.1487917907977491,86.3544703503543
ZCTA5 77506,10954,1963,8991,0.17920394376483476,84.83150432489776
ZCTA5 08701,23877,3153,20724,0.13205176529714788,84.72644814099064
ZCTA5 10952,9031,1733,7298,0.19189458531724063,83.73303308536785
ZCTA5 92570,13944,2241,11703,0.16071428571428573,83.5697065817348
ZCTA5 11235,32269,3779,28490,0.11710929994731786,83.56955065757172
ZCTA5 11435,18874,2689,16185,0.14247112429797607,83.28923077304495
ZCTA5 91767,14099,2248,11851,0.15944393219377262,83.19405351905147
ZCTA5 95823,23359,3065,20294,0.1312128087674986,83.08929302639021
ZCTA5 92404,17722,2579,15143,0.14552533574088702,82.9684726450366
ZCTA5 95112,20316,2806,17510,0.13811773971254185,82.9616656684332
ZCTA5 11717,13694,2186,11508,0.15963195560099314,82.11281431231255
ZCTA5 85009,12338,2052,10286,0.16631544820878585,82.06986086857786
ZCTA5 11223,27958,3392,24566,0.12132484440947135,81.70709407226558
ZCTA5 91352,12474,2058,10416,0.16498316498316498,81.69345369652285
ZCTA5 08901,14893,2287,12606,0.1535620761431545,81.51275109648282
ZCTA5 91306,14510,2247,12263,0.15485871812543073,81.32639592919718
ZCTA5 89115,18309,2591,15718,0.14151510186247201,81.31372358137239
ZCTA5 92102,14592,2251,12341,0.1542626096491228,81.15542334506762
ZCTA5 92411,6430,1383,5047,0.2150855365474339,80.99520230233485
ZCTA5 90032,13470,2137,11333,0.15864884929472903,80.80394081599115
ZCTA5 90660,16666,2426,14240,0.14556582263290532,80.48765661798716
ZCTA5 11372,23814,3023,20791,0.1269421348786428,80.22960594368357
ZCTA5 78577,21609,2828,18781,0.13087139617751864,79.63718270502322
ZCTA5 92571,12406,2010,10396,0.1620183782040948,79.6340579989923
ZCTA5 95012,2482,793,1689,0.3195004029008864,79.25016006848831
ZCTA5 94015,20052,2688,17364,0.13405146618791142,79.21874551828903
ZCTA5 96706,19191,2615,16576,0.13626178938043876,79.20214024846896
ZCTA5 75231,16956,2407,14549,0.14195564991743337,78.57062276450945
ZCTA5 85035,14758,2202,12556,0.14920720964900394,78.20040583093741
ZCTA5 90031,11621,1904,9717,0.1638413217451166,78.16627784350614
ZCTA5 10034,16095,2320,13775,0.14414414414414414,78.09381017740625
ZCTA5 85008,21902,2809,19093,0.1282531275682586,78.02041083044654
ZCTA5 92840,15131,2221,12910,0.1467847465468244,77.52535382025353
ZCTA5 11211,39384,4071,35313,0.10336684948202315,77.15756493629867
ZCTA5 11232,8812,1591,7221,0.18054925102133454,76.78887536771495
ZCTA5 07087,24194,2952,21242,0.122013722410515,76.60409906099918
ZCTA5 95127,16567,2325,14242,0.14033922858694997,76.50710357028579
ZCTA5 90061,7318,1421,5897,0.1941787373599344,76.4612512666227
ZCTA5 91950,16787,2338,14449,0.1392744385536427,76.24620390659078
ZCTA5 92780,19343,2546,16797,0.1316238432507884,75.92801700248154
ZCTA5 90621,10172,1717,8455,0.16879669681478568,75.9102372581932
ZCTA5 94538,22095,2766,19329,0.1251866938221317,75.82861380963355
ZCTA5 92154,21999,2753,19246,0.12514205191145053,75.62687958071521
ZCTA5 91606,15439,2189,13250,0.14178379428719476,74.85479919903108
ZCTA5 92407,17028,2323,14705,0.1364223631665492,74.72186884998528
ZCTA5 10462,29543,3288,26255,0.11129539992553228,74.40458370857728
ZCTA5 91768,8073,1468,6605,0.181840703579834,74.14380685871176
ZCTA5 93550,21577,2673,18904,0.12388191129443389,73.86861905636455
ZCTA5 91762,17326,2326,15000,0.13424910539074222,73.78204210032825
ZCTA5 93304,15060,2126,12934,0.14116865869853917,73.51051029687564
ZCTA5 90012,12736,1914,10822,0.1502826633165829,73.32096181418991
ZCTA5 92084,14879,2100,12779,0.1411385173734794,73.04698235291666
ZCTA5 91702,15383,2136,13247,0.13885457973087173,72.69853170665981
ZCTA5 93706,11087,1745,9342,0.157391539641021,72.57251398641723
ZCTA5 11206,31042,3330,27712,0.10727401584949424,72.32870038872697
ZCTA5 78520,17963,2344,15619,0.13049045259700495,72.32465617117546
ZCTA5 94014,14028,2006,12022,0.14299971485600227,72.15317246170667
ZCTA5 94901,15679,2140,13539,0.1364882964474775,71.74689094599407
ZCTA5 94603,9901,1614,8287,0.163013836986163,71.69225396899799
ZCTA5 93036,12879,1887,10992,0.1465175867691591,71.35526440787378
ZCTA5 78541,12817,1877,10940,0.14644612623858938,71.13831303001137
ZCTA5 93203,5345,1111,4234,0.2078578110383536,70.90752911422622
ZCTA5 92083,11290,1732,9558,0.15341009743135517,70.88127872246719
ZCTA5 86021,809,389,420,0.48084054388133496,70.765256251378
ZCTA5 78570,9060,1506,7554,0.16622516556291392,70.279748443272
ZCTA5 92683,27536,3017,24519,0.10956565950029053,70.23657768145209
ZCTA5 11237,16740,2191,14549,0.13088410991636798,70.1024110682355
ZCTA5 92405,8862,1482,7380,0.16723087339201084,70.03405164993261
ZCTA5 94108,7833,1373,6460,0.175284054640623,69.80631573335057
ZCTA5 94112,23266,2692,20574,0.11570532106937162,69.76949421272035
ZCTA5 90640,19290,2384,16906,0.12358735095904613,69.61672313063302
ZCTA5 10032,21222,2527,18695,0.11907454528319668,69.36382389537431
ZCTA5 94102,17841,2257,15584,0.12650636175102292,69.11924418450063
ZCTA5 90602,7769,1355,6414,0.17441112112240958,69.0926676452112
ZCTA5 92114,17994,2267,15727,0.12598643992441924,69.02713512561215
ZCTA5 10460,20443,2455,17988,0.12009000635914494,68.88626470137754
ZCTA5 95035,22688,2620,20068,0.11547954866008463,68.70828016042265
ZCTA5 93705,12109,1764,10345,0.1456767693451152,68.67478423164356
ZCTA5 95351,13330,1867,11463,0.14006001500375093,68.44770886174403
ZCTA5 33161,15904,2084,13820,0.13103621730382295,68.43620257550567
ZCTA5 10950,12596,1802,10794,0.1430612892981899,68.40973728542875
ZCTA5 91342,25033,2783,22250,0.11117325130827307,68.38278936049112
ZCTA5 10454,13167,1848,11319,0.14035087719298245,68.21353718145662
ZCTA5 91910,24999,2775,22224,0.1110044401776071,68.18790326587828
ZCTA5 93204,2299,663,1636,0.28838625489343195,67.9762176028737
ZCTA5 96817,19225,2337,16888,0.12156046814044213,67.93645556533522
ZCTA5 77015,17306,2184,15122,0.12619900612504334,67.85015804100945
ZCTA5 94520,13531,1870,11661,0.13820116768901042,67.75936839600678
ZCTA5 90605,10388,1586,8802,0.15267616480554486,67.5748690573402
ZCTA5 93257,21804,2519,19285,0.11552926068611263,67.39725138171241
ZCTA5 91304,17225,2163,15062,0.1255732946298984,67.23450175637798
ZCTA5 11550,16451,2101,14350,0.12771260105768648,67.23248125751253
ZCTA5 90247,15886,2055,13831,0.12935918418733475,67.22199248588059
ZCTA5 94541,21713,2502,19211,0.11523050706949754,67.0116475692402
ZCTA5 95205,10855,1613,9242,0.1485951174573929,66.71255297658385
ZCTA5 92503,25016,2734,22282,0.10929005436520627,66.70315600157633
ZCTA5 92027,16363,2080,14283,0.12711605451323107,66.62805510468152
ZCTA5 91748,13492,1841,11651,0.1364512303587311,66.53126922798131
ZCTA5 10033,19652,2334,17318,0.1187665377569713,66.50864755383046
ZCTA5 91801,19721,2337,17384,0.11850311850311851,66.41958492625135
ZCTA5 90065,15337,1991,13346,0.12981678294320922,66.36537705043665
ZCTA5 07093,24319,2664,21655,0.10954397795962005,65.98755526698716
ZCTA5 91746,6676,1192,5484,0.17855002995805871,65.928940206248285
ZCTA5 60632,24918,2704,22214,0.1085159322578056,65.89281103232865
ZCTA5 90303,7144,1239,5905,0.17343225083986563,65.79511629482906
ZCTA5 93725,6666,1188,5478,0.1782178217821782,65.72870773905858
ZCTA5 90631,21332,2435,18897,0.11414775923495218,65.54167572803875
ZCTA5 92530,14959,1941,13018,0.12975466274483588,65.50019302392151
ZCTA5 96732,7648,1284,6364,0.16788702928870292,65.37960109044937
ZCTA5 93241,4150,895,3255,0.21566265060240963,65.276309537802
ZCTA5 91764,16129,2019,14110,0.1251782503565007,64.78132978640863
ZCTA5 90301,12136,1689,10447,0.13917270929466052,64.76669846257788
ZCTA5 85706,17097,2078,15019,0.12154179095747791,64.05272235622238
ZCTA5 92301,8077,1305,6772,0.16156988981057324,64.03100829846255
ZCTA5 93703,9889,1467,8422,0.14834664779047427,63.53757442072784
ZCTA5 75042,11483,1598,9885,0.1391622398327963,62.99392174982999
ZCTA5 78753,20121,2279,17842,0.11326474827294866,62.95756949675719
ZCTA5 11210,22267,2434,19833,0.10930974087214264,62.947868464119814
ZCTA5 77074,13181,1739,11442,0.13193232683407935,62.87483941958702
ZCTA5 11369,10294,1490,8804,0.14474451136584418,62.79316796855464
ZCTA5 90260,10509,1509,9000,0.14359120753639737,62.78803924734439
ZCTA5 93640,2847,696,2151,0.24446786090621708,62.613409259486225
ZCTA5 94536,24517,2581,21936,0.10527389158543052,62.5374326531151
ZCTA5 94565,27947,2808,25139,0.10047590081225176,62.308295329523105
ZCTA5 75243,27936,2807,25129,0.10047966781214204,62.2995331754204
ZCTA5 78586,15758,1933,13825,0.12266785125015865,62.279450093095726
ZCTA5 78573,9920,1444,8476,0.14556451612903226,62.0961063767239
ZCTA5 99559,2252,605,1647,0.26865008880994673,62.06931825869489
ZCTA5 90680,8659,1324,7335,0.15290449243561613,61.8136024949653
ZCTA5 96761,7590,1222,6368,0.16100131752305666,61.79516774748643
ZCTA5 89030,13742,1759,11983,0.12800174647067383,61.6365264626852
ZCTA5 90501,14244,1796,12448,0.12608817747823645,61.48217325502807
ZCTA5 93722,24718,2565,22153,0.10377053159640748,61.478846713889915
ZCTA5 85349,8133,1266,6867,0.15566211729988935,61.289728970028655
ZCTA5 90745,15139,1862,13277,0.12299359270757645,61.266863402315984
ZCTA5 85040,10007,1436,8571,0.14349955031477965,61.21905194222341
ZCTA5 93306,22240,2383,19857,0.10714928057553957,61.11794537114946
ZCTA5 93930,4255,858,3397,0.20164512338425383,61.012013398777434
ZCTA5 78516,9539,1386,8153,0.14529824929237867,60.747339503945646
ZCTA5 10040,16181,1928,14253,0.11915209195970583,60.62276144998877
ZCTA5 90062,9905,1412,8493,0.1425542655224634,60.38307173957925
ZCTA5 92627,22180,2353,19827,0.10608656447249774,60.15528732766789
ZCTA5 93960,4081,826,3255,0.20240137221269297,60.020173277746686
ZCTA5 95110,6377,1075,5302,0.16857456484240238,60.00563091291669
ZCTA5 94806,19773,2177,17596,0.11009963080968999,59.935677723332894
ZCTA5 10455,14401,1771,12630,0.12297757100201374,59.744187638031846
ZCTA5 94578,14538,1781,12757,0.12250653459898198,59.711852962008834
ZCTA5 76106,10292,1433,8859,0.13923435678196658,59.6783819696841
ZCTA5 94606,15201,1829,13372,0.1203210315110848,59.55976298977677
ZCTA5 94587,21484,2281,19203,0.10617203500279278,59.27360814728215
ZCTA5 77060,13837,1708,12129,0.12343716123437161,58.8632396660728
ZCTA5 07306,20216,2181,18035,0.1078848436881678,58.852138539789266
ZCTA5 33162,12927,1635,11292,0.1264794615920167,58.81833021849775
ZCTA5 90016,17087,1953,15134,0.11429741909053666,58.76779421044183
ZCTA5 90242,12203,1570,10633,0.12865688765057773,58.485126937231755
ZCTA5 90716,3809,775,3034,0.20346547650301916,58.35072221772715
ZCTA5 77099,17046,1937,15109,0.11363369705502757,58.21534153996233
ZCTA5 95341,8365,1237,7128,0.1478780633592349,58.1986002764334
ZCTA5 96795,2352,586,1766,0.24914965986394558,58.1731673493151
ZCTA5 92324,18075,2003,16072,0.11081604426002767,57.84007371029664
ZCTA5 11691,20594,2178,18416,0.10575895892007381,57.703225157687854
ZCTA5 94133,12995,1606,11389,0.12358599461331281,57.13853087882028
ZCTA5 92507,16763,1889,14874,0.11268865954781364,57.04963225503322
ZCTA5 78582,10702,1419,9283,0.13259203887123902,57.0341340194031
ZCTA5 78076,4049,788,3261,0.19461595455668065,57.029411439439414
ZCTA5 93618,8074,1190,6884,0.14738667327223184,56.93179238799696
ZCTA5 75240,10194,1374,8820,0.1347851677457328,56.89543742627928
ZCTA5 91401,15132,1764,13368,0.11657414750198256,56.86123864788083
ZCTA5 48126,12851,1586,11265,0.12341452027079605,56.71296638409528
ZCTA5 78043,12402,1549,10853,0.12489920980487018,56.63289819037098
ZCTA5 77087,11089,1442,9647,0.13003877716656145,56.56097666116181
ZCTA5 77013,5937,980,4957,0.16506653191847734,56.39532359396583
ZCTA5 85031,7906,1166,6740,0.14748292436124463,56.383967261850884
ZCTA5 60623,25005,2433,22572,0.0973005398920216,56.14515002217736
ZCTA5 90802,20749,2148,18601,0.10352306135235433,56.128894278286914
ZCTA5 80010,13626,1631,11995,0.11969763687068839,55.985188686693604
ZCTA5 60804,22226,2234,19992,0.10051291280482318,55.59665918901723
ZCTA5 95407,12702,1551,11151,0.1221067548417572,55.563579454787416
ZCTA5 77072,18096,1948,16148,0.10764809902740938,55.50375262163356
ZCTA5 55106,17879,1929,15950,0.1078919402651155,55.35127793022723
ZCTA5 92231,8825,1229,7596,0.13926345609065155,55.276936086837026
ZCTA5 97233,13546,1604,11942,0.11841133914070574,54.988048890464626
ZCTA5 33030,9011,1240,7771,0.1376095882809899,54.98334769763214
ZCTA5 92841,9559,1285,8274,0.13442828747776964,54.900854353827526
ZCTA5 34116,9620,1289,8331,0.13399168399168399,54.83760546811959
ZCTA5 89110,20835,2120,18715,0.1017518598512119,54.8233297295251
ZCTA5 95838,11083,1406,9677,0.12686095822430749,54.68520999344873
ZCTA5 33126,18026,1921,16105,0.1065682902474204,54.59006582548359
ZCTA5 85006,9251,1249,8002,0.13501243108853098,54.32158140276798
ZCTA5 92020,19156,1991,17165,0.10393610357068281,54.24914306602117
ZCTA5 91321,11045,1393,9652,0.12612041647804437,54.15857233032445
ZCTA5 93436,17978,1904,16074,0.10590721993547669,54.024409875666215
ZCTA5 11207,33240,2882,30358,0.08670276774969916,53.98849028631171
ZCTA5 95210,11805,1447,10358,0.122575180008471,53.84877847189288
ZCTA5 10469,22450,2193,20257,0.0976837416481069,53.518731235936585
ZCTA5 75217,23629,2265,21364,0.09585678615260908,53.34430527603295
ZCTA5 78550,16638,1793,14845,0.10776535641303041,53.304937514774615
ZCTA5 92243,12945,1523,11422,0.11765160293549633,53.273669982954374
ZCTA5 11229,30946,2717,28229,0.08779809991598268,53.16377548170592
ZCTA5 91761,17028,1815,15213,0.1065891472868217,53.072510017036564
ZCTA5 78852,15970,1738,14232,0.10882905447714465,52.97144347940034
ZCTA5 99349,2085,503,1582,0.24124700239808153,52.765076731599976
ZCTA5 99344,4910,829,4081,0.16883910386965376,52.756257088295
ZCTA5 78572,24134,2279,21855,0.09443109306372752,52.67963316883017
ZCTA5 92806,12380,1464,10916,0.11825525040387722,52.47161708899427
ZCTA5 92505,13517,1548,11969,0.11452245320707258,52.414790599100876
ZCTA5 92844,6715,996,5719,0.1483246463142219,52.34729896089986
ZCTA5 99723,1345,389,956,0.2892193308550186,52.16335801351694
ZCTA5 76119,14423,1607,12816,0.11141926090272482,52.0703739489505
ZCTA5 33125,20893,2052,18841,0.09821471306179103,52.0563242924764
ZCTA5 92021,22463,2153,20310,0.09584650313849441,52.002916343808906
ZCTA5 57770,1151,355,796,0.30842745438748914,51.87895086300696
ZCTA5 95134,11419,1378,10041,0.12067606620544706,51.83251865554242
ZCTA5 90606,8893,1176,7717,0.13223883953671428,51.80557470813145
ZCTA5 93434,2014,484,1530,0.24031777557100298,51.62698984066374
ZCTA5 95051,21161,2056,19105,0.09715986957138131,51.535796090303585
ZCTA5 57772,470,216,254,0.4595744680851064,51.37409891149899
ZCTA5 93117,15977,1702,14275,0.1065281341929023,51.365670475812685
ZCTA5 94085,8361,1123,7238,0.13431407726348524,51.28737622116135
ZCTA5 10451,19123,1910,17213,0.09987972598441668,51.082934671794334
ZCTA5 93280,6251,935,5316,0.14957606782914734,51.056580541355864
ZCTA5 10466,23704,2205,21499,0.09302227472156598,51.00199570750265
ZCTA5 96793,10125,1260,8865,0.12444444444444444,50.91611508449107
ZCTA5 93101,12842,1467,11375,0.11423454290608939,50.90786774099952
ZCTA5 11213,25027,2285,22742,0.09130139449394654,50.891994869453725
ZCTA5 11354,20112,1966,18146,0.09775258552108194,50.70963825039108
ZCTA5 95824,8925,1159,7766,0.12985994397759104,50.64889185115226
ZCTA5 90804,15066,1621,13445,0.10759325633877605,50.60680198774177
ZCTA5 93955,10606,1286,9320,0.12125212144069394,50.28320471839371
ZCTA5 85015,14885,1600,13285,0.10749076251259658,50.23235319955535
ZCTA5 93727,24224,2216,22008,0.09147952443857331,50.22307321633661
ZCTA5 11418,10938,1310,9628,0.11976595355640884,50.19977823061751
ZCTA5 89502,18527,1844,16683,0.09953041506989799,50.01618143550239
ZCTA5 10002,33540,2769,30771,0.08255813953488372,50.01042856478672
ZCTA5 60505,21665,2048,19617,0.09453034848834525,49.99352796746178
ZCTA5 11419,12479,1416,11063,0.11347063065950798,49.70864746046055
ZCTA5 93215,11937,1375,10562,0.11518807070453213,49.66066701477583
ZCTA5 75060,14003,1525,12478,0.1089052345925873,49.652212668471186
ZCTA5 11374,19416,1890,17526,0.09734239802224968,49.506626380814254
ZCTA5 33023,20500,1960,18540,0.09560975609756098,49.4902547539665
ZCTA5 95206,17277,1745,15532,0.10100133124963825,49.374635861702686
ZCTA5 93219,2520,530,1990,0.21031746031746032,49.3742967688951
ZCTA5 86040,3226,612,2614,0.18970861748295104,49.35458401600454
ZCTA5 98901,10370,1248,9122,0.12034715525554485,49.20812834928541
ZCTA5 91763,10281,1241,9040,0.12070810232467659,49.20003827028506
ZCTA5 96707,13211,1458,11753,0.11036257664067822,49.15914936511191
ZCTA5 94560,13677,1490,12187,0.10894201944870952,49.094762935829294
ZCTA5 93926,2315,502,1813,0.21684665226781857,49.07044380903545
ZCTA5 92394,8025,1057,6968,0.13171339563862927,48.95067156136867
ZCTA5 93274,21580,2014,19566,0.0933271547729379,48.91242566705575
ZCTA5 75061,17381,1741,15640,0.10016684885794834,48.9112081790213
ZCTA5 99301,23461,2131,21330,0.09083159285622949,48.87388292490844
ZCTA5 92868,8016,1054,6962,0.1314870259481038,48.81050544982464
ZCTA5 91411,9689,1187,8502,0.1225100629579936,48.74890903191918
ZCTA5 10459,16382,1668,14714,0.10181906971065804,48.66080453101182
ZCTA5 77080,15243,1588,13655,0.10417896739486977,48.558984607315566
ZCTA5 94533,23867,2147,21720,0.08995684417815393,48.54342967055472
ZCTA5 92408,3713,656,3057,0.1766765418798815,48.53290004442262
ZCTA5 98944,6218,895,5323,0.14393695722097138,48.44877673213117
ZCTA5 11209,29297,2471,26826,0.0843431068027443,48.439251437561126
ZCTA5 77092,14105,1504,12601,0.10662885501595179,48.32925308041993
ZCTA5 91205,14294,1516,12778,0.10605848607807472,48.27274554442401
ZCTA5 90241,13542,1462,12080,0.10796041943582928,48.21662317373757
ZCTA5 78744,14857,1552,13305,0.10446254290906644,48.13242967397722
ZCTA5 20737,5954,864,5090,0.14511252939200536,47.913566166643115
ZCTA5 91803,9671,1168,8503,0.12077344638610278,47.75386994699939
ZCTA5 78724,6458,905,5553,0.14013626509755342,47.67639186258602
ZCTA5 92240,11952,1335,10617,0.11169678714859438,47.56925697758866
ZCTA5 93223,2760,541,2219,0.19601449275362318,47.493265254347676
ZCTA5 91387,13240,1425,11815,0.10762839879154079,47.463495022954866
ZCTA5 77587,4615,732,3883,0.15861321776814735,47.283647926956164
ZCTA5 93263,5516,815,4701,0.1477519941986947,47.20771042729544
ZCTA5 72764,18281,1758,16523,0.09616541764673706,47.152857155069576
ZCTA5 90710,9162,1116,8046,0.12180746561886051,47.030614634107224
ZCTA5 02128,16399,1631,14768,0.09945728398073053,47.00409916540002
ZCTA5 94801,9263,1123,8140,0.1212350210514952,46.98274355864376
ZCTA5 94401,12459,1359,11100,0.10907777510233566,46.9420078311937
ZCTA5 93701,3376,603,2773,0.1786137440758294,46.903992754945875
ZCTA5 11205,16294,1620,14674,0.09942310052780165,46.829112196277634
ZCTA5 92705,14711,1512,13199,0.10278023247909727,46.760622294262646
ZCTA5 78501,20913,1915,18998,0.09156983694352795,46.73733546039745
ZCTA5 84784,336,165,171,0.49107142857142855,46.64822312919518
ZCTA5 07501,10559,1215,9344,0.11506771474571456,46.63761802183419
ZCTA5 92234,17951,1724,16227,0.0960392178708707,46.63129848216466
ZCTA5 55130,5440,800,4640,0.14705882352941177,46.597049182881236
ZCTA5 92831,12407,1348,11059,0.10864834367695655,46.57793937203578
ZCTA5 78576,2717,527,2190,0.19396393080603608,46.527444457150445
ZCTA5 75180,6202,866,5336,0.13963237665269268,46.501192416445605
ZCTA5 94804,14419,1486,12933,0.10305846452597267,46.48001495669892
ZCTA5 95240,16319,1610,14709,0.09865800600526993,46.321491680078076
ZCTA5 92833,16375,1613,14762,0.09850381679389313,46.29117607478039
ZCTA5 75229,10935,1234,9701,0.11284865112025606,46.1702707847419
ZCTA5 07202,12999,1379,11620,0.10608508346795907,46.051009074149945
ZCTA5 20903,7409,960,6449,0.12957214198947226,46.00946519232904
ZCTA5 77502,10803,1221,9582,0.1130241599555679,45.99220225293395
ZCTA5 94110,27736,2302,25434,0.08299682722815115,45.88425264068948
ZCTA5 75040,18460,1736,16724,0.09404117009750812,45.77811188089901
ZCTA5 92832,8209,1020,7189,0.12425386770617615,45.750126394980114
ZCTA5 92618,17258,1655,15603,0.09589755475721405,45.61884272905303
ZCTA5 91601,16809,1623,15186,0.09655541674103159,45.49581819539043
ZCTA5 93635,11353,1249,10104,0.11001497401567868,45.365374634376515
ZCTA5 75062,16126,1575,14551,0.09766836165199057,45.347876816476614
ZCTA5 90731,22624,1982,20642,0.08760608203677511,45.296120001815666
ZCTA5 85043,9813,1135,8678,0.11566289615815754,45.28783361279796
ZCTA5 99604,209,124,85,0.5933014354066986,45.00966597936589
ZCTA5 33168,6701,884,5817,0.13192060886434862,44.825055689284504
ZCTA5 91776,11455,1245,10210,0.10868616324749018,44.77780538315207
ZCTA5 95133,8648,1038,7610,0.1200277520814061,44.77194659174651
ZCTA5 91754,11109,1220,9889,0.10982086596453326,44.76145349358329
ZCTA5 10463,28682,2321,26361,0.08092183250819329,44.70591447151543
ZCTA5 90604,12295,1300,10995,0.10573403822692151,44.57016985568749
ZCTA5 91204,6327,849,5478,0.13418681839734473,44.55864489218992
ZCTA5 10474,3488,589,2899,0.16886467889908258,44.473724473986394
ZCTA5 77034,12371,1303,11068,0.10532697437555573,44.455926116458855
ZCTA5 86045,3062,544,2518,0.17766165904637493,44.376527613879155
ZCTA5 95358,8973,1055,7918,0.11757494706341245,44.31337696286967
ZCTA5 78741,21474,1883,19591,0.08768743596907888,44.19618115319736
ZCTA5 93630,5341,759,4582,0.1421082194345628,44.15908193046823
ZCTA5 84606,10391,1156,9235,0.11125012029641035,44.10099285130541
ZCTA5 78596,18821,1716,17105,0.09117475160724722,44.03668271367711
ZCTA5 99769,211,122,89,0.5781990521327014,44.00453847583434
ZCTA5 78503,6390,843,5547,0.13192488262910798,43.77441060620806
ZCTA5 89101,14622,1439,13183,0.09841334974695665,43.68240478016862
ZCTA5 90034,25878,2128,23750,0.08223201174743025,43.63654682434622
ZCTA5 93234,1852,399,1453,0.21544276457883368,43.55395722257485
ZCTA5 11104,11619,1231,10388,0.10594715552112918,43.45532813685895
ZCTA5 33150,9733,1096,8637,0.11260659611630536,43.42604765726928
ZCTA5 10031,21959,1888,20071,0.08597841431759187,43.28411909616968
ZCTA5 92316,7575,930,6645,0.12277227722772277,43.23083174234799
ZCTA5 75051,12798,1302,11496,0.10173464603844351,42.95663323162059
ZCTA5 84116,10974,1176,9798,0.10716238381629306,42.93990157905419
ZCTA5 90013,6966,877,6089,0.12589721504450185,42.90705945814166
ZCTA5 10029,31690,2430,29260,0.07668034080151467,42.79275377145698
ZCTA5 75235,7853,944,6909,0.12020883738698586,42.75366971360004
ZCTA5 78526,12619,1283,11336,0.10167208178144069,42.61608336903774
ZCTA5 96717,1309,321,988,0.2452253628724217,42.60883801918328
ZCTA5 85041,17015,1567,15448,0.0920952101087276,42.538306982147866
ZCTA5 30093,17976,1626,16350,0.09045393858477971,42.49933796543563
ZCTA5 94134,12044,1238,10806,0.10278977084025241,42.315970631242664
ZCTA5 22041,10798,1150,9648,0.10650120392665309,42.212096586811214
ZCTA5 95215,6795,852,5943,0.12538631346578366,42.14294575082331
ZCTA5 91103,8500,983,7517,0.11564705882352941,42.141155111545395
ZCTA5 85714,5242,723,4519,0.13792445631438383,42.06337450015853
ZCTA5 89102,14711,1409,13302,0.09577866902317993,42.03804283039962
ZCTA5 76164,4379,646,3733,0.14752226535738752,41.97730064425753
ZCTA5 95660,10671,1135,9536,0.10636304001499391,41.883754170157346
ZCTA5 78752,8188,955,7233,0.11663409868099658,41.857201967108935
ZCTA5 84104,7626,912,6714,0.11959087332808813,41.83111048190779
ZCTA5 33613,14335,1378,12957,0.09612835716777118,41.730170226914986
ZCTA5 75253,6453,817,5636,0.1266077793274446,41.614367353908534
ZCTA5 77017,9953,1079,8874,0.10840952476640209,41.585540794942865
ZCTA5 78589,10768,1134,9634,0.10531203566121843,41.46718026511309
ZCTA5 11370,7993,933,7060,0.11672713624421369,41.402033721825795
ZCTA5 80219,21560,1811,19749,0.08399814471243043,41.2720684369072
ZCTA5 92115,21425,1803,19622,0.08415402567094515,41.269537883071145
ZCTA5 77012,5997,774,5223,0.12906453226613307,41.17511065719052
ZCTA5 96826,14799,1395,13404,0.09426312588688425,41.13829727162253
ZCTA5 95019,2277,429,1848,0.18840579710144928,41.11881414068059
ZCTA5 92139,10410,1102,9308,0.1058597502401537,41.082803690420036
ZCTA5 91786,19085,1659,17426,0.08692690594707886,41.08099845861058
ZCTA5 78045,18703,1630,17073,0.08715179382986686,40.83882240478217
ZCTA5 95126,14939,1397,13542,0.09351362206305643,40.82297987069117
ZCTA5 78207,15351,1420,13931,0.09250211712592013,40.68512952432133
ZCTA5 85941,2523,451,2072,0.17875544986127626,40.58737602711243
ZCTA5 93726,14130,1339,12791,0.09476291578202406,40.52808635240702
ZCTA5 85019,7512,880,6632,0.11714589989350373,40.33880884520885
ZCTA5 33135,14517,1358,13159,0.09354549838120824,40.26361983674654
ZCTA5 75212,7608,886,6722,0.11645636172450052,40.2612768850844
ZCTA5 80012,18764,1616,17148,0.08612236196972926,40.121172372068145
ZCTA5 92504,16538,1481,15057,0.08955133631636232,40.1185243849895
ZCTA5 78211,9157,996,8161,0.1087692475701649,40.079401213281024
ZCTA5 02150,13141,1265,11876,0.09626360246556578,40.04070130741836
ZCTA5 93657,10529,1090,9439,0.10352360148162218,39.983868651077074
ZCTA5 86053,550,187,363,0.34,39.97972406366381
ZCTA5 90240,7442,868,6574,0.1166353130878796,39.905471821351234
ZCTA5 85201,19560,1657,17903,0.08471370143149284,39.867732181732826
ZCTA5 92069,14927,1375,13552,0.09211495946941783,39.85627710983471
ZCTA5 93015,5064,679,4385,0.13408372827804108,39.823114241464225
ZCTA5 85203,12567,1223,11344,0.09731837351794383,39.814009474533314
ZCTA5 92655,2499,441,2058,0.17647058823529413,39.758677648491485
ZCTA5 33141,17739,1545,16194,0.08709622864874006,39.73127557682981
ZCTA5 91932,9175,991,8184,0.1080108991825613,39.7148172733179
ZCTA5 34137,114,80,34,0.7017543859649122,39.68141249561866
ZCTA5 93256,1560,334,1226,0.2141025641025641,39.67887597146404
ZCTA5 93452,277,128,149,0.4620938628158845,39.67302687334502
ZCTA5 93615,1521,329,1192,0.21630506245890863,39.65743766193707
ZCTA5 30504,8449,938,7511,0.11101905550952776,39.64884256351856
ZCTA5 93933,8838,961,7877,0.10873500792034396,39.35719445382561
ZCTA5 89431,14605,1341,13264,0.09181787059226293,39.22438638416891
ZCTA5 77443,53,53,0,1,39.131229887655216
ZCTA5 98813,828,230,598,0.2777777777777778,39.097015579958835
ZCTA5 95128,13785,1286,12499,0.09328980776206021,39.068422970162324
ZCTA5 10013,11986,1170,10816,0.09761388286334056,39.062691026927055
ZCTA5 07018,10585,1076,9509,0.10165328294756731,39.01995813206746
ZCTA5 92392,15994,1422,14572,0.08890834062773541,39.00095899728976
ZCTA5 55411,9535,1003,8532,0.10519140010487676,38.95539563210773
ZCTA5 07208,10981,1101,9880,0.10026409252344959,38.93359844896576
ZCTA5 94109,33108,2378,30730,0.07182554065482663,38.82719664342332
ZCTA5 85204,22177,1780,20397,0.08026333588853317,38.7654394575068
ZCTA5 94545,9340,986,8354,0.10556745182012849,38.75710842706752
ZCTA5 78242,8855,952,7903,0.1075098814229249,38.75390970927032
ZCTA5 33415,16516,1448,15068,0.08767255994187455,38.74909514721771
ZCTA5 94086,19461,1622,17839,0.08334617953856431,38.70579834090609
ZCTA5 96762,929,243,686,0.26157158234660927,38.66600383945568
ZCTA5 75041,9379,986,8393,0.10512847851583325,38.601523561228575
ZCTA5 11236,33282,2376,30906,0.0713899405083829,38.48715920783883
ZCTA5 93662,8496,922,7574,0.1085216572504708,38.47882651765361
ZCTA5 11228,15306,1366,13940,0.08924604730171175,38.38524872291423
ZCTA5 30721,18135,1536,16599,0.08469809760132341,38.3763497659773
ZCTA5 61820,14299,1303,12996,0.09112525351423176,38.350717518704585
ZCTA5 90028,16652,1444,15208,0.08671631035311074,38.222079904594906
ZCTA5 07502,4458,608,3850,0.1363840287124271,38.218551333986575
ZCTA5 22306,11813,1142,10671,0.09667315669178024,38.21116110581572
ZCTA5 95815,9236,969,8267,0.1049155478562148,38.19231756633129
ZCTA5 94080,21204,1709,19495,0.0805980003772873,38.17650611549928
ZCTA5 95386,2976,474,2502,0.1592741935483871,38.17060987232152
ZCTA5 93250,3733,544,3189,0.14572729708009644,38.14763813291416
ZCTA5 77547,2624,439,2185,0.16730182926829268,38.12901497077348
ZCTA5 10705,14260,1294,12966,0.09074333800841515,38.044757803568
ZCTA5 92551,7868,870,6998,0.11057447890188103,38.04202586386724
ZCTA5 94061,13894,1270,12624,0.09140636245861523,37.98796864104374
ZCTA5 99752,942,241,701,0.25583864118895966,37.95708928911529
ZCTA5 77061,8664,925,7739,0.10676361957525392,37.94738537021316
ZCTA5 85542,679,200,479,0.29455081001472755,37.83547455150699
ZCTA5 98030,11989,1145,10844,0.09550421219451163,37.78297519496897
ZCTA5 95020,18743,1557,17186,0.08307101317825322,37.775579429439105
ZCTA5 94555,11545,1115,10430,0.09657860545690775,37.718731353737
ZCTA5 93728,5781,709,5072,0.12264314132503028,37.71163836453166
ZCTA5 33127,10096,1019,9077,0.1009310618066561,37.7044297627658
ZCTA5 86020,585,183,402,0.3128205128205128,37.57638868396872
ZCTA5 99770,175,95,80,0.5428571428571428,37.475167196692425
ZCTA5 85911,430,154,276,0.3581395348837209,37.442081329380905
ZCTA5 93925,420,152,268,0.3619047619047619,37.43326738479704
ZCTA5 96813,10463,1038,9425,0.09920672847175763,37.40273773114071
ZCTA5 95334,4532,603,3929,0.13305383936451898,37.28770453365186
ZCTA5 96818,18286,1518,16768,0.08301432790112655,37.26957935048895
ZCTA5 11367,14580,1296,13284,0.08888888888888889,37.224008368908834
ZCTA5 86505,2047,371,1676,0.18124084025403028,37.18408504761207
ZCTA5 80260,11833,1123,10710,0.09490408180512128,37.17331421244646
ZCTA5 92111,16892,1433,15459,0.08483305706843476,37.13536574223722
ZCTA5 33313,19653,1592,18061,0.08100544446140538,37.071402005985874
ZCTA5 98948,3668,526,3142,0.14340239912758998,37.03102524804124
ZCTA5 10461,18927,1547,17380,0.08173508744122153,36.938464531800165
ZCTA5 77076,9816,983,8833,0.10014262428687856,36.74350289006094
ZCTA5 96766,4932,629,4303,0.1275344687753447,36.742863797432484
ZCTA5 98273,10940,1057,9883,0.09661791590493601,36.73999902828083
ZCTA5 33430,7249,805,6444,0.11104979997240999,36.73998853231111
ZCTA5 99563,215,104,111,0.48372093023255813,36.715731751557584
ZCTA5 77075,13042,1189,11853,0.091166998926545,36.65278765891117
ZCTA5 95023,15429,1334,14095,0.08646056128070516,36.61504943007695
ZCTA5 92254,2947,456,2491,0.15473362741771293,36.61340978918839
ZCTA5 79107,11349,1081,10268,0.09525068287954885,36.61047440405785
ZCTA5 10005,4374,581,3793,0.13283036122542297,36.54976066487741
ZCTA5 92345,23480,1791,21689,0.07627768313458262,36.491665200580904
ZCTA5 77093,12591,1157,11434,0.09189103327773807,36.46528109847788
ZCTA5 79701,9656,963,8693,0.09973073736536868,36.21773301734989
ZCTA5 99554,168,90,78,0.5357142857142857,36.20315435150536
ZCTA5 75223,4589,594,3995,0.12943996513401612,36.160030155912985
ZCTA5 57764,429,149,280,0.3473193473193473,36.15220724048134
ZCTA5 75038,12279,1130,11149,0.09202703803241306,36.0944599710268
ZCTA5 33014,14119,1243,12876,0.08803739641617678,36.068135146103465
ZCTA5 11706,18534,1499,17035,0.08087838566958024,35.90435728669587
ZCTA5 95380,14121,1239,12882,0.08774166135542809,35.87525628145151
ZCTA5 95050,14270,1248,13022,0.0874562018220042,35.87439586105734
ZCTA5 90014,5496,662,4834,0.12045123726346434,35.86664263832507
ZCTA5 80910,11656,1086,10570,0.09317089910775567,35.853648088648576
ZCTA5 95307,12408,1133,11275,0.09131205673758866,35.84066103234615
ZCTA5 07060,14850,1282,13568,0.08632996632996633,35.83295659037175
ZCTA5 85364,26211,1919,24292,0.07321353630155278,35.79674430539052
ZCTA5 97071,9152,921,8231,0.10063374125874126,35.74027319399646
ZCTA5 33147,14189,1240,12949,0.08739164141236169,35.72966839825794
ZCTA5 95014,21378,1654,19724,0.07736925811582,35.707517476243304
ZCTA5 86043,568,172,396,0.3028169014084507,35.70053253974492
ZCTA5 93212,4220,557,3663,0.13199052132701422,35.59717223612025
ZCTA5 87311,1054,243,811,0.23055028462998103,35.58453876070743
ZCTA5 85281,23822,1783,22039,0.07484678028712954,35.52828463103926
ZCTA5 86044,976,232,744,0.23770491803278687,35.48555018569906
ZCTA5 92201,22942,1733,21209,0.0755383140092407,35.44838584249862
ZCTA5 93060,10001,972,9029,0.09719028097190281,35.446216074823205
ZCTA5 30501,9629,947,8682,0.0983487381867276,35.41290517779824
ZCTA5 60659,13193,1172,12021,0.0888349882513454,35.37477403626225
ZCTA5 07307,15774,1325,14449,0.08399898567262584,35.30286897362913
ZCTA5 91752,8456,866,7590,0.10241248817407758,35.2640180896663
ZCTA5 90701,4602,584,4018,0.12690134724033028,35.253502615725864
ZCTA5 10801,14439,1244,13195,0.08615555093843064,35.21705590803856
ZCTA5 89106,8639,877,7762,0.10151637921055678,35.18037136618081
ZCTA5 11234,31835,2193,29642,0.06888644573582535,35.157148935172835
ZCTA5 93041,7194,776,6418,0.10786766750069503,35.09939398692262
ZCTA5 90302,10893,1023,9870,0.09391352244560727,35.091329326423214
ZCTA5 85323,12686,1135,11551,0.08946870565978243,35.08533485270258
ZCTA5 90040,3512,491,3021,0.13980637813211846,35.04988426175436
ZCTA5 77053,8613,873,7740,0.1013584117032393,35.04586366494841
ZCTA5 87420,3240,467,2773,0.1441358024691358,35.03570791436665
ZCTA5 77011,5831,676,5155,0.11593208712056251,35.02449926367818
ZCTA5 60074,14510,1243,13267,0.08566505858028946,34.97496415095299
ZCTA5 33139,20882,1607,19275,0.07695623024614501,34.95893762807053
ZCTA5 85037,14533,1242,13291,0.08546067570357119,34.86565240348267
ZCTA5 90024,16737,1371,15366,0.08191432156300413,34.86470640022395
ZCTA5 11415,8379,854,7525,0.10192147034252297,34.85314260033224
ZCTA5 94103,14841,1258,13583,0.08476517754868271,34.7619876387712
ZCTA5 90638,14462,1235,13227,0.0853962107592311,34.737268947534595
ZCTA5 99662,119,72,47,0.6050420168067226,34.67524624420139
ZCTA5 77035,14126,1213,12913,0.08587002690075039,34.644538531679565
ZCTA5 07104,18606,1471,17135,0.07906051811243685,34.59506873806306
ZCTA5 99621,153,82,71,0.5359477124183006,34.565216313382464
ZCTA5 90027,21716,1642,20074,0.07561245164855405,34.54897341147479
ZCTA5 92395,13429,1168,12261,0.08697594757614119,34.4917213744965
ZCTA5 99659,108,68,40,0.6296296296296297,34.45474677599922
ZCTA5 10701,22535,1683,20852,0.07468382516086089,34.41920183936909
ZCTA5 33137,10039,955,9084,0.09512899691204303,34.36495305537672
ZCTA5 95322,3288,464,2824,0.1411192214111922,34.33234624333168
ZCTA5 55454,3401,473,2928,0.13907674213466628,34.25491358499421
ZCTA5 10303,8156,828,7328,0.1015203531142717,34.184768822634155
ZCTA5 07047,21900,1641,20259,0.07493150684931507,34.13463297481762
ZCTA5 92346,17265,1384,15881,0.08016217781639154,34.130059471183145
ZCTA5 94066,14807,1241,13566,0.08381171067738231,34.07693401802949
ZCTA5 55407,14791,1239,13552,0.08376715570279224,34.02838369293303
ZCTA5 93648,4299,545,3754,0.12677366829495232,34.02662664375903
ZCTA5 07503,5322,624,4698,0.11724915445321307,33.99524659860913
ZCTA5 99762,1431,279,1152,0.1949685534591195,33.977698219047596
ZCTA5 20010,12621,1108,11513,0.08779019095158862,33.94667387236136
ZCTA5 92879,14384,1213,13171,0.08432981090100111,33.932214239219526
ZCTA5 95301,11611,1045,10566,0.09000086125226078,33.88477047990901
ZCTA5 91722,9880,936,8944,0.09473684210526316,33.874956859510775
ZCTA5 76111,6641,718,5923,0.10811624755307936,33.8360373987689
ZCTA5 95828,17762,1405,16357,0.07910145253912848,33.83165578815328
ZCTA5 86503,3142,446,2696,0.14194780394653086,33.81973310437412
ZCTA5 77982,289,113,176,0.39100346020761245,33.802427697484454
ZCTA5 89433,6781,727,6054,0.10721132576316178,33.77642753989612
ZCTA5 95401,13505,1157,12348,0.08567197334320623,33.74647226126543
ZCTA5 85634,1626,299,1327,0.1838868388683887,33.73380649210581
ZCTA5 78416,5091,603,4488,0.11844431349440189,33.72351639900112
ZCTA5 79927,11119,1011,10108,0.09092544293551579,33.70126705743502
ZCTA5 99650,122,71,51,0.5819672131147541,33.69224568648061
ZCTA5 92227,7043,744,6299,0.10563680249893512,33.68792261448109
ZCTA5 11433,10519,973,9546,0.0924992870044681,33.677029607823634
ZCTA5 94704,7998,807,7191,0.10090022505626407,33.54361686748575
ZCTA5 77086,8025,807,7218,0.1005607476635514,33.43106756607554
ZCTA5 93309,21718,1610,20108,0.07413205635878073,33.33731304562454
ZCTA5 86047,4100,521,3579,0.12707317073170732,33.336400787699915
ZCTA5 33144,9175,881,8294,0.09602179836512262,33.32846609855924
ZCTA5 85042,14525,1208,13317,0.08316695352839931,33.31874276222774
ZCTA5 96701,13209,1130,12079,0.08554773260655614,33.29519134456564
ZCTA5 93247,5246,609,4637,0.1160884483415936,33.28412252500068
ZCTA5 08401,15272,1249,14023,0.08178365636458879,33.21410631753087
ZCTA5 86515,1301,258,1043,0.19830899308224442,33.067643291825455
ZCTA5 07201,8557,836,7721,0.09769779128199135,33.04862461170321
ZCTA5 67846,11492,1021,10471,0.08884441350504699,33.02125752507797
ZCTA5 33311,22430,1639,20791,0.07307177886758805,32.99629473616929
ZCTA5 92543,12833,1101,11732,0.08579443621912257,32.9733075421887
ZCTA5 78584,4955,583,4372,0.11765893037336024,32.96258113099636
ZCTA5 11385,35126,2286,32840,0.06507999772248477,32.96236066145438
ZCTA5 98951,3564,473,3091,0.13271604938271606,32.95445559159317
ZCTA5 92336,24524,1748,22776,0.07127711629424237,32.93921507580564
ZCTA5 08861,16665,1321,15344,0.07926792679267927,32.88977936199668
ZCTA5 99641,124,70,54,0.5645161290322581,32.88661076508854
ZCTA5 91790,12217,1058,11159,0.08660063845461242,32.667748021383176
ZCTA5 90249,8784,844,7940,0.09608378870673953,32.64288449459812
ZCTA5 33015,21075,1553,19522,0.07368920521945432,32.4825763736836
ZCTA5 99561,86,57,29,0.6627906976744186,32.45601965960292
ZCTA5 99632,167,81,86,0.48502994011976047,32.45278240109921
ZCTA5 85210,14558,1191,13367,0.08181068828135733,32.446534325818085
ZCTA5 90715,5994,652,5342,0.10877544210877545,32.429384450922065
ZCTA5 78221,11535,1011,10524,0.08764629388816644,32.36737525849032
ZCTA5 92028,16575,1303,15272,0.07861236802413273,32.331492738737616
ZCTA5 57752,392,128,264,0.32653061224489793,32.269109002721756
ZCTA5 99655,165,80,85,0.48484848484848486,32.24490695171847
ZCTA5 33460,11310,994,10316,0.0878868258178603,32.19239894615604
ZCTA5 85021,15941,1264,14677,0.07929239069067186,32.184586039707185
ZCTA5 76115,5847,638,5209,0.10911578587309731,32.17398469097886
ZCTA5 93647,2889,407,2482,0.1408791969539633,32.11013036212362
ZCTA5 55117,16066,1269,14797,0.07898667994522594,32.09503568292793
ZCTA5 92126,25221,1760,23461,0.06978311724356687,32.08456552316452
ZCTA5 85051,14978,1206,13772,0.08051809320336493,32.03151314507053
ZCTA5 94104,272,104,168,0.38235294117647056,31.999776158375518
ZCTA5 22311,7907,775,7132,0.0980144176046541,31.92520320477463
ZCTA5 95388,3968,494,3474,0.12449596774193548,31.892563239888684
ZCTA5 07522,6074,650,5424,0.10701350016463615,31.88143334683252
ZCTA5 94580,8917,839,8078,0.09408994056296961,31.84203850985877
ZCTA5 87375,744,181,563,0.24327956989247312,31.827865219706872
ZCTA5 11221,30871,2038,28833,0.066016649930355345,31.816683721320643
ZCTA5 91780,11173,978,10195,0.0875324442853307,31.788514508563924
ZCTA5 77503,7910,773,7137,0.097724399494311,31.787816953445617
ZCTA5 93543,3711,472,3239,0.1271894368094853,31.754938554565477
ZCTA5 36513,252,99,153,0.39285714285714285,31.7281673036717
ZCTA5 60639,25570,1767,23803,0.0691044192412984,31.702252093114716
ZCTA5 91755,8783,828,7955,0.0942730274393715,31.69730064795559
ZCTA5 98930,4677,546,4131,0.11674150096215523,31.675637435604074
ZCTA5 33172,13687,1124,12563,0.08212172134141886,31.663292181610686
ZCTA5 01902,17247,1324,15923,0.07676697396648692,31.632639586269754
ZCTA5 92274,4980,568,4412,0.1140562248995984,31.631770799634825
ZCTA5 98198,13838,1131,12707,0.08173146408440526,31.582173622454714
ZCTA5 77583,9146,848,8298,0.09271812814345069,31.518737861690603
ZCTA5 78723,13000,1081,11919,0.08315384615384615,31.51285048302164
ZCTA5 60085,22747,1613,21134,0.07091044972963467,31.415858400579957
ZCTA5 99750,117,65,52,0.5555555555555556,31.405872114849206
ZCTA5 68039,301,108,193,0.3588039867109635,31.390400414133435
ZCTA5 73109,6998,706,6292,0.10088596741926265,31.369987194201048
ZCTA5 07206,7844,762,7082,0.0971443141254462,31.369213522476667
ZCTA5 11225,24105,1682,22423,0.06977805434557145,31.36231053495627
ZCTA5 89107,12575,1053,11522,0.0837375745526839,31.357478538896473
ZCTA5 11416,7217,720,6497,0.09976444506027435,31.32721658443162
ZCTA5 77530,9249,851,8398,0.0920099470212996,31.316967154875016
ZCTA5 20005,8137,779,7358,0.09573552906476589,31.243007484979813
ZCTA5 96737,1656,284,1372,0.17149758454106281,31.239836843112442
ZCTA5 89512,10218,909,9309,0.08896065766294774,31.202487834570952
ZCTA5 99609,105,61,44,0.580952380952381,31.198983057705046
ZCTA5 30021,7192,716,6476,0.09955506117908787,31.174161432496323
ZCTA5 96814,10179,906,9273,0.08900677866195107,31.168761202830403
ZCTA5 95315,3636,459,3177,0.12623762376237624,31.113240625107604
ZCTA5 77901,14697,1169,13528,0.07954004218548003,31.070236400079754
ZCTA5 75227,17672,1333,16339,0.07543005885015844,31.03166505073993
ZCTA5 95376,15783,1229,14554,0.07786859278971045,31.029956875764285
ZCTA5 77055,15178,1194,13984,0.07866649097377784,30.976080297030638
ZCTA5 07524,4050,489,3561,0.12074074074074075,30.891407442311884
ZCTA5 11375,32857,2106,30751,0.06409593085187328,30.887993358789736
ZCTA5 87052,554,149,405,0.26895306859205775,30.825261080981402
ZCTA5 22204,22396,1578,20818,0.070459010537596,30.796827644752458
ZCTA5 79763,11703,988,10715,0.08442279757327181,30.662955533936135
ZCTA5 92647,21363,1520,19843,0.07115105556335721,30.640710006722923
ZCTA5 95605,4925,551,4374,0.11187817258883248,30.60658178264413
ZCTA5 60651,19653,1428,18225,0.07266066249427568,30.56572394175557
ZCTA5 97301,18286,1354,16932,0.0740457180356557,30.525112295040866
ZCTA5 96822,18253,1351,16902,0.07401523037308935,30.474649871669737
ZCTA5 75224,10994,942,10052,0.08568309987265782,30.454500539953095
ZCTA5 98002,13132,1066,12066,0.08117575388364301,30.411841031828335
ZCTA5 85705,23656,1632,22024,0.06898884004058167,30.393808328785816
ZCTA5 92371,5187,567,4620,0.10931174089068826,30.382237100468434
ZCTA5 99343,829,185,644,0.22316043425814233,30.375392804573025
ZCTA5 96021,5693,602,5091,0.10574389601264711,30.332614188569785
ZCTA5 34956,2153,325,1828,0.15095215977705528,30.31903018606141
ZCTA5 99508,12330,1017,11313,0.08248175182481751,30.275021194979665
ZCTA5 11420,13159,1064,12095,0.08085720799452846,30.23987834374043
ZCTA5 91792,8655,795,7860,0.09185441941074524,30.214178816271517
ZCTA5 99551,133,67,66,0.5037593984962406,30.16259490666399
ZCTA5 10035,14428,1134,13294,0.07859717216523426,30.154760847538356
ZCTA5 11233,29345,1910,27435,0.0650877491906628,30.13543382471706
ZCTA5 33405,7021,688,6333,0.09799173906850876,30.072857934495506
ZCTA5 22044,5320,572,4748,0.10751879699248121,30.04203433298525
ZCTA5 78557,3523,438,3085,0.12432585864320182,29.99491863145154
ZCTA5 77067,10187,885,9302,0.086875429468931,29.984704836210142
ZCTA5 44062,3940,470,3470,0.11928934010152284,29.962367661579048
ZCTA5 60160,7695,730,6965,0.09486679662118258,29.958810836604798
ZCTA5 89156,9455,840,8615,0.088841882601798,29.950682391902035
ZCTA5 95131,9528,844,8684,0.08858102434928632,29.92447968805157
ZCTA5 77088,17396,1291,16105,0.07421246263508853,29.895304712237024
ZCTA5 90021,1758,284,1474,0.161547212741752,29.86743008106468
ZCTA5 68107,9277,826,8451,0.0890374043332974,29.772144619296594
ZCTA5 77083,22434,1551,20883,0.06913613265579031,29.7210585735256
ZCTA5 33461,14912,1151,13761,0.07718615879828326,29.698159470993115
ZCTA5 95121,9709,851,8858,0.087650633432897307,29.69755598515804
ZCTA5 33142,18983,1370,17613,0.07216983616920403,29.664116459050785
ZCTA5 98168,11459,954,10505,0.08325333798760799,29.6454400909528
ZCTA5 75228,25797,1719,24078,0.06663565530875683,29.637565927866934
ZCTA5 93313,13981,1097,12884,0.07846362921107217,29.59615508715939
ZCTA5 85550,1160,220,940,0.1896551724137931,29.585283680616318
ZCTA5 60139,11451,952,10499,0.08313684394376036,29.56576514053245
ZCTA5 98032,13674,1079,12595,0.07890887816293696,29.558953253179308
ZCTA5 93230,21799,1513,20286,0.06940685352539107,29.51968958376782
ZCTA5 33010,15108,1157,13951,0.07658194334127615,29.479687311583316
ZCTA5 89020,422,123,299,0.2914691943127962,29.475707286546758
ZCTA5 96704,2610,358,2252,0.1371647509578544,29.46497898858175
ZCTA5 78595,1707,276,1431,0.1616871704745167,29.46316808465017
ZCTA5 33138,12447,1007,11440,0.08090302884229132,29.438829464723465
ZCTA5 86507,560,144,416,0.2571428571428571,29.437506971569114
ZCTA5 93704,11302,940,10362,0.08317112015572466,29.39304536699869
ZCTA5 75050,14690,1132,13558,0.07705922396187882,29.390710376336855
ZCTA5 10573,12489,1008,11481,0.0807110257026183,29.369129399100554
ZCTA5 60645,16255,1217,15038,0.07486927099354045,29.363953445111964
ZCTA5 98932,1342,238,1104,0.17734724292101342,29.31426793434029
ZCTA5 97236,13181,1046,12135,0.07935664972308626,29.30709175201392
ZCTA5 33935,6229,624,5605,0.10017659335366833,29.28489071636791
ZCTA5 78538,3091,396,2695,0.12811387900355872,29.266949003008648
ZCTA5 92311,11416,944,10472,0.08269096005606166,29.255610088841983
ZCTA5 60133,11219,932,10287,0.08307335769676442,29.227332282355192
ZCTA5 99552,81,50,31,0.6172839506172839,29.220782513662247
ZCTA5 11106,16992,1253,15739,0.07374058380414313,29.20405454225779
ZCTA5 33012,23929,1612,22317,0.06736595762463955,29.17259680650362
ZCTA5 94124,11041,919,10122,0.08323521420161217,29.089125278873553
ZCTA5 92602,8735,781,7954,0.08941041785918717,29.083225542904422
ZCTA5 99620,158,71,87,0.44936708860759494,29.073279137032998
ZCTA5 84120,13643,1067,12576,0.07820860514549585,29.070559942864648
ZCTA5 73119,9631,835,8796,0.08669920049839061,29.058772950280616
ZCTA5 98188,8925,792,8133,0.08873949579831933,29.045343007111246
ZCTA5 79849,3352,414,2938,0.12350835322195704,28.99470277718848
ZCTA5 77045,10475,883,9592,0.08429594272076373,28.9374441492418
ZCTA5 87305,1001,198,803,0.1978021978021978,28.91641661210313
ZCTA5 60070,5790,589,5201,0.10172711571675302,28.890201158777593
ZCTA5 77091,9785,840,8945,0.0858456821665815,28.820654429779992
ZCTA5 98902,16602,1223,15379,0.07366582339477172,28.813394506110633
ZCTA5 78840,15257,1150,14107,0.07537523759585764,28.79580557115287
ZCTA5 93440,485,130,355,0.26804123711340205,28.730152767614175
ZCTA5 97113,4478,495,3983,0.11054041983028137,28.68677076833109
ZCTA5 96815,13376,1044,12332,0.07805023923444976,28.682835725979672
ZCTA5 99742,150,68,82,0.4533333333333333,28.597825898802615
ZCTA5 33130,12767,1008,11759,0.07895355212657633,28.589879053471087
ZCTA5 07011,12574,997,11577,0.07929059965007158,28.58313793499986
ZCTA5 99357,959,191,768,0.1991657977059437,28.538111215928314
ZCTA5 93901,9690,829,8861,0.08555211558307534,28.51970126568264
ZCTA5 76105,6566,635,5931,0.09671032592141335,28.504658216041488
ZCTA5 83830,168,72,96,0.42857142857142855,28.48024367978945
ZCTA5 11203,27761,1782,25979,0.0641907712258204,28.479700760170026
ZCTA5 80239,12013,963,11050,0.08016315658037126,28.470073789554554
ZCTA5 95129,13875,1067,12808,0.0769009009009009,28.460069350087974
ZCTA5 05701,9057,790,8267,0.08722535055757977,28.457992584734804
ZCTA5 66102,10406,870,9536,0.08360561214683836,28.450362017066432
ZCTA5 99679,85,50,35,0.5882352941176471,28.444232786983964
ZCTA5 90620,13091,1023,12068,0.07814529065770377,28.43609998603716
ZCTA5 94107,13961,1070,12891,0.07664207434997493,28.378062687662847
ZCTA5 91325,11748,946,10802,0.08052434456928839,28.37201580177183
ZCTA5 78580,3726,435,3291,0.11674718196457327,28.274356253195112
ZCTA5 30507,7978,721,7257,0.09037352719979945,28.272847111997546
ZCTA5 92567,2577,344,2233,0.13348855258051998,28.240300135648642
ZCTA5 92501,6706,640,6066,0.09543692215926036,28.22703239851633
ZCTA5 91345,5314,547,4767,0.10293564170116673,28.167119422204117
ZCTA5 55103,5013,526,4487,0.10492718930779972,28.141914955033524
ZCTA5 33409,11116,905,10211,0.08141417776178482,28.12004054265564
ZCTA5 50588,4381,481,3900,0.10979228486646884,28.098992829993065
ZCTA5 77022,9398,804,8594,0.08555011704618004,28.085628279719796
ZCTA5 10030,12736,996,11740,0.0782035175879397,28.084429773794092
ZCTA5 93267,1774,272,1502,0.15332581736189402,28.077351651691146
ZCTA5 94607,11300,914,10386,0.08088495575221238,28.03896392224532
ZCTA5 10012,12041,956,11085,0.07939539905323478,28.034724005153496
ZCTA5 93552,9972,837,9135,0.08393501805054152,28.033688398578626
ZCTA5 92626,19058,1333,17725,0.06994438031272956,28.01413586721897
ZCTA5 85032,27909,1775,26134,0.0635995556988785,28.006251647895482
ZCTA5 80022,14395,1085,13310,0.0753733935394234,27.969286622252575
ZCTA5 07305,22280,1496,20784,0.06714542190305206,27.966419414283568
ZCTA5 76117,10270,853,9417,0.08305744888023368,27.954907499349474
ZCTA5 90041,9724,820,8904,0.08432743726861373,27.89809671306514
ZCTA5 95202,2850,363,2487,0.12736842105263158,27.88153691953837
ZCTA5 78237,11073,898,10175,0.08109816671182155,27.880673457085145
ZCTA5 95825,15976,1168,14808,0.07310966449674512,27.87402428046079
ZCTA5 86510,1330,227,1103,0.17067669172932332,27.83005808088161
ZCTA5 93103,7608,691,6917,0.09082544689800211,27.828661266727934
ZCTA5 95403,16532,1196,15336,0.07234454391483185,27.80782861880517
ZCTA5 98938,865,176,689,0.20346820809248556,27.807105267571107
ZCTA5 95136,15767,1155,14612,0.0732542652375214,27.79207201969124
ZCTA5 77471,13055,1007,12048,0.07713519724243585,27.755153881007892
ZCTA5 95328,1219,215,1004,0.1763740771123872,27.74964836470738
ZCTA5 99636,110,56,54,0.509090909090909,27.741811112352803
ZCTA5 76110,10378,855,9523,0.08238581614954713,27.721013391499323
ZCTA5 99763,118,58,60,0.4915254237288136,27.671781143750454
ZCTA5 80011,16257,1178,15079,0.07246109368272129,27.658216211765584
ZCTA5 89108,26276,1685,24591,0.06412695996346476,27.649986976755944
ZCTA5 94558,24302,1587,22715,0.06530326722080487,27.610876922153764
ZCTA5 79904,11006,889,10117,0.08077412320552425,27.607143948145925
ZCTA5 91977,18984,1319,17665,0.0694795617361989,27.603538970154318
ZCTA5 99326,1395,232,1163,0.16630824372759856,27.594648569471612
ZCTA5 99759,56,39,17,0.6964285714285714,27.59013774321911
ZCTA5 78758,19976,1369,18607,0.0685322386864237,27.570973681076598
ZCTA5 77050,1428,235,1193,0.1645658263305322,27.552961922413708
ZCTA5 99658,197,76,121,0.38578680203045684,27.50103448816283
ZCTA5 92236,14772,1095,13677,0.07412672623883022,27.49054930432699
ZCTA5 78616,2468,328,2140,0.13290113452188007,27.47431731771176
ZCTA5 99671,112,56,56,0.5,27.457841694047424
ZCTA5 75455,9300,787,8513,0.0846236559139785,27.44195209373424
ZCTA5 91730,23576,1546,22030,0.06557516118086189,27.427490543274796
ZCTA5 33128,3113,379,2734,0.12174751044008994,27.39556523001257
ZCTA5 94040,14444,1075,13369,0.07442536693436722,27.383231480408032
ZCTA5 91710,21639,1444,20195,0.06673136466564998,27.222462762498488
ZCTA5 85193,1393,229,1164,0.16439339554917445,27.17741901233034
ZCTA5 93646,2786,351,2435,0.1259870782483848,27.1612368632139
ZCTA5 75226,1785,266,1519,0.14901960784313725,27.152506626715713
ZCTA5 11378,12604,969,11635,0.0768803554427166,27.112416878907926
ZCTA5 77306,3974,440,3534,0.11071967790639155,27.08708661384218
ZCTA5 11722,9371,785,8586,0.08376907480525024,27.086449833376797
ZCTA5 77023,9744,806,8938,0.0827175697865353,27.04303720482989
ZCTA5 80916,14121,1050,13071,0.07435734013171871,27.03037058276861
ZCTA5 80229,17975,1253,16722,0.06970792767732963,27.030225810621396
ZCTA5 90670,4868,500,4368,0.10271158586688578,26.872261532478028
ZCTA5 11365,15571,1123,14448,0.0721212510436067,26.832546895771216
ZCTA5 27229,1094,196,898,0.17915904936014626,26.80067099776939
ZCTA5 78228,18437,1271,17166,0.06893746271085317,26.79360914625272
ZCTA5 99637,117,56,61,0.47863247863247865,26.778731198289748
ZCTA5 77855,43,33,10,0.7674418604651163,26.76616215347509
ZCTA5 92026,16853,1188,15665,0.07049190055183054,26.739002085457983
ZCTA5 83440,10138,823,9315,0.08117971986585125,26.723264450805814
ZCTA5 89169,9194,768,8426,0.08353273874265825,26.70340342614047
ZCTA5 75238,12776,970,11806,0.07592360676268002,26.695391154305725
ZCTA5 99727,114,55,59,0.4824561403508772,26.660220867750994
ZCTA5 90066,25225,1605,23620,0.06362735381565907,26.650093135093694
ZCTA5 55612,336,99,237,0.29464285714285715,26.624840605478177
ZCTA5 89119,21650,1428,20222,0.06595842956120092,26.59691802731568
ZCTA5 99680,139,61,78,0.43884892086330934,26.57960872534183
ZCTA5 78002,1857,268,1589,0.14431879375336565,26.56817821426777
ZCTA5 77518,3631,409,3222,0.11264114568989259,26.53564162687252
ZCTA5 95901,11785,912,10873,0.07738650827322868,26.522317837661873
ZCTA5 48212,10805,857,9948,0.07931513188338732,26.51050134278102
ZCTA5 93291,16769,1178,15591,0.07024867314687817,26.497123861934902
ZCTA5 58335,409,110,299,0.26894865525672373,26.48533047922311
ZCTA5 39350,9024,754,8270,0.0835549645390071,26.467115711716755
ZCTA5 94087,20180,1351,18829,0.06694747274529236,26.459441586271886
ZCTA5 07304,15750,1124,14626,0.07136507936507937,26.458591383000094
ZCTA5 76009,6902,626,6276,0.09069834830483918,26.447300423731484
ZCTA5 37407,3430,393,3037,0.11457725947521866,26.421304995489955
ZCTA5 99772,158,65,93,0.41139240506329117,26.41876003923787
ZCTA5 55344,7103,638,6465,0.08982120230888357,26.418527853287024
ZCTA5 11101,13169,985,12184,0.07479687144050422,26.383813215370807
ZCTA5 20782,10996,865,10131,0.07866496907966533,26.36464534907781
ZCTA5 95991,14321,1046,13275,0.0730395922072481,26.344152422282928
ZCTA5 11423,9787,795,8992,0.08123020333094921,26.284354089873467
ZCTA5 60626,22417,1456,20961,0.06495070705268323,26.224885827234843
ZCTA5 93654,8753,734,8019,0.08385696332685937,26.22379453657318
ZCTA5 80631,17458,1207,16251,0.06913735823118342,26.21941979266564
ZCTA5 77803,9546,779,8767,0.08160486067462812,26.162284715387994
ZCTA5 99681,71,42,29,0.5915492957746479,26.151733954022372
ZCTA5 91504,9414,771,8643,0.08189929891650732,26.139642814013367
ZCTA5 33973,3811,417,3394,0.10942009971136185,26.079605963699926
ZCTA5 79835,3063,362,2701,0.11818478615736207,26.07813946323377
ZCTA5 76040,11478,886,10592,0.07719114828367311,26.058189894584626
ZCTA5 92867,12906,964,11942,0.07469394080272741,26.053998570450183
ZCTA5 95330,5453,528,4925,0.09682743443975793,26.024741901541532
ZCTA5 33612,18487,1254,17233,0.06783144912641316,25.993625994027834
ZCTA5 77038,8731,728,8003,0.0833810560073302,25.943521798537443
ZCTA5 47326,677,144,533,0.21270310192023634,25.93664906819504
ZCTA5 91010,8073,689,7384,0.0853462157809984,25.928700544032562
ZCTA5 13123,104,51,53,0.49038461538461536,25.913724523910926
ZCTA5 77014,11583,888,10695,0.07666407666407667,25.861648586458752
ZCTA5 76014,10883,849,10034,0.07801157768997519,25.849765309933044
ZCTA5 20899,183,69,114,0.3770491803278688,25.848505618431904
ZCTA5 10044,4748,479,4269,0.10088458298230835,25.838887490873947
ZCTA5 94577,17193,1184,16009,0.06886523585180016,25.821234667562816
ZCTA5 94132,10280,814,9466,0.0791828793774319,25.78385767656622
ZCTA5 95620,6660,601,6059,0.09024024024024024,25.77160523617031
ZCTA5 85007,5157,505,4652,0.09792515028117123,25.746929994105884
ZCTA5 99761,94,48,46,0.5106382978723404,25.728412587306085
ZCTA5 99628,152,62,90,0.40789473684210525,25.672475215068843
ZCTA5 78041,14111,1020,13091,0.07228403373254907,25.65116074177046
ZCTA5 93266,339,96,243,0.2831858407079646,25.5703387212488
ZCTA5 57714,140,59,81,0.42142857142857143,25.52878513505257
ZCTA5 33976,4614,466,4148,0.10099696575639358,25.51411245119579
ZCTA5 92870,17128,1173,15955,0.06848435310602523,25.495169173443703
ZCTA5 41615,280,86,194,0.30714285714285716,25.468237043281075
ZCTA5 97006,26610,1637,24973,0.061518226230740325,25.458616465119306
ZCTA5 92337,9766,779,8987,0.07976653696498054,25.451755403987704
ZCTA5 86011,68,40,28,0.5882352941176471,25.441295231809775
ZCTA5 92374,13696,993,12703,0.07250292056074767,25.413605311070523
ZCTA5 78559,3945,419,3526,0.10621039290240811,25.413022573453
ZCTA5 33068,16131,1120,15011,0.06943152935341888,25.411021233008007
ZCTA5 90058,757,151,606,0.19947159841479525,25.40180406953811
ZCTA5 97305,14348,1027,13321,0.07157792026763311,25.395311446164396
ZCTA5 60120,15506,1087,14419,0.07010189604024249,25.378101438752722
ZCTA5 98935,984,176,808,0.17886178861788618,25.365744955166722
ZCTA5 33181,7435,642,6793,0.0863483523873571,25.363599715574818
ZCTA5 60110,11106,852,10254,0.07671528903295516,25.353559142468388
ZCTA5 95820,12708,938,11770,0.0738117721120554,25.30033378019579
ZCTA5 97209,12047,902,11145,0.07487341246783431,25.281563113745314
ZCTA5 90043,17066,1164,15902,0.06820578928864408,25.24661004685202
ZCTA5 75203,6551,586,5965,0.08945199206228056,25.205044457593825
ZCTA5 00729,16333,1125,15208,0.06887895671340231,25.176908387888375
ZCTA5 94559,10211,799,9412,0.07824894721378906,25.172357849290616
ZCTA5 93268,5710,533,5177,0.09334500875656743,25.1675547071025
ZCTA5 92557,13743,990,12753,0.07203667321545514,25.153210678220837
ZCTA5 88024,51,34,17,0.6666666666666666,25.14766452512442
ZCTA5 95203,5498,519,4979,0.0943979628955984,25.130112282077643
ZCTA5 10473,20935,1353,19582,0.06462861237162647,25.084024615771185
ZCTA5 93249,541,123,418,0.22735674676524953,25.081019310741286
ZCTA5 80221,13925,998,12927,0.07166965888689407,25.0783677891953
ZCTA5 84601,10727,825,9902,0.07690873496783816,25.028619792221235
ZCTA5 00674,15374,1072,14302,0.06972811239755432,25.01211372282025
ZCTA5 38456,1389,214,1175,0.15406767458603313,24.99826807943969
ZCTA5 89104,14209,1011,13198,0.07115208670560912,24.989717164547976
ZCTA5 87013,1542,228,1314,0.14785992217898833,24.983477796606312
ZCTA5 91945,8548,701,7847,0.08200748713149275,24.96396702459629
ZCTA5 97818,1436,218,1218,0.15181058495821728,24.942034630746516
ZCTA5 95207,18222,1215,17007,0.0666776424102733,24.94049982040114
ZCTA5 93451,1331,208,1123,0.1562734785875282,24.91830760124435
ZCTA5 07302,20926,1348,19578,0.06441747108859791,24.908776777238558
ZCTA5 11421,11638,872,10766,0.07492696339577247,24.880825249538752
ZCTA5 86033,2138,278,1860,0.13002806361085126,24.832839538480158
ZCTA5 92612,12736,930,11806,0.07302135678391959,24.8321300846153
ZCTA5 90047,17420,1172,16248,0.06727898966704937,24.826854194597463
ZCTA5 93210,4566,454,4112,0.0994305738063951,24.792436991859642
ZCTA5 11417,9060,727,8333,0.08024282560706401,24.766639133777694
ZCTA5 78405,5293,501,4792,0.0946533156999811,24.76047038482426
ZCTA5 92539,1627,234,1393,0.14382298709280886,24.757284044341528
ZCTA5 90039,11413,856,10557,0.07500219048453519,24.68383095620791
ZCTA5 77016,9741,763,8978,0.07832871368442665,24.62998778207248
ZCTA5 86030,387,100,287,0.25839793281653745,24.608913076450854
ZCTA5 93637,12305,902,11403,0.0733035351483137,24.582412298398992
ZCTA5 55430,7678,644,7034,0.08387600937744204,24.570002592539275
ZCTA5 90248,3822,401,3421,0.10491889063317635,24.569691686243353
ZCTA5 67801,9799,765,9034,0.07806919073374834,24.560338767119287
ZCTA5 99709,12020,886,11134,0.07371048252911813,24.544179370965054
ZCTA5 93606,221,73,148,0.33031674208144796,24.542263464003987
ZCTA5 85172,509,116,393,0.22789783889980353,24.395833927774408
ZCTA5 33805,9018,717,8301,0.0795076513639388,24.320918940735158
ZCTA5 78214,7609,636,6973,0.08358522801945065,24.318294996644394
ZCTA5 87026,1122,184,938,0.16399286987522282,24.316361695027922
ZCTA5 88072,474,111,363,0.23417721518987342,24.30241224139606
ZCTA5 01561,108,49,59,0.4537037037037037,24.287464748551038
ZCTA5 99785,96,46,50,0.4791666666666667,24.285860568114845
ZCTA5 59034,1779,243,1536,0.13659359190556492,24.192206454228163
ZCTA5 87327,1850,249,1601,0.1345945945945946,24.192092994734875
ZCTA5 87323,1277,198,1079,0.15505090054815976,24.164633375984216
ZCTA5 79838,1917,254,1663,0.13249869587897756,24.115947690579283
ZCTA5 78640,17378,1153,16225,0.06634825641615837,24.114586819332835
ZCTA5 96753,10571,799,9772,0.07558414530318797,24.088600565123294
ZCTA5 86511,1016,172,844,0.16929133858267717,24.078441204189197
ZCTA5 53204,12951,924,12027,0.07134584201992124,23.980468249710984
ZCTA5 38127,14338,996,13342,0.06946575533547217,23.979974616875072
ZCTA5 87301,7735,638,7097,0.08248222365869425,23.979341689949496
ZCTA5 95961,8821,700,8121,0.07935608207686204,23.974639433285034
ZCTA5 60501,3472,369,3103,0.10627880184331798,23.863318080287506
ZCTA5 07107,12749,911,11838,0.07145658483018276,23.862255712312827
ZCTA5 98104,8125,658,7467,0.08098461538461539,23.825717657279945
ZCTA5 33016,14948,1023,13925,0.06843724913031844,23.78547009436039
ZCTA5 32808,18106,1181,16925,0.06522699657572076,23.77547339418225
ZCTA5 95117,10722,800,9922,0.07461294534601753,23.700780903252813
ZCTA5 01901,885,156,729,0.17627118644067796,23.627321858174234
ZCTA5 33060,12867,912,11955,0.07087899277220798,23.608077888360572
ZCTA5 76140,9606,737,8869,0.0767228815323756,23.583464493780568
ZCTA5 84770,14682,1005,13677,0.06845116469145893,23.582265475038152
ZCTA5 64854,1451,210,1241,0.1447277739490007,23.571580210790632
ZCTA5 59022,474,108,366,0.22784810126582278,23.53611858355555
ZCTA5 92882,21510,1340,20170,0.06229660622966062,23.52415859884012
ZCTA5 93609,1538,217,1321,0.14109232769830948,23.475089178478925
ZCTA5 11436,5581,502,5079,0.08994803798602401,23.470365848255263
ZCTA5 95348,10895,805,10090,0.07388710417622762,23.469896318040092
ZCTA5 20851,4933,461,4472,0.09345226028785729,23.43449277072201
ZCTA5 96740,13711,952,12759,0.06943330172853913,23.42865910818993
ZCTA5 99585,68,37,31,0.5441176470588235,23.418136556247912
ZCTA5 75236,6686,568,6118,0.0849536344600658,23.417923185419035
ZCTA5 84119,16914,1113,15801,0.06580347641007449,23.39646361940725
ZCTA5 79102,4183,412,3771,0.09849390389672484,23.39296685295719
ZCTA5 10535,143,55,88,0.38461538461538464,23.3527274341846
ZCTA5 55404,12042,863,11179,0.07166583623982727,23.318871681076438
ZCTA5 86502,363,92,271,0.2534435261707989,23.308695686672213
ZCTA5 78368,3242,347,2895,0.10703269586674892,23.29808721801648
ZCTA5 76053,10770,794,9976,0.07372330547818012,23.240338490276084
ZCTA5 85756,10889,800,10089,0.07346863807512168,23.220594422120524
ZCTA5 90503,16738,1100,15638,0.06571872386187119,23.21344117033936
ZCTA5 93656,1670,226,1444,0.13532934131736526,23.15204706640555
ZCTA5 76541,7762,626,7136,0.08064931718629219,23.12312788718991
ZCTA5 11231,15702,1046,14656,0.06661571774296268,23.108639986777316
ZCTA5 11212,31454,1789,29665,0.05687670884466205,23.101149201990207
ZCTA5 99657,50,31,19,0.62,23.06481854360071
ZCTA5 99614,156,57,99,0.36538461538461536,23.05538778461407
ZCTA5 20877,12950,905,12045,0.06988416988416989,23.054529068978017
ZCTA5 85283,19477,1230,18247,0.0631514093546234,23.04831062235552
ZCTA5 11216,24079,1447,22632,0.06009385771834379,22.988477349848157
ZCTA5 87049,364,91,273,0.25,22.97542242005028
ZCTA5 75074,17124,1113,16011,0.06499649614576034,22.954000264848236
ZCTA5 99789,106,46,60,0.4339622641509434,22.931226886319738
ZCTA5 99581,179,61,118,0.3407821229050279,22.86607448243035
ZCTA5 86547,279,78,201,0.27956989247311825,22.86148658441435
ZCTA5 57794,94,43,51,0.4574468085106383,22.860478110718436
ZCTA5 95670,20519,1275,19244,0.06213753106876554,22.84915172170592
ZCTA5 94089,8101,640,7461,0.07900259227255894,22.798435483036013
ZCTA5 77357,7659,615,7044,0.08029768899334117,22.798063511932174
ZCTA5 93277,18022,1153,16869,0.06397736100321828,22.7873301869994
ZCTA5 77066,10650,779,9871,0.07314553990610329,22.77892220121752
ZCTA5 33020,18546,1178,17368,0.06351773967432331,22.76814638985718
ZCTA5 98118,16888,1096,15792,0.06489815253434392,22.724205489178665
ZCTA5 78579,1293,190,1103,0.14694508894044858,22.694635850146906
ZCTA5 63774,37,26,11,0.7027027027027027,22.638694845793733
ZCTA5 75766,9730,727,9003,0.07471736896197329,22.635058758277765
ZCTA5 10199,55,32,23,0.5818181818181818,22.615873914056674
ZCTA5 79853,676,128,548,0.1893491124260355,22.54074677649619
ZCTA5 07029,6635,552,6083,0.08319517709118313,22.53188324299545
ZCTA5 83001,6811,562,6249,0.08251358097195713,22.51594683665464
ZCTA5 10038,10210,750,9460,0.07345739471106758,22.478646551139285
ZCTA5 95365,1324,191,1133,0.14425981873111782,22.421709918258546
ZCTA5 95054,8360,648,7712,0.07751196172248803,22.40207409541771
ZCTA5 99712,5555,486,5069,0.08748874887488749,22.396301855346035
ZCTA5 98952,577,116,461,0.20103986135181975,22.386581656607518
ZCTA5 93622,2820,308,2512,0.10921985815602837,22.37483383520907
ZCTA5 91042,9854,728,9126,0.07387862796833773,22.315816373022137
ZCTA5 33166,7908,621,7287,0.07852807283763277,22.29055476192279
ZCTA5 79905,7683,608,7075,0.07913575426265781,22.26737210423305
ZCTA5 89121,24091,1427,22664,0.05923373874060853,22.251785877310457
ZCTA5 60609,20603,1262,19341,0.06125321555113333,22.189985786037692
ZCTA5 47558,1219,180,1039,0.14766201804757997,22.17484775546662
ZCTA5 94589,9643,714,8929,0.07404334750596288,22.165556150486946
ZCTA5 75901,10642,767,9875,0.07207291862431874,22.155016576635095
ZCTA5 99578,117,47,70,0.4017094017094017,22.15159028173029
ZCTA5 07017,13066,892,12174,0.06826878922394,22.130699128898826
ZCTA5 90404,9904,727,9177,0.07340468497576737,22.110063119824158
ZCTA5 11105,15363,1006,14357,0.06548200221310942,22.076368322791268
ZCTA5 07105,16796,1076,15720,0.06406287211240771,22.060221521800525
ZCTA5 78114,7451,591,6860,0.0793182123204939,22.016182019005246
ZCTA5 95627,1209,178,1031,0.14722911497105046,21.999997372384776
ZCTA5 77511,16252,1048,15204,0.06448437115431947,21.998852835426117
ZCTA5 91324,9925,726,9199,0.07314861460957178,21.99162223149887
ZCTA5 75043,21054,1278,19776,0.060701054431461954,21.985990777688198
ZCTA5 80216,3951,380,3571,0.0961781827385472,21.925522265967594
ZCTA5 76518,543,110,433,0.20257826887661143,21.916356384334907
ZCTA5 87326,494,104,390,0.21052631578947367,21.8865181821659
ZCTA5 87416,1481,201,1280,0.13571910871033085,21.886035633148243
ZCTA5 94572,3329,338,2991,0.10153199158906578,21.84364898415413
ZCTA5 82190,193,61,132,0.3160621761658031,21.83363978257827
ZCTA5 85337,802,138,664,0.17206982543640897,21.830433792527536
ZCTA5 93610,4891,438,4453,0.08955223880597014,21.817715543133705
ZCTA5 60185,10573,757,9816,0.07159746524165327,21.81120046930042
ZCTA5 87313,1620,212,1408,0.1308641975308642,21.803387175103126
ZCTA5 85353,10546,755,9791,0.0715911245970036,21.779712214903842
ZCTA5 91931,145,52,93,0.3586206896551724,21.774734336597703
ZCTA5 85303,9529,701,8828,0.07356490712561654,21.774419957874713
ZCTA5 48120,2255,261,1994,0.11574279379157427,21.73080430315277
ZCTA5 11102,13072,884,12188,0.06762545899632803,21.72673762427987
ZCTA5 75216,18415,1146,17269,0.062231876187890306,21.71720773640417
ZCTA5 94928,15998,1029,14969,0.06432054006750844,21.711030418409713
ZCTA5 60165,1264,181,1083,0.14319620253164558,21.697483647907408
ZCTA5 87940,231,67,164,0.29004329004329005,21.68738754939578
ZCTA5 22309,11526,804,10722,0.06975533576262363,21.673152039201824
ZCTA5 93206,562,111,451,0.19750889679715303,21.628173407455783
ZCTA5 78140,1229,177,1052,0.14401952807160293,21.555487721449982
ZCTA5 76043,2776,297,2479,0.10698847262247839,21.54578826302012
ZCTA5 18225,91,40,51,0.43956043956043955,21.5438567589094
ZCTA5 06810,18629,1151,17478,0.061785388372966876,21.504133812287655
ZCTA5 93043,16,16,0,1,21.500351221496462
ZCTA5 11692,6815,547,6268,0.08026412325752018,21.489858140689492
ZCTA5 77995,3767,363,3404,0.0963631537032121,21.472028690572337
ZCTA5 12601,16137,1029,15108,0.06376649934932144,21.413749644554244
ZCTA5 79035,1707,216,1491,0.1265377855887522,21.387143411031317
ZCTA5 57622,84,38,46,0.4523809523809524,21.352111770595158
ZCTA5 99753,76,36,40,0.47368421052631576,21.34270884754635
ZCTA5 33309,12974,871,12103,0.06713426853707415,21.33400656070109
ZCTA5 98848,3534,346,3188,0.09790605546123372,21.30745165894451
ZCTA5 97030,14453,944,13509,0.06531515948246039,21.30101637457194
ZCTA5 78617,6501,526,5975,0.08091062913397938,21.278834424335976
ZCTA5 19134,19830,1201,18629,0.0605648008068583,21.230628747864827
ZCTA5 75471,413,91,322,0.22033898305084745,21.120879517090824
ZCTA5 33169,11777,806,10971,0.06843848178653307,21.113140346272445
ZCTA5 94612,8788,649,8139,0.07385070550751024,21.059664055190648
ZCTA5 33024,23426,1363,22063,0.05818321523093998,21.048355590467445
ZCTA5 99557,205,61,144,0.2975609756097561,21.029044486959958
ZCTA5 99615,4105,379,3726,0.092326431181486,20.976347028278113
ZCTA5 06608,4395,397,3998,0.09032992036405006,20.96858480742697
ZCTA5 97838,9175,668,8507,0.07280653950953679,20.9621679147084
ZCTA5 92061,699,123,576,0.1759656652360515,20.953249775893184
ZCTA5 86540,257,69,188,0.26848249027237353,20.953171084327415
ZCTA5 87455,561,108,453,0.1925133689839572,20.95092259360031
ZCTA5 73127,9031,660,8371,0.0730816077953715,20.94238752685198
ZCTA5 33034,4894,427,4467,0.08724969350224765,20.928621673727445
ZCTA5 74146,5586,468,5118,0.08378088077336197,20.91758175847819
ZCTA5 75150,21248,1259,19989,0.059252635542168676,20.912921911266473
ZCTA5 11224,18725,1141,17584,0.06093457943925234,20.912020961033367
ZCTA5 95148,12092,818,11274,0.06764803175653325,20.910256501416512
ZCTA5 87045,502,101,401,0.20119521912350596,20.90037870375553
ZCTA5 92583,9296,673,8623,0.07239672977624785,20.88020773409726
ZCTA5 96743,4364,394,3970,0.09028414298808432,20.87768599748082
ZCTA5 85139,5564,466,5098,0.08375269590222861,20.86465846871612
ZCTA5 87070,26,20,6,0.7692307692307693,20.863912167667376
ZCTA5 08105,8597,635,7962,0.07386297545655461,20.83587628390403
ZCTA5 78372,1597,203,1394,0.12711333750782716,20.814478326625096
ZCTA5 92122,19946,1195,18751,0.059911761756743204,20.779737789111135
ZCTA5 79928,15201,969,14232,0.06374580619696073,20.76925035625707
ZCTA5 95842,11230,770,10460,0.06856634016028496,20.692345273546735
ZCTA5 90232,6410,512,5898,0.07987519500780031,20.66836609005832
ZCTA5 88081,4281,386,3895,0.09016584910067742,20.635151391557603
ZCTA5 75006,18022,1101,16921,0.06109199866829431,20.633234464884332
ZCTA5 77453,98,40,58,0.40816326530612246,20.62862723006188
ZCTA5 07106,11339,774,10565,0.06825998765323221,20.611109730423102
ZCTA5 92555,10774,745,10029,0.06914794876554668,20.60360403506335
ZCTA5 86035,558,106,452,0.18996415770609318,20.55995140789673
ZCTA5 10305,14663,937,13726,0.06390233922116893,20.503812294503323
ZCTA5 95560,570,107,463,0.18771929824561404,20.48179977546706
ZCTA5 65746,2590,274,2316,0.10579150579150579,20.472697169628347
ZCTA5 92054,15358,970,14388,0.06315926552936581,20.47199996595127
ZCTA5 94590,14557,931,13626,0.06395548533351653,20.465225135772606
ZCTA5 32818,16968,1047,15921,0.061704384724186705,20.46439963808335
ZCTA5 87108,16760,1037,15723,0.06187350835322196,20.46034273898024
ZCTA5 77020,8454,621,7833,0.07345635202271114,20.453945255235162
ZCTA5 10475,18759,1131,17628,0.060291060291060294,20.440847382249903
ZCTA5 96782,11407,774,10633,0.06785307267467344,20.431133193225904
ZCTA5 61801,11568,782,10786,0.06760027662517289,20.423608182978064
ZCTA5 11201,28067,1554,26513,0.05536751344995903,20.415885318115194
ZCTA5 12435,100,40,60,0.4,20.384090386836032
ZCTA5 25977,91,38,53,0.4175824175824176,20.37792684019818
ZCTA5 39817,3724,348,3376,0.09344790547798067,20.35979087829058
ZCTA5 33417,14246,913,13333,0.06408816509897515,20.33349956982248
ZCTA5 77301,10510,726,9784,0.06907706945765937,20.30919937283489
ZCTA5 20705,8935,644,8291,0.07207610520425294,20.302221623748977
ZCTA5 98204,16848,1037,15811,0.061550332383665717,20.280707521483464
ZCTA5 99782,131,46,85,0.3511450381679389,20.221036733129917
ZCTA5 10037,9731,684,9047,0.07029082314253417,20.207896682269357
ZCTA5 88063,4042,366,3676,0.09054923305294409,20.186417686483068
ZCTA5 90025,22105,1279,20826,0.05786021262157883,20.179219307083475
ZCTA5 60629,31827,1712,30115,0.05379080654789958,20.176156218291545
ZCTA5 85621,7078,542,6536,0.07657530375812377,20.174733112016973
ZCTA5 92276,2707,279,2428,0.10306612486147027,20.141444316674054
ZCTA5 11356,7453,562,6891,0.0754058768281229,20.140837312965584
ZCTA5 51105,3814,351,3463,0.09202936549554273,20.117159073238344
ZCTA5 77090,15892,987,14905,0.062106720362446514,20.08697353099888
ZCTA5 98499,12947,844,12103,0.06518884683710512,20.080786350129614
ZCTA5 77445,4579,397,4182,0.08670015287180607,20.037090971633333
ZCTA5 85131,3392,323,3069,0.09522405660377359,20.00632480017042
ZCTA5 94805,5299,439,4860,0.08284581996603133,19.994610282640966
ZCTA5 11096,2581,269,2312,0.1042231693142193,19.994001357093207
ZCTA5 79907,16483,1013,15470,0.06145725899411515,19.99336923484165
ZCTA5 41855,313,74,239,0.2364217252396166,19.96925059120739
ZCTA5 87325,851,133,718,0.1562867215041128,19.926963255092964
ZCTA5 46224,13685,877,12808,0.06408476434051881,19.926904837581855
ZCTA5 32809,9275,655,8620,0.07061994609164421,19.905009321949066
ZCTA5 11520,14086,896,13190,0.06360925741871362,19.90290354566264
ZCTA5 84536,417,87,330,0.20863309352517986,19.893574805410843
ZCTA5 98057,6235,491,5744,0.07874899759422614,19.88974550807057
ZCTA5 95231,801,128,673,0.15980024968789014,19.885700930687374
ZCTA5 08820,12902,837,12065,0.0648736629979848,19.84676566826137
ZCTA5 78754,8192,597,7595,0.0728759765625,19.84238022795362
ZCTA5 99766,152,49,103,0.3223684210526316,19.80860019168395
ZCTA5 92606,8660,620,8040,0.07159353348729793,19.73761304949421
ZCTA5 98921,153,49,104,0.3202614379084967,19.728719359262158
ZCTA5 33312,17769,1067,16702,0.060048398896955374,19.714272148733837
ZCTA5 34972,5663,456,5207,0.08052269115309907,19.697733136101338
ZCTA5 91791,10170,697,9473,0.06853490658800393,19.673940111337554
ZCTA5 92220,11667,772,10895,0.06616953801319962,19.651400323240463
ZCTA5 96771,2867,285,2582,0.09940704569236135,19.638585676774298
ZCTA5 94501,25347,1410,23937,0.05562788495679962,19.631945326158203
ZCTA5 93710,11238,750,10488,0.06673785371062467,19.62176238032998
ZCTA5 06854,10796,727,10069,0.06733975546498704,19.579814000213414
ZCTA5 55414,11532,763,10769,0.06616371834894208,19.53389990705875
ZCTA5 77477,13101,840,12261,0.06411724295855278,19.517757738343033
ZCTA5 28803,15900,974,14926,0.06125786163522012,19.496781885685383
ZCTA5 17886,499,95,404,0.1903807615230461,19.494394137682065
ZCTA5 20011,24166,1353,22813,0.055987751386245135,19.480236517994946
ZCTA5 77039,7570,558,7012,0.07371202113606341,19.47873820174282
ZCTA5 60106,7036,529,6507,0.0751847640704946,19.46613828269535
ZCTA5 75964,6825,517,6308,0.07575091575091575,19.43213930016715
ZCTA5 22305,6825,517,6308,0.07575091575091575,19.43213930016715
ZCTA5 32839,18160,1078,17082,0.05936123348017621,19.415023852336386
ZCTA5 07111,20403,1180,19223,0.05783463216193697,19.366479591574773
ZCTA5 68776,5413,437,4976,0.0807315721411417,19.343499040555166
ZCTA5 84604,11850,775,11075,0.06540084388185655,19.33957349491233
ZCTA5 10606,5580,446,5134,0.07992831541218638,19.305938471254713
ZCTA5 64863,489,93,396,0.1901840490797546,19.2738802120409
ZCTA5 85350,5945,466,5479,0.0783851976450799,19.265694153332717
ZCTA5 75208,10380,700,9680,0.0674373795761079,19.254187813017282
ZCTA5 99622,73,32,41,0.4383561643835616,19.23864177750114
ZCTA5 99576,848,129,719,0.15212264150943397,19.217466450281815
ZCTA5 75119,9164,637,8527,0.06951113051069402,19.195253238905956
ZCTA5 85713,16772,1008,15764,0.06010016694490818,19.19049842526561
ZCTA5 57555,1216,161,1055,0.13240131578947367,19.18813907778764
ZCTA5 98003,18567,1091,17476,0.05876016588571121,19.175914617085223
ZCTA5 99336,18418,1084,17334,0.05885546747746769,19.17074213295113
ZCTA5 33493,540,98,442,0.1814814814814815,19.129413097957922
ZCTA5 18102,16093,974,15119,0.0605232088485677,19.09647528801315
ZCTA5 76673,478,91,387,0.1903765690376569,19.07927268196637
ZCTA5 85034,1833,208,1625,0.11347517730496454,19.052324204581453
ZCTA5 68071,562,100,462,0.17793594306049823,19.047769596267237
ZCTA5 99678,206,56,150,0.27184466019417475,19.027666880662775
ZCTA5 92250,2402,248,2154,0.10324729392173189,19.02224595399451
ZCTA5 01905,8374,593,7781,0.07081442560305708,19.012470008379957
ZCTA5 92057,19342,1122,18220,0.058008478957708616,18.990663976561923
ZCTA5 89825,537,97,440,0.18063314711359404,18.966877369150207
ZCTA5 06902,25948,1417,24531,0.05460921843687375,18.950797324695348
ZCTA5 33054,9072,628,8444,0.06922398589065255,18.94656174175408
ZCTA5 93308,19454,1125,18329,0.05782872416983654,18.90614002354028
ZCTA5 07063,3995,348,3647,0.08710888610763454,18.85944022617375
ZCTA5 39057,783,121,662,0.1545338441890166,18.841478858170078
ZCTA5 86520,460,88,372,0.19130434782608696,18.82725133592034
ZCTA5 28347,524,95,429,0.18129770992366412,18.820489307370657
ZCTA5 90704,1562,186,1376,0.11907810499359796,18.81908233266151
ZCTA5 10280,4560,381,4179,0.08355263157894736,18.813485824652894
ZCTA5 90504,11559,750,10809,0.06488450558006748,18.791921980417325
ZCTA5 93301,4651,386,4265,0.0829929047516663,18.787999140656076
ZCTA5 78834,2555,256,2299,0.10019569471624266,18.76092326419787
ZCTA5 85607,5040,408,4632,0.08095238095238096,18.75231725854798
ZCTA5 33032,12314,786,11528,0.06382978723404255,18.745054134562658
ZCTA5 95695,14625,896,13729,0.061264957264957266,18.703510530633103
ZCTA5 02863,6309,478,5831,0.0757647804723411,18.689250625897188
ZCTA5 95387,167,49,118,0.2934131736526946,18.682118138867377
ZCTA5 01841,14795,903,13892,0.06103413315309226,18.655765071872935
ZCTA5 86504,1780,201,1579,0.11292134831460675,18.644919273145256
ZCTA5 33534,4942,401,4541,0.0811412383650344,18.642940757431926
ZCTA5 97005,11156,727,10429,0.06516672642524202,18.62719951730007
ZCTA5 57756,144,45,99,0.3125,18.621720622494845
ZCTA5 95981,12,12,0,1,18.61985034810372
ZCTA5 94605,15951,956,14995,0.05993354648611372,18.597884996213796
ZCTA5 10039,11210,729,10481,0.06503122212310437,18.59244246479419
ZCTA5 95482,11396,738,10658,0.06475956475956476,18.584781150930944
ZCTA5 95041,82,33,49,0.4024390243902439,18.581403757082867
ZCTA5 91913,14756,899,13857,0.06092436974789916,18.55701135225317
ZCTA5 20710,3630,322,3308,0.08870523415977961,18.512133912999495
ZCTA5 57625,1183,154,1029,0.1301775147928994,18.500627961000248
ZCTA5 71730,12140,772,11368,0.06359143327841846,18.466098987842745
ZCTA5 10019,25428,1380,24048,0.05427088249174139,18.45991671098616
ZCTA5 78566,4881,395,4486,0.08092603974595369,18.44391714250994
ZCTA5 59050,377,77,300,0.20424403183023873,18.441477276983854
ZCTA5 44082,578,99,479,0.17128027681660898,18.42715569227735
ZCTA5 95354,8818,606,8212,0.06872306645497846,18.417856650479674
ZCTA5 78102,7209,522,6687,0.07240948813982521,18.393591237596702
ZCTA5 93292,13275,825,12450,0.062146892655367235,18.384463959264796
ZCTA5 99721,70,30,40,0.42857142857142855,18.383918244625594
ZCTA5 80236,6417,479,5938,0.0746454729624435,18.349906685138187
ZCTA5 77979,6182,466,5716,0.07538013587835651,18.332002264899806
ZCTA5 30060,13452,832,12620,0.06184953910199227,18.3148295537017
ZCTA5 73129,6248,469,5779,0.0750640204865557,18.290643488630263
ZCTA5 46327,3854,333,3521,0.08640373637778931,18.28019227724927
ZCTA5 50316,5668,437,5231,0.07709950599858857,18.273221546969072
ZCTA5 33865,248,60,188,0.24193548387096775,18.258115822570964
ZCTA5 90008,14834,896,13938,0.060401779695294595,18.252033375901693
ZCTA5 99771,71,30,41,0.4225352112676056,18.231915634835996
ZCTA5 50314,3947,338,3609,0.08563465923486192,18.2307357743823
ZCTA5 77302,6338,473,5865,0.07462922057431366,18.229408162099034
ZCTA5 07601,18732,1075,17657,0.05738842622250694,18.21686827335358
ZCTA5 11553,6325,472,5853,0.07462450592885375,18.20861803702143
ZCTA5 78387,3230,294,2936,0.09102167182662539,18.19454474015359
ZCTA5 77328,4781,386,4395,0.0807362476469358,18.181024085002374
ZCTA5 95993,12116,765,11351,0.0631396500495213,18.171287307501053
ZCTA5 34140,144,44,100,0.3055555555555556,18.158293016010052
ZCTA5 97501,17798,1031,16767,0.0579278570625913,18.157110764899382
ZCTA5 75067,24965,1351,23614,0.05411576206689365,18.154782376672415
ZCTA5 95834,10141,668,9473,0.06587121585642441,18.154149640803663
ZCTA5 07513,3415,305,3110,0.08931185944363104,18.15268416288817
ZCTA5 93920,485,88,397,0.18144329896907216,18.124398305350237
ZCTA5 34113,8177,568,7609,0.0694631282866577,18.107969188610145
ZCTA5 99180,533,93,440,0.17448405253283303,18.10663102268071
ZCTA5 87461,422,81,341,0.19194312796208532,18.10581861760653
ZCTA5 22312,11507,734,10773,0.06378725992873903,18.095047204508234
ZCTA5 16256,544,94,450,0.17279411764705882,18.073322276860356
ZCTA5 75210,2823,267,2556,0.09458023379383634,18.06111063420533
ZCTA5 41740,406,79,327,0.19458128078817735,18.054878488454737
ZCTA5 91201,8311,574,7737,0.0690650944531344,18.053943073571443
ZCTA5 59855,330,70,260,0.21212121212121213,18.049466593633003
ZCTA5 92630,21234,1183,20051,0.055712536498069135,18.03726951480297
ZCTA5 87317,546,94,452,0.17216117216117216,18.024266734578237
ZCTA5 97882,2193,225,1968,0.10259917920656635,18.00705966262506
ZCTA5 82054,356,73,283,0.2050561797752809,18.005712664424507
ZCTA5 46732,1135,147,988,0.12951541850220263,17.997365894368603
ZCTA5 77063,18455,1057,17398,0.057274451368192904,17.995570214571273
ZCTA5 87749,48,24,24,0.5,17.975376854726687
ZCTA5 33013,9543,635,8908,0.0665409200461071,17.974576975126084
ZCTA5 94509,21586,1197,20389,0.05545260817196331,17.973783878123218
ZCTA5 33033,15375,915,14460,0.05951219512195122,17.96846116964684
ZCTA5 93612,13606,832,12774,0.0611494928707923,17.965262561385067
ZCTA5 95132,12127,761,11366,0.06275253566422033,17.942462814609016
ZCTA5 95821,14788,887,13901,0.059981065728969434,17.93919701140892
ZCTA5 12781,113,38,75,0.336283185840708,17.901925290901115
ZCTA5 99786,78,31,47,0.3974358974358974,17.876806352820093
ZCTA5 78558,206,53,153,0.25728155339805825,17.865279753243218
ZCTA5 86514,827,120,707,0.14510278113663846,17.855372643604397
ZCTA5 87316,304,66,238,0.21710526315789475,17.8071029366974
ZCTA5 33407,10719,690,10029,0.06437167646235656,17.800968363532178
ZCTA5 76041,161,46,115,0.2857142857142857,17.800185954352152
ZCTA5 72616,4002,336,3666,0.08395802098950525,17.767466367354878
ZCTA5 78593,1528,176,1352,0.11518324607329843,17.766463667889646
ZCTA5 78223,17808,1022,16786,0.05738993710691824,17.763012915391926
ZCTA5 78621,6957,499,6458,0.07172631881558143,17.752359951915878
ZCTA5 57577,274,62,212,0.22627737226277372,17.749966633373923
ZCTA5 10006,1794,195,1599,0.10869565217391304,17.72275568926336
ZCTA5 60033,4618,371,4247,0.08033780857514075,17.71783634280733
ZCTA5 10927,3641,314,3327,0.08624004394397143,17.712935867416782
ZCTA5 08611,8109,558,7551,0.06881243063263041,17.706662751448622
ZCTA5 96777,530,91,439,0.17169811320754716,17.69892731559003
ZCTA5 07505,1037,137,900,0.13211186113789777,17.66782641644632
ZCTA5 78220,5381,413,4968,0.07675153317227282,17.662626928202407
ZCTA5 95039,349,71,278,0.2034383954154728,17.659738916452273
ZCTA5 10027,23811,1286,22525,0.05400865146360925,17.63830358686641
ZCTA5 19148,19610,1100,18510,0.05609382967873534,17.630730873705474
ZCTA5 22191,22366,1222,21144,0.05463650183313959,17.616898326559554
ZCTA5 93624,218,54,164,0.24770642201834864,17.592057212596075
ZCTA5 95234,26,17,9,0.6538461538461539,17.592029448062448
ZCTA5 66407,211,53,158,0.25118483412322273,17.5882979443621
ZCTA5 99739,85,32,53,0.3764705882352941,17.586824000204533
ZCTA5 95062,15106,894,14212,0.05918178207334834,17.584743048551395
ZCTA5 78959,690,106,584,0.1536231884057971,17.55415462722924
ZCTA5 93201,378,74,304,0.19576719576719576,17.54939740446195
ZCTA5 83122,219,54,165,0.2465753424657534,17.53927509069646
ZCTA5 93627,39,21,18,0.5384615384615384,17.538526263253388
ZCTA5 12733,319,67,252,0.21003134796238246,17.538516890607248
ZCTA5 30720,9662,633,9029,0.06551438625543365,17.525161806853934
ZCTA5 50226,1988,207,1781,0.10412474849094568,17.523041763327523
ZCTA5 83605,14409,860,13549,0.059684919147754874,17.51013314216337
ZCTA5 94706,7905,544,7361,0.06881720430107527,17.48487903893678
ZCTA5 68661,2289,227,2062,0.09916994320664045,17.48457745752059
ZCTA5 86512,694,106,588,0.15273775216138327,17.47524472611591
ZCTA5 92225,5891,438,5453,0.07435070446443728,17.45594335064753
ZCTA5 89883,1307,157,1150,0.12012241775057383,17.424509421083567
ZCTA5 43224,17312,990,16322,0.05718576709796673,17.364500031159494
ZCTA5 78112,2170,218,1952,0.10046082949308756,17.35843099585238
ZCTA5 92391,927,126,801,0.13592233009708737,17.34968587988099
ZCTA5 74955,5778,430,5348,0.0744202146071305,17.31709774809519
ZCTA5 17401,6550,471,6079,0.07190839694656488,17.307206926513576
ZCTA5 78363,10459,668,9791,0.06386843866526437,17.297545182319563
ZCTA5 86042,548,91,457,0.16605839416058393,17.262771641514178
ZCTA5 77541,6479,466,6013,0.07192467973452693,17.220437552789058
ZCTA5 86054,540,90,450,0.16666666666666666,17.214909202396996
ZCTA5 78227,14396,853,13543,0.05925257015837733,17.213750553764527
ZCTA5 95368,4061,333,3728,0.0819995075104654,17.203882075276155
ZCTA5 85711,16673,957,15716,0.05739818868829845,17.193552770201542
ZCTA5 33971,7284,507,6777,0.06960461285008238,17.15776773262283
ZCTA5 54867,249,57,192,0.2289156626506024,17.152358903822613
ZCTA5 06513,14621,862,13759,0.05895629573900554,17.148522880207686
ZCTA5 79706,7795,533,7262,0.06837716484926235,17.146745431191274
ZCTA5 79836,1686,183,1503,0.10854092526690391,17.145683830155654
ZCTA5 87024,545,90,455,0.1651376146788991,17.095913641417724
ZCTA5 58854,2844,259,2585,0.09106891701828411,17.086810559080586
ZCTA5 94111,2160,215,1945,0.09953703703703703,17.07962685127309
ZCTA5 93675,1286,153,1133,0.11897356143079316,17.05484710359041
ZCTA5 48340,9895,636,9259,0.06427488630621526,17.049539617319358
ZCTA5 68147,3919,323,3596,0.0824189844348048,17.046459389947245
ZCTA5 99126,341,68,273,0.19941348973607037,17.04283247787621
ZCTA5 90505,14089,835,13254,0.059266094115977004,17.03814368551759
ZCTA5 77031,6000,438,5562,0.073,17.034861075710122
ZCTA5 10550,13410,803,12607,0.0598806860551827,17.018298769298823
ZCTA5 64101,10,10,0,1,16.997520088378046
ZCTA5 24887,10,10,0,1,16.997520088378046
ZCTA5 73108,4652,364,4288,0.07824591573516768,16.98948522528668
ZCTA5 89142,11054,691,10363,0.0625113081237561,16.98926260098568
ZCTA5 93261,743,108,635,0.14535666218034993,16.962779043376212
ZCTA5 76011,9626,621,9005,0.0645127778932059,16.94599025391039
ZCTA5 78408,4271,342,3929,0.08007492390540857,16.943631049803763
ZCTA5 53218,14036,830,13206,0.059133656312339695,16.918810145009623
ZCTA5 99626,71,28,43,0.39436619718309857,16.9119459149716
ZCTA5 76114,8893,584,8309,0.06566962779714382,16.89470181224088
ZCTA5 98444,12595,762,11833,0.06050019849146487,16.879689758550832
ZCTA5 91723,6250,449,5801,0.07184,16.87614288617208
ZCTA5 10301,14489,850,13639,0.0586651942853199,16.87607618637719
ZCTA5 92548,2356,226,2130,0.09592529711375213,16.862795775628243
ZCTA5 99746,113,36,77,0.3185840707964602,16.855630841928377
ZCTA5 30753,2609,242,2367,0.09275584515139901,16.844827470926486
ZCTA5 79714,5508,409,5099,0.0742556281771968,16.839723363487018
ZCTA5 60625,29527,1508,28019,0.051071900294645575,16.83529808620583
ZCTA5 71832,3514,297,3217,0.08451906659077973,16.83394127379706
ZCTA5 60624,11831,725,11106,0.061279688952751245,16.83123209488097
ZCTA5 79936,35120,1742,33378,0.04960136674259681,16.828112377725606
ZCTA5 98121,12215,743,11472,0.06082685223086369,16.823872937588238
ZCTA5 46711,2565,239,2326,0.09317738791423003,16.820908741900187
ZCTA5 72904,7819,529,7290,0.0676557104489065,16.818351058844488
ZCTA5 79703,7646,520,7126,0.06800941668846455,16.803250218925452
ZCTA5 37211,30080,1530,28550,0.05086436170212766,16.79204683841798
ZCTA5 93270,1569,172,1397,0.10962396430847673,16.778647474580858
ZCTA5 11217,17447,982,16465,0.05628474809422823,16.77022644298651
ZCTA5 32064,2354,225,2129,0.0955819881053526,16.763006891194607
ZCTA5 98846,441,78,363,0.17687074829931973,16.748717539153574
ZCTA5 88021,5832,425,5407,0.07287379972565158,16.74108383677147
ZCTA5 78933,540,88,452,0.16296296296296298,16.736283228506764
ZCTA5 95822,15993,915,15078,0.05721253048208591,16.708718139054977
ZCTA5 99504,14700,856,13844,0.0582312925170068,16.705954418250283
ZCTA5 83012,109,35,74,0.3211009174311927,16.70074112081569
ZCTA5 87401,16112,920,15192,0.057100297914597815,16.691541673511107
ZCTA5 95567,770,109,661,0.14155844155844155,16.682112506112336
ZCTA5 91104,12960,775,12185,0.059799382716049385,16.678847947675436
ZCTA5 11590,14082,827,13255,0.058727453486720635,16.67844751133247
ZCTA5 34266,10053,637,9416,0.06336416989953247,16.677319461958696
ZCTA5 85256,1707,181,1526,0.1060339777387229,16.67612901808699
ZCTA5 95776,7432,507,6925,0.06821851453175458,16.666678264489622
ZCTA5 20879,8331,552,7779,0.0662585523946705,16.651084691425627
ZCTA5 78401,1740,183,1557,0.10517241379310345,16.636690492448363
ZCTA5 96731,808,112,696,0.13861386138613863,16.62332144363253
ZCTA5 66607,2950,261,2689,0.08847457627118645,16.618710477184624
ZCTA5 78073,2221,215,2006,0.09680324178298064,16.602639514453042
ZCTA5 79901,3835,313,3522,0.08161668839634942,16.586482842573
ZCTA5 93616,686,101,585,0.14723032069970846,16.572046330426186
ZCTA5 79029,4892,372,4520,0.07604251839738348,16.56518767119145
ZCTA5 06607,2832,253,2579,0.0893361581920904,16.53792447726543
ZCTA5 67901,7001,483,6518,0.06899014426510498,16.535237722824604
ZCTA5 77029,5697,415,5282,0.07284535720554677,16.534248186803147
ZCTA5 75159,5286,393,4893,0.07434733257661748,16.533948596215833
ZCTA5 07001,4955,375,4580,0.07568113017154389,16.530042843836608
ZCTA5 84627,1973,198,1775,0.10035478966041561,16.525564942588463
ZCTA5 97761,1045,131,914,0.12535885167464114,16.52184534938609
ZCTA5 90230,13204,783,12421,0.05930021205695244,16.516142392270353
ZCTA5 90010,1961,197,1764,0.10045894951555329,16.500884038315537
ZCTA5 33167,5706,415,5291,0.07273045916579039,16.49903722245852
ZCTA5 86538,636,96,540,0.1509433962264151,16.477429243134463
ZCTA5 06605,8938,579,8359,0.06477959275005594,16.46945253883259
ZCTA5 95514,56,24,32,0.42857142857142855,16.443076355112574
ZCTA5 97466,443,77,366,0.17381489841986456,16.42897157674931
ZCTA5 94591,18658,1027,17631,0.055043413013184696,16.399534102835613
ZCTA5 93242,1056,131,925,0.1240530303030303,16.372592791728092
ZCTA5 33815,5395,395,5000,0.0732159406858202,16.241409683563827
ZCTA5 80498,2573,234,2339,0.09094442285270113,16.21722938771309
ZCTA5 33174,9667,610,9057,0.06310127236991828,16.210264348529332
ZCTA5 38618,4539,348,4191,0.07666886979510905,16.191010021155257
ZCTA5 68850,4324,336,3988,0.07770582793709528,16.182095423657042
ZCTA5 72824,629,94,535,0.1494435612082671,16.177314993796774
ZCTA5 20712,3845,309,3536,0.08036410923276983,16.176160788293977
ZCTA5 10470,6076,430,5646,0.07077024358130349,16.175847620699678
ZCTA5 02909,14566,838,13728,0.057531237127557325,16.15978031244984
ZCTA5 20886,11792,710,11082,0.060210312075983714,16.15768316976788
ZCTA5 35552,332,64,268,0.1927710843373494,16.143357304227155
ZCTA5 81601,5916,421,5495,0.0711629479377958,16.129420865523805
ZCTA5 95965,6892,471,6421,0.0683401044689495,16.105905793580757
ZCTA5 78578,4233,330,3903,0.07795889440113395,16.102474614520197
ZCTA5 60660,20676,1108,19568,0.05358870187657187,16.10038400110663
ZCTA5 24884,110,34,76,0.3090909090909091,16.07668373233121
ZCTA5 79766,1788,182,1606,0.1017897091722595,16.06915447109852
ZCTA5 94514,447,76,371,0.17002237136465326,16.057067986445745
ZCTA5 98843,635,94,541,0.14803149606299212,16.056407876778298
ZCTA5 33614,18484,1010,17474,0.054641852412897644,16.01927862867498
ZCTA5 29378,68,26,42,0.38235294117647056,15.999888079187759
ZCTA5 75702,7660,508,7152,0.06631853785900783,15.995645352533064
ZCTA5 57566,285,58,227,0.20350877192982456,15.965177954306652
ZCTA5 78504,17936,984,16952,0.054861730597680645,15.943788224432085
ZCTA5 95060,18617,1014,17603,0.054466347961540526,15.94363806601857
ZCTA5 93954,100,32,68,0.32,15.935185364582017
ZCTA5 11429,7340,491,6849,0.06689373297002725,15.932016208836393
ZCTA5 93721,2000,195,1805,0.0975,15.928264736479237
ZCTA5 77362,1733,177,1556,0.10213502596653203,15.90001836687907
ZCTA5 77372,4222,327,3895,0.07745144481288489,15.898174358260478
ZCTA5 36790,118,35,83,0.2966101694915254,15.897077651084112
ZCTA5 01107,3794,303,3491,0.07986294148655772,15.896852334647718
ZCTA5 92675,12895,756,12139,0.0586273749515316,15.89684586060271
ZCTA5 78222,7472,497,6975,0.06651498929336189,15.892570560918333
ZCTA5 10075,11035,669,10366,0.06062528318985048,15.87287073120805
ZCTA5 93272,1094,131,963,0.11974405850091407,15.871987644461553
ZCTA5 80247,14334,821,13513,0.057276405748569834,15.860903356921662
ZCTA5 05678,74,27,47,0.36486486486486486,15.85423979058025
ZCTA5 20912,9382,590,8792,0.06288637817096568,15.853769413120894
ZCTA5 12823,200,47,153,0.235,15.850822077578398
ZCTA5 78404,6990,472,6518,0.06752503576537912,15.841047387381947
ZCTA5 33462,12124,719,11405,0.0593038601121742,15.828513066881333
ZCTA5 86556,446,75,371,0.1681614349775785,15.820541320425924
ZCTA5 95987,1803,181,1622,0.10038824181919023,15.805481877772392
ZCTA5 42762,51,22,29,0.43137254901960786,15.803094877532684
ZCTA5 95367,7360,490,6870,0.06657608695652174,15.802160843141854
ZCTA5 97532,1036,126,910,0.12162162162162163,15.781596030037157
ZCTA5 77085,5228,380,4848,0.07268553940321347,15.774787808174878
ZCTA5 95237,1250,142,1108,0.1136,15.757911413632787
ZCTA5 11726,5785,409,5376,0.07070008643042351,15.754062648507118
ZCTA5 80435,2122,201,1921,0.09472196041470311,15.695223073915084
ZCTA5 10304,14172,810,13362,0.0571549534292972,15.690615023921474
ZCTA5 29406,12495,733,11762,0.05866346538615446,15.670780141160224
ZCTA5 99764,86,29,57,0.3372093023255814,15.66519784021048
ZCTA5 81143,329,62,267,0.1884498480243161,15.634372754332698
ZCTA5 91775,8070,522,7548,0.06468401486988848,15.601582002111037
ZCTA5 92281,693,97,596,0.13997113997113997,15.59366661114618
ZCTA5 22172,3380,276,3104,0.08165680473372781,15.584452862654063
ZCTA5 95476,15296,858,14438,0.05609309623430962,15.570637245270088
ZCTA5 10314,31362,1545,29817,0.04926343983164339,15.569499601288353
ZCTA5 99589,48,21,27,0.4375,15.567336374541592
ZCTA5 79404,3299,271,3028,0.08214610488026675,15.552873148282742
ZCTA5 01438,206,47,159,0.22815533980582525,15.5405054984041
ZCTA5 98232,1774,177,1597,0.09977452085682074,15.53410550641672
ZCTA5 33009,18421,995,17426,0.05401444004125726,15.518398030459142
ZCTA5 93673,184,44,140,0.2391304347826087,15.515153186147865
ZCTA5 96729,333,62,271,0.18618618618618618,15.499408450914585
ZCTA5 78745,26330,1333,24997,0.050626661602734525,15.496009812380176
ZCTA5 70730,1428,153,1275,0.10714285714285714,15.48558450271778
ZCTA5 49450,997,121,876,0.1213640922768305,15.43647843418829
ZCTA5 95363,7273,480,6793,0.06599752509280903,15.43409635060153
ZCTA5 17509,1322,145,1177,0.10968229954614221,15.41323095948205
ZCTA5 16332,12,10,2,0.8333333333333334,15.409129707856929
ZCTA5 75149,17603,956,16647,0.05430892461512242,15.387211505771678
ZCTA5 00707,3862,301,3561,0.07793889176592439,15.3737348271207
ZCTA5 10553,3385,274,3111,0.08094534711964549,15.365782881763398
ZCTA5 85122,18859,1010,17849,0.0535553316718808,15.351185502493381
ZCTA5 86023,742,100,642,0.1347708894878706,15.347791095027336
ZCTA5 80915,8052,517,7535,0.06420765027322405,15.346458893164144
ZCTA5 37217,12857,743,12114,0.05778953099478883,15.345086685734975
ZCTA5 91906,1218,137,1081,0.11247947454844007,15.337427878758769
ZCTA5 98284,9578,590,8988,0.06159949885153477,15.318127024633249
ZCTA5 11701,8519,539,7980,0.06327033689400165,15.304111152918066
ZCTA5 11427,7500,489,7011,0.0652,15.289010527187763
ZCTA5 11103,15665,868,14797,0.05541015001595914,15.281979196184897
ZCTA5 57548,387,67,320,0.1731266149870801,15.280202814160726
ZCTA5 33838,1183,134,1049,0.1132713440405748,15.266920187530358
ZCTA5 33055,11368,673,10695,0.05920126671358199,15.266240703045336
ZCTA5 70812,3633,287,3346,0.0789980732177264,15.266002791617975
ZCTA5 38961,331,61,270,0.18429003021148035,15.260948265823151
ZCTA5 97862,4157,316,3841,0.07601635795044503,15.260764660311084
ZCTA5 48210,8971,560,8411,0.06242336417344778,15.258744490471784
ZCTA5 98148,4547,337,4210,0.074114800967671,15.247508724780065
ZCTA5 79072,8584,541,8043,0.06302423112767941,15.235582340232853
ZCTA5 89103,21695,1129,20566,0.052039640470154414,15.223505887742258
ZCTA5 33025,24198,1235,22963,0.05103727580791801,15.210605863301224
ZCTA5 49084,8,8,0,1,15.20304414661262
ZCTA5 85530,410,69,341,0.16829268292682928,15.183390939227529
ZCTA5 66536,1109,128,981,0.11541929666366095,15.179505164800469
ZCTA5 91724,7941,508,7433,0.06397179196574738,15.123430156423947
ZCTA5 78384,1670,167,1503,0.1,15.123130898386949
ZCTA5 16872,463,74,389,0.15982721382289417,15.121950640138792
ZCTA5 93286,2859,241,2618,0.08429520811472543,15.117638528380963
ZCTA5 39204,5918,407,5511,0.0687732342007435,15.109804323946157
ZCTA5 20109,13206,754,12452,0.05709525973042556,15.108273127952788
ZCTA5 93427,2123,196,1927,0.09232218558643429,15.084014984303517
ZCTA5 73601,3530,279,3251,0.07903682719546742,15.06084650276294
ZCTA5 93013,6232,422,5810,0.06771501925545571,15.040905677508116
ZCTA5 22304,21304,1107,20197,0.05196207285016898,15.022737310198503
ZCTA5 95610,17670,950,16720,0.053763440860215055,15.013227198048892
ZCTA5 33064,20480,1071,19409,0.052294921875,14.99424229616973
ZCTA5 90502,6011,410,5601,0.0682082848111795,14.984482579556483
ZCTA5 98004,16523,899,15624,0.054409005628517824,14.979254952174363
ZCTA5 65047,428,70,358,0.16355140186915887,14.967622557337931
ZCTA5 91101,10521,628,9893,0.05969014352247885,14.965372387925017
ZCTA5 56387,3339,267,3072,0.07996406109613657,14.945688915414845
ZCTA5 94949,7202,469,6733,0.0651207997778395,14.944812207847102
ZCTA5 00794,8918,552,8366,0.061897286387082306,14.937325612092474
ZCTA5 85939,1571,159,1412,0.10120942075111394,14.934603193495628
ZCTA5 57563,71,25,46,0.352112676056338,14.931991335175008
ZCTA5 70732,503,77,426,0.15308151093439365,14.920291260512926
ZCTA5 76104,6306,424,5882,0.06723755153821757,14.919086377563483
ZCTA5 80025,99,30,69,0.30303030303030304,14.916332511113378
ZCTA5 99503,5928,404,5524,0.06815114709851552,14.856205253598331
ZCTA5 46740,1289,139,1150,0.1078355314197052,14.850916824564239
ZCTA5 74728,4301,319,3982,0.0741687979539642,14.84900976166333
ZCTA5 56301,12052,696,11356,0.057749751078659144,14.832644260142223
ZCTA5 07002,24975,1257,23718,0.05033033033033033,14.831582655279338
ZCTA5 38801,11520,671,10849,0.05824652777777778,14.798095556292212
ZCTA5 57560,139,36,103,0.2589928057553957,14.787383759487202
ZCTA5 99773,62,23,39,0.3709677419354839,14.779172939665935
ZCTA5 67213,8723,540,8183,0.061905307806947155,14.777280308421227
ZCTA5 64126,2294,204,2090,0.08892763731473409,14.775580240013756
ZCTA5 85282,22334,1144,21190,0.051222351571594875,14.766835850346883
ZCTA5 78539,11164,654,10510,0.05858115370834826,14.764272350917558
ZCTA5 90703,15553,851,14702,0.05471613193596091,14.745922558840896
ZCTA5 60415,5159,363,4796,0.07036247334754797,14.742429476295808
ZCTA5 78336,4213,313,3900,0.07429385236173748,14.741456276159798
ZCTA5 76134,8320,520,7800,0.0625,14.733550471182216
ZCTA5 06114,9698,585,9113,0.06032171581769437,14.714006809078226
ZCTA5 93235,1245,135,1110,0.10843373493975904,14.712628857263384
ZCTA5 78629,4284,316,3968,0.07376283846872082,14.67187017971307
ZCTA5 01105,4965,352,4613,0.07089627391742195,14.671756060072656
ZCTA5 94608,14114,785,13329,0.05561853478815361,14.643400423383149
ZCTA5 34741,15205,833,14372,0.054784610325550806,14.626976532757306
ZCTA5 35951,4338,318,4020,0.07330567081604426,14.596601045279726
ZCTA5 87051,333,59,274,0.17717717717717718,14.585164100569237
ZCTA5 68801,10788,633,10155,0.05867630700778643,14.568476250460305
ZCTA5 85326,15693,853,14840,0.054355445102912125,14.560868084311814
ZCTA5 85344,3701,283,3418,0.0764658200486355,14.551507659967992
ZCTA5 33890,1463,149,1314,0.10184552289815448,14.547420796986964
ZCTA5 01840,2262,200,2062,0.08841732979664015,14.537191539527807
ZCTA5 22904,59,22,37,0.3728813559322034,14.498920720092759
ZCTA5 34208,12339,702,11637,0.05689277899343545,14.47883080852543
ZCTA5 78264,3089,248,2841,0.08028488183878278,14.47445181251036
ZCTA5 91203,5698,387,5311,0.06791856791856792,14.467519144720939
ZCTA5 33803,12015,687,11328,0.05717852684144819,14.461656107247764
ZCTA5 12779,771,98,673,0.12710765239948119,14.461518553817324
ZCTA5 77078,4672,334,4338,0.07148972602739725,14.457840448587287
ZCTA5 79932,8986,547,8439,0.06087246828399733,14.453918259277659
ZCTA5 78061,3181,253,2928,0.07953473750392959,14.453134791425017
ZCTA5 95697,144,36,108,0.25,14.450872164131704
ZCTA5 91917,205,44,161,0.2146341463414634,14.426138129554733
ZCTA5 73139,7325,467,6858,0.0637542662116041,14.421479998581392
ZCTA5 36801,9963,592,9371,0.05941985345779384,14.413074903824697
ZCTA5 78225,4174,307,3867,0.07355055103018687,14.406009158886441
ZCTA5 74128,4495,324,4171,0.07208008898776418,14.401440299985486
ZCTA5 13069,9236,557,8679,0.06030749242096146,14.351650592130355
ZCTA5 00772,6637,432,6205,0.0650896489377731,14.332514192910685
ZCTA5 79845,1761,167,1594,0.09483248154457695,14.323765456217677
ZCTA5 72209,11199,647,10552,0.05777301544780784,14.311801537582399
ZCTA5 78562,793,99,694,0.12484237074401008,14.311642885158113
ZCTA5 86545,372,62,310,0.16666666666666666,14.288259410555657
ZCTA5 89122,17869,941,16928,0.05266103307403884,14.278017757563157
ZCTA5 86039,403,65,338,0.16129032258064516,14.271482595257948
ZCTA5 78415,13442,747,12695,0.05557208748698111,14.26059901109081
ZCTA5 12590,12799,718,12081,0.05609813266661458,14.24629965840612
ZCTA5 12550,18991,988,18003,0.052024643252066766,14.231745863201574
ZCTA5 87121,23992,1199,22793,0.04997499166388796,14.23068910712807
ZCTA5 99732,7,7,0,1,14.22114560815586
ZCTA5 13208,8456,518,7938,0.061258278145695365,14.218486305763358
ZCTA5 99751,30,15,15,0.5,14.210783165202486
ZCTA5 22542,752,95,657,0.12632978723404256,14.163592054816442
ZCTA5 91210,308,55,253,0.17857142857142858,14.16306777976942
ZCTA5 60432,6184,407,5777,0.0658150064683053,14.151958997519483
ZCTA5 39092,1042,117,925,0.11228406909788867,14.151013336806272
ZCTA5 23824,2385,204,2181,0.08553459119496855,14.144290425698989
ZCTA5 84123,14379,786,13593,0.054663050281660755,14.14306719990589
ZCTA5 60406,8747,530,8217,0.060592203041042646,14.114640058979605
ZCTA5 78543,2491,210,2281,0.08430349257326375,14.113492761780417
ZCTA5 31075,950,110,840,0.11578947368421053,14.112716684154927
ZCTA5 95832,3156,248,2908,0.07858048162230671,14.098104292783534
ZCTA5 27260,9043,543,8500,0.06004644476390578,14.062858477627227
ZCTA5 78011,600,82,518,0.13666666666666666,14.05952739053694
ZCTA5 75551,4100,299,3801,0.07292682926829268,14.055638805007922
ZCTA5 97503,3895,288,3607,0.07394094993581515,14.051712781748616
ZCTA5 70805,9393,559,8834,0.05951240285318855,14.044586153310505
ZCTA5 60008,8313,508,7805,0.061109106219174786,14.022112675613291
ZCTA5 78204,4279,308,3971,0.07197943444730077,14.014545713547346
ZCTA5 77040,17924,937,16987,0.05227627761660344,14.013513498051182
ZCTA5 96786,12684,708,11976,0.05581835383159887,14.006924137596094
ZCTA5 71322,2221,193,2028,0.08689779378658262,14.006598504160578
ZCTA5 78656,712,91,621,0.12780898876404495,14.00125172189887
ZCTA5 94043,13024,723,12301,0.05551289926289926,13.9995562284837
ZCTA5 75116,6514,421,6093,0.06463002763279091,13.992790391183144
ZCTA5 93907,7235,456,6779,0.06302695231513476,13.988573727147278
ZCTA5 24854,85,26,59,0.3058823529411765,13.967687737944726
ZCTA5 41849,31,15,16,0.4838709677419355,13.946283725636865
ZCTA5 85225,25231,1242,23989,0.049225159525979945,13.931155416269894
ZCTA5 93445,2468,207,2261,0.08387358184764993,13.92941304874349
ZCTA5 57572,470,70,400,0.14893617021276595,13.922783674653832
ZCTA5 76708,9550,564,8986,0.05905759162303665,13.914304239983124
ZCTA5 81647,2489,208,2281,0.08356769787063077,13.90368388317358
ZCTA5 33018,14004,764,13240,0.05455584118823193,13.8868714942161
ZCTA5 39643,418,65,353,0.15550239234449761,13.876580647313785
ZCTA5 91356,11827,667,11160,0.05639638116174854,13.87503912103722
ZCTA5 75232,10943,627,10316,0.057296902129215024,13.870302125840189
ZCTA5 91502,5125,350,4775,0.06829268292682927,13.869752200080532
ZCTA5 33317,12456,695,11761,0.05579640333975594,13.86683946624999
ZCTA5 97026,1151,123,1028,0.10686359687228497,13.850076528094691
ZCTA5 84531,169,38,131,0.22485207100591717,13.837049362625411
ZCTA5 07034,3331,255,3076,0.07655358751125788,13.833149315530962
ZCTA5 96726,105,29,76,0.2761904761904762,13.832236114669884
ZCTA5 94038,1110,120,990,0.10810810810810811,13.831742568894988
ZCTA5 98812,1725,161,1564,0.09333333333333334,13.830339623972279
ZCTA5 98031,12093,678,11415,0.05606549243363929,13.827848497739001
ZCTA5 98331,2416,203,2213,0.08402317880794702,13.82277923733514
ZCTA5 60060,12666,703,11963,0.055502921206379285,13.799562670318995
ZCTA5 78380,7783,479,7304,0.06154439162276757,13.781313154060452
ZCTA5 88240,12655,702,11953,0.055472145397076254,13.774315903319353
ZCTA5 99666,40,17,23,0.425,13.771322790884218
ZCTA5 85128,4739,329,4410,0.06942392909896603,13.77028956425963
ZCTA5 86535,320,55,265,0.171875,13.77017109814684
ZCTA5 92040,15274,817,14457,0.05348959015320152,13.770074014930097
ZCTA5 01420,14817,797,14020,0.053789566039009244,13.765570909622507
ZCTA5 57432,155,36,119,0.23225806451612904,13.76428672568465
ZCTA5 84534,616,82,534,0.1331168831168831,13.75580033348408
ZCTA5 80204,13220,726,12494,0.05491679273827534,13.723347511639
ZCTA5 98824,100,28,72,0.28,13.71073285345501
ZCTA5 76018,9477,557,8920,0.0587738735886884,13.707423908187032
ZCTA5 86508,204,42,162,0.20588235294117646,13.695764597181213
ZCTA5 08232,6256,404,5852,0.06457800511508952,13.690002137757107
ZCTA5 08817,15657,831,14826,0.053075301781950565,13.653365655103993
ZCTA5 98146,10111,585,9526,0.05785777865690832,13.646234883542622
ZCTA5 33860,7979,486,7493,0.06090988845720015,13.638573150890078
ZCTA5 78702,9287,547,8740,0.05889953698718639,13.636666975253927
ZCTA5 38617,249,47,202,0.18875502008032127,13.628135152719473
ZCTA5 40007,50,19,31,0.38,13.627265813328599
ZCTA5 20012,6078,394,5684,0.06482395524843698,13.60047079501926
ZCTA5 71842,854,100,754,0.117096018735363,13.5929992857449
ZCTA5 75215,6450,412,6038,0.06387596899224807,13.587099764937886
ZCTA5 58538,650,84,566,0.12923076923076923,13.579346747960187
ZCTA5 81632,3235,247,2988,0.07635239567233384,13.568717982410464
ZCTA5 99634,115,30,85,0.2608695652173913,13.56225099261652
ZCTA5 77057,19836,1007,18829,0.05076628352490421,13.559332101770158
ZCTA5 19133,8907,528,8379,0.05927921859211856,13.554037609176122
ZCTA5 99685,897,103,794,0.11482720178372352,13.553124957935392
ZCTA5 27610,25377,1237,24140,0.04874492650825551,13.545966772266056
ZCTA5 11215,28635,1370,27265,0.04784354810546534,13.541019722125005
ZCTA5 15464,604,80,524,0.13245033112582782,13.530056879131413
ZCTA5 27960,217,43,174,0.19815668202764977,13.4925186803708
ZCTA5 33801,12271,679,11592,0.05533371363377068,13.478445579097174
ZCTA5 78202,3848,279,3569,0.0725051975051975,13.471385430949258
ZCTA5 87712,78,24,54,0.3076923076923077,13.469087492004919
ZCTA5 31518,340,56,284,0.16470588235294117,13.458830426850213
ZCTA5 60040,1999,175,1824,0.08754377188594298,13.448773895043772
ZCTA5 93950,6845,429,6416,0.06267348429510591,13.443696951107963
ZCTA5 87357,227,44,183,0.19383259911894274,13.437603314363534
ZCTA5 99363,67,22,45,0.3283582089552239,13.423975547622193
ZCTA5 77864,2829,223,2606,0.07882644043831742,13.420520923177097
ZCTA5 98850,611,80,531,0.1309328968903437,13.399643603148922
ZCTA5 70039,964,107,857,0.11099585062240663,13.388638926846745
ZCTA5 30297,8883,524,8359,0.05898908026567601,13.383692959505574
ZCTA5 85619,42,17,25,0.40476190476190477,13.382020654148514
ZCTA5 32811,15429,815,14614,0.05282260677944131,13.379036171302594
ZCTA5 91106,10554,600,9954,0.05685048322910745,13.366498263410621
ZCTA5 77084,34864,1614,33250,0.04629417163836622,13.332578485341443
ZCTA5 99654,18101,928,17173,0.05126788575216839,13.32806232858278
ZCTA5 55904,10195,583,9612,0.057184894556154976,13.324972107661758
ZCTA5 33514,690,86,604,0.1246376811594203,13.319981635814136
ZCTA5 77042,19198,974,18224,0.050734451505365145,13.314962871855816
ZCTA5 27560,12595,690,11905,0.05478364430329496,13.311922153717797
ZCTA5 68067,325,54,271,0.16615384615384615,13.303760902813705
ZCTA5 75254,11720,651,11069,0.055546075085324234,13.300211950077848
ZCTA5 95360,3830,276,3554,0.07206266318537859,13.287537217412773
ZCTA5 52584,188,39,149,0.2074468085106383,13.267000572409371
ZCTA5 33134,16304,850,15454,0.05213444553483808,13.26452380877746
ZCTA5 33193,14402,768,13634,0.05332592695458964,13.262001819910221
ZCTA5 98672,2679,213,2466,0.07950727883538634,13.255853891117196
ZCTA5 97875,1031,111,920,0.10766246362754607,13.250872063812654
ZCTA5 30071,7474,456,7018,0.06101150655606101,13.248773752396835
ZCTA5 79336,5980,384,5596,0.06421404682274247,13.228092128477671
ZCTA5 49255,722,88,634,0.12188365650969529,13.213822221931343
ZCTA5 20781,3770,272,3498,0.07214854111405836,13.212369914700165
ZCTA5 78417,1328,131,1197,0.09864457831325302,13.211294001730522
ZCTA5 08360,14453,769,13684,0.05320694665467377,13.20591681057001
ZCTA5 33406,8580,507,8073,0.05909090909090909,13.205906878027115
ZCTA5 77469,15544,816,14728,0.05249613998970664,13.202452318148726
ZCTA5 90601,11097,621,10476,0.05596107055961071,13.184999002439408
ZCTA5 33907,9546,551,8995,0.0577205112088833,13.18489701892348
ZCTA5 93560,6969,431,6538,0.061845314966279236,13.18044499216437
ZCTA5 60101,13261,716,12545,0.05399291154513234,13.152958105098433
ZCTA5 02151,19999,1003,18996,0.05015250762538127,13.132229429066626
ZCTA5 76059,1569,146,1423,0.09305289993626514,13.128377186235541
ZCTA5 88260,4679,318,4361,0.06796324000854884,13.127194704746547
ZCTA5 48122,3734,269,3465,0.07204070701660417,13.112491363743061
ZCTA5 72761,7459,453,7006,0.060732001608794745,13.101228810317016
ZCTA5 06610,8553,504,8049,0.058926692388635564,13.10065419133092
ZCTA5 37181,628,80,548,0.12738853503184713,13.090827686161427
ZCTA5 97913,1750,157,1593,0.08971428571428572,13.088268029477632
ZCTA5 99690,39,16,23,0.41025641025641024,13.086057840330163
ZCTA5 76504,8929,521,8408,0.05834919923843655,13.082050315560405
ZCTA5 99740,209,41,168,0.19617224880382775,13.081931974673331
ZCTA5 16434,933,103,830,0.11039657020364416,13.06980930902142
ZCTA5 77461,3840,274,3566,0.07135416666666666,13.060717081508175
ZCTA5 74960,4538,310,4228,0.06831203173204055,13.058555744383533
ZCTA5 84532,4149,290,3859,0.06989636056881177,13.053843265457044
ZCTA5 15646,59,20,39,0.3389830508474576,13.050925470331839
ZCTA5 60608,25627,1233,24394,0.04811331798493776,13.05023733529021
ZCTA5 60181,10776,604,10172,0.05605048255382331,13.044516511763758
ZCTA5 20170,13387,719,12668,0.053708821991484273,13.03250389024484
ZCTA5 72611,595,77,518,0.12941176470588237,13.016691868219832
ZCTA5 84005,6937,427,6510,0.0615539858728557,13.015211871633324
ZCTA5 95037,17265,885,16380,0.051259774109470024,13.010716571731766
ZCTA5 33065,17886,911,16975,0.05093369115509337,13.000118769905452
ZCTA5 33873,4357,300,4057,0.06885471654808355,12.994689923303122
ZCTA5 95833,14722,776,13946,0.05271022958837115,12.993082185927873
ZCTA5 98836,315,52,263,0.16507936507936508,12.991436958277639
ZCTA5 95335,109,28,81,0.25688073394495414,12.97212272139431
ZCTA5 79403,5766,370,5396,0.06416926812348249,12.9703367363985
ZCTA5 38863,7163,437,6726,0.0610079575596817,12.968527814145482
ZCTA5 86034,598,77,521,0.12876254180602006,12.961176600545729
ZCTA5 86506,358,56,302,0.1564245810055866,12.93912787545525
ZCTA5 01854,9492,544,8948,0.05731142014327855,12.925904762052443
ZCTA5 19082,14135,749,13386,0.05298903431199151,12.915751737910531
ZCTA5 35601,12393,673,11720,0.05430484951182119,12.90832621726337
ZCTA5 78213,16098,833,15265,0.05174555845446639,12.906066476085085
ZCTA5 53215,19135,961,18174,0.05022210608831983,12.898967108030115
ZCTA5 95336,15429,804,14625,0.052109663620454987,12.886558048284256
ZCTA5 93660,1120,115,1005,0.10267857142857142,12.8834112464569
ZCTA5 93534,13943,740,13203,0.05307322670874274,12.883018396030664
ZCTA5 66762,9712,553,9159,0.05693986820428336,12.871213453412706
ZCTA5 07650,7516,452,7064,0.0601383714741884,12.86498998872398
ZCTA5 57621,66,21,45,0.3181818181818182,12.863662435823516
ZCTA5 33610,16005,828,15177,0.05173383317713215,12.860483317938435
ZCTA5 23301,495,68,427,0.13737373737373737,12.857683916715807
ZCTA5 94515,2970,225,2745,0.07575757575757576,12.820822578480374
ZCTA5 97201,9116,525,8591,0.05759104870557262,12.815778294568219
ZCTA5 34947,3991,279,3712,0.06990729140566274,12.806716265996492
ZCTA5 28441,1277,125,1152,0.09788566953797964,12.804313534790369
ZCTA5 95951,856,96,760,0.11214953271028037,12.804090441392749
ZCTA5 77598,11012,610,10402,0.055394115510352344,12.803544715173993
ZCTA5 78560,1354,130,1224,0.09601181683899557,12.801248627161993
ZCTA5 44491,984,105,879,0.10670731707317073,12.778695261529336
ZCTA5 65535,547,72,475,0.1316270566727605,12.768739316020763
ZCTA5 78653,6846,419,6427,0.0612036225533158,12.768349813229639
ZCTA5 94010,16037,827,15210,0.051568248425515995,12.75672087810104
ZCTA5 79323,2197,181,2016,0.08238507055075102,12.754419006710446
ZCTA5 02149,15736,814,14922,0.051728520589730556,12.748244593419525
ZCTA5 10018,5095,334,4761,0.06555446516192345,12.742164094278644
ZCTA5 75069,13853,733,13120,0.05291272648523786,12.736318550686343
ZCTA5 56671,861,96,765,0.11149825783972125,12.735156623274463
ZCTA5 36016,1439,135,1304,0.09381514940931203,12.733542767863844
ZCTA5 99783,56,19,37,0.3392857142857143,12.727389225743732
ZCTA5 33175,15655,810,14845,0.05174065793676142,12.72383716528914
ZCTA5 78224,5692,363,5329,0.06377371749824315,12.72088046820095
ZCTA5 98052,26876,1274,25602,0.04740288733442476,12.716783172943051
ZCTA5 70052,1363,130,1233,0.09537784299339692,12.71356147124198
ZCTA5 48209,9956,561,9395,0.056347930895942144,12.703436723018084
ZCTA5 22042,12420,670,11750,0.05394524959742351,12.699514075068842
ZCTA5 77664,934,101,833,0.10813704496788008,12.692791672859887
ZCTA5 07050,12245,662,11583,0.054062882809309924,12.68211646103507
ZCTA5 83338,6897,420,6477,0.060896041757285774,12.673767475724066
ZCTA5 95437,5872,371,5501,0.06318119891008174,12.667955145433087
ZCTA5 28508,811,92,719,0.11344019728729964,12.66739375751948
ZCTA5 87034,516,69,447,0.13372093023255813,12.666150291076164
ZCTA5 84737,6081,381,5700,0.06265416872224963,12.662874458504819
ZCTA5 98178,9572,543,9029,0.056727956539908066,12.662809061357306
ZCTA5 91202,8764,506,8258,0.057736193518941124,12.641476099988902
ZCTA5 99749,80,23,57,0.2875,12.63630429973603
ZCTA5 95425,3935,274,3661,0.0696315120711563,12.62034477000535
ZCTA5 41085,318,51,267,0.16037735849056603,12.586860224097011
ZCTA5 94503,5442,349,5093,0.06413083425211319,12.584890053791254
ZCTA5 28544,2416,192,2224,0.07947019867549669,12.57824351314536
ZCTA5 33413,5099,332,4767,0.06511080604040008,12.570985567493356
ZCTA5 52307,94,25,69,0.26595744680851063,12.535913995002891
ZCTA5 95317,270,46,224,0.17037037037037037,12.511218706315413
ZCTA5 78201,16314,833,15481,0.05106043888684565,12.505721394163194
ZCTA5 97527,14976,776,14200,0.05181623931623932,12.496281754081547
ZCTA5 98947,879,96,783,0.10921501706484642,12.491136427408877
ZCTA5 78026,1895,161,1734,0.08496042216358839,12.468868221829553
ZCTA5 84645,704,83,621,0.11789772727272728,12.459929610520971
ZCTA5 15750,116,28,88,0.2413793103448276,12.453716625139627
ZCTA5 28365,6083,378,5705,0.06214039125431531,12.442114622620636
ZCTA5 96705,786,89,697,0.11323155216284987,12.438092133938474
ZCTA5 98266,1475,135,1340,0.09152542372881356,12.402800735385586
ZCTA5 33811,7782,457,7325,0.058725263428424566,12.397423302949807
ZCTA5 87020,3966,273,3693,0.06883509833585477,12.391039804145382
ZCTA5 96778,5849,366,5483,0.06257479911095915,12.38521435966166
ZCTA5 87310,274,46,228,0.1678832116788321,12.374603003231453
ZCTA5 98404,11384,618,10766,0.05428671820098384,12.360935263072195
ZCTA5 93652,103,26,77,0.2524271844660194,12.35868318792557
ZCTA5 59016,275,46,229,0.16727272727272727,12.340864390375607
ZCTA5 33132,6389,391,5998,0.06119893567068399,12.332735304661062
ZCTA5 49509,9964,554,9410,0.05560016057808109,12.293443835058877
ZCTA5 78352,111,27,84,0.24324324324324326,12.291569379336378
ZCTA5 07310,5776,361,5415,0.0625,12.27606966393446
ZCTA5 41214,238,42,196,0.17647058823529413,12.269794302450366
ZCTA5 77032,4210,284,3926,0.067458432304038,12.26977332001683
ZCTA5 78218,12458,663,11795,0.053218815219136295,12.268023239126926
ZCTA5 85321,1655,145,1510,0.08761329305135952,12.25273762028046
ZCTA5 96713,395,57,338,0.14430379746835442,12.251679354957213
ZCTA5 68108,5142,330,4812,0.06417736289381563,12.251645140645039
ZCTA5 92260,15607,797,14810,0.05106682898699302,12.236179302254207
ZCTA5 95540,5395,342,5053,0.0633920296570899,12.228648697867104
ZCTA5 30008,10804,590,10214,0.054609403924472416,12.228456358540512
ZCTA5 84047,13013,686,12327,0.052716514254975796,12.21966256357186
ZCTA5 11412,11039,600,10439,0.05435274934323761,12.210772201645211
ZCTA5 25103,60,19,41,0.31666666666666665,12.199753714983792
ZCTA5 92869,11597,624,10973,0.05380701905665258,12.188759119783054
ZCTA5 87507,17947,894,17053,0.04981333927675935,12.187600737502484
ZCTA5 35805,9180,517,8663,0.05631808278867102,12.182419085570235
ZCTA5 20784,9583,535,9048,0.055828028801001774,12.180167033357984
ZCTA5 12751,290,47,243,0.16206896551724137,12.180154856540089
ZCTA5 27597,8516,487,8029,0.05718647252231095,12.179217809628655
ZCTA5 10069,2552,196,2356,0.0768025078369906,12.177976641914581
ZCTA5 89019,946,99,847,0.10465116279069768,12.17782929078015
ZCTA5 02907,9004,509,8495,0.05653043091959129,12.177127066968097
ZCTA5 75556,410,58,352,0.14146341463414633,12.162299264552763
ZCTA5 32040,2465,191,2274,0.07748478701825558,12.156977078637274
ZCTA5 92249,1836,155,1681,0.08442265795206971,12.145085021919249
ZCTA5 78664,20075,981,19094,0.0488667496886675,12.144063330531806
ZCTA5 95439,232,41,191,0.17672413793103448,12.13562262256238
ZCTA5 87001,907,96,811,0.10584343991179714,12.123848793732034
ZCTA5 98144,13439,702,12737,0.05223602946647816,12.108305670741913
ZCTA5 97220,11544,620,10924,0.05370755370755371,12.10144400055383
ZCTA5 08102,2439,189,2250,0.07749077490774908,12.094337776966627
ZCTA5 95449,508,66,442,0.12992125984251968,12.091323016794831
ZCTA5 97624,1494,134,1360,0.08969210174029452,12.08835411016922
ZCTA5 78216,17177,859,16318,0.050008732607556616,12.065697531764348
ZCTA5 38118,12911,678,12233,0.05251336070017814,12.043306388499431
ZCTA5 28578,2218,176,2042,0.0793507664562669,12.020530872457899
ZCTA5 83355,1437,130,1307,0.09046624913013222,12.01870861488954
ZCTA5 84057,11987,637,11350,0.05314090264453158,11.986442126361467
ZCTA5 14721,56,18,38,0.32142857142857145,11.984251799869963
ZCTA5 95948,3645,252,3393,0.0691358024691358,11.979968147654283
ZCTA5 87413,5677,352,5325,0.06200457988374141,11.962824594602465
ZCTA5 38037,630,75,555,0.11904761904761904,11.947403911049866
ZCTA5 00741,1494,133,1361,0.08902275769745649,11.944478278009218
ZCTA5 37210,7053,416,6637,0.058981993477952646,11.922368124928399
ZCTA5 95665,1764,149,1615,0.0844671201814059,11.91494940487249
ZCTA5 57339,409,57,352,0.1393643031784841,11.911377537400423
ZCTA5 92401,672,78,594,0.11607142857142858,11.910175107902761
ZCTA5 78005,219,39,180,0.1780821917808219,11.902478684784768
ZCTA5 65620,88,23,65,0.26136363636363635,11.88958500972865
ZCTA5 33165,16079,809,15270,0.0503140742583494,11.889010892980979
ZCTA5 32822,22469,1072,21397,0.04771017846811162,11.88366899921106
ZCTA5 95130,5137,325,4812,0.06326649795600545,11.882632462228553
ZCTA5 59031,75,21,54,0.28,11.873842955593943
ZCTA5 76706,13206,687,12519,0.05202180826896865,11.865979793114025
ZCTA5 80030,6238,377,5861,0.0604360371914075,11.851042499713426
ZCTA5 72070,718,81,637,0.11281337047353761,11.825573695631132
ZCTA5 22960,3780,257,3523,0.06798941798941799,11.807844582974143
ZCTA5 70760,2488,189,2299,0.07596463022508039,11.79188761402727
ZCTA5 44606,2219,174,2045,0.07841369986480397,11.777762517834521
ZCTA5 92708,18892,923,17969,0.04885665890323947,11.773098644274796
ZCTA5 71973,588,71,517,0.12074829931972789,11.771625936183776
ZCTA5 90064,10958,588,10370,0.05365942690271947,11.762278725294173
ZCTA5 47011,293,46,247,0.15699658703071673,11.760147593552764
ZCTA5 54150,347,51,296,0.14697406340057637,11.759789711050953
ZCTA5 26691,151,31,120,0.2052980132450331,11.743171336324835
ZCTA5 92275,822,88,734,0.1070559610705596,11.735104753669804
ZCTA5 33435,13441,694,12747,0.051633063016144634,11.720455112434445
ZCTA5 95686,371,53,318,0.14285714285714285,11.718685810176051
ZCTA5 99501,7646,440,7206,0.05754642950562386,11.715380437968587
ZCTA5 83423,274,44,230,0.16058394160583941,11.702682549463646
ZCTA5 39067,541,67,474,0.12384473197781885,11.691883655439124
ZCTA5 47542,3806,257,3549,0.0675249605885444,11.689037151646314
ZCTA5 75604,11361,603,10758,0.053076313704779506,11.63097501827451
ZCTA5 29506,7149,416,6733,0.05818995663729193,11.630814488848397
ZCTA5 78575,3445,238,3207,0.0690856313497823,11.630286885074495
ZCTA5 39561,888,92,796,0.1036036036036036,11.625009266341237
ZCTA5 77009,13848,709,13139,0.051198729058347776,11.612345383327746
ZCTA5 95571,121,27,94,0.2231404958677686,11.603571303220098
ZCTA5 78552,12117,635,11482,0.05240571098456714,11.601213300694312
ZCTA5 98108,8645,483,8162,0.055870445344129556,11.590643848354564
ZCTA5 72531,377,53,324,0.14058355437665782,11.567569298636796
ZCTA5 28377,4214,276,3938,0.06549596582819174,11.567145171247125
ZCTA5 77033,8996,498,8498,0.05535793686082703,11.553274859937162
ZCTA5 12762,258,42,216,0.16279069767441862,11.552977591992903
ZCTA5 98424,4097,270,3827,0.06590187942396876,11.549923595918262
ZCTA5 92108,11097,590,10507,0.05316752275389745,11.548476248262526
ZCTA5 99745,33,13,20,0.3939393939393939,11.51615468252644
ZCTA5 21205,5217,324,4893,0.0621046578493387,11.50812006266292
ZCTA5 97128,14067,716,13351,0.0508992677898628,11.506290217739675
ZCTA5 60644,16339,811,15528,0.04963584062672134,11.502628959565618
ZCTA5 75039,9697,528,9169,0.05444982984428174,11.497667144943005
ZCTA5 79070,3317,230,3087,0.06933976484775399,11.493573364647872
ZCTA5 33598,5453,335,5118,0.06143407298734641,11.490154511918664
ZCTA5 72756,15916,793,15123,0.0498240764011058,11.484820280760283
ZCTA5 59003,404,55,349,0.13613861386138615,11.477786696582887
ZCTA5 76118,5521,338,5183,0.06122079333454084,11.473445278827509
ZCTA5 10282,2231,172,2059,0.07709547288211564,11.463305073278267
ZCTA5 96791,2304,176,2128,0.0763888888888889,11.460728008047482
ZCTA5 90755,4607,294,4313,0.06381593227696983,11.460355613029964
ZCTA5 85928,429,57,372,0.13286713286713286,11.45076400818601
ZCTA5 53713,10129,546,9583,0.05390463026952315,11.44584432168932
ZCTA5 52537,2620,193,2427,0.07366412213740459,11.445808937799988
ZCTA5 98247,3082,217,2865,0.07040882543802726,11.40900286647998
ZCTA5 78370,1575,134,1441,0.08507936507936507,11.393691720966295
ZCTA5 33403,4236,275,3961,0.06491973559962229,11.388737171909897
ZCTA5 99350,5149,319,4830,0.06195377743251117,11.372665402407662
ZCTA5 34743,11779,616,11163,0.05229645980134137,11.372323580883208
ZCTA5 75706,2841,204,2637,0.07180570221752904,11.367908913489478
ZCTA5 97060,7458,426,7032,0.05711987127916331,11.365597159925386
ZCTA5 97108,204,36,168,0.17647058823529413,11.359622185283282
ZCTA5 77026,7995,450,7545,0.05628517823639775,11.352616377505148
ZCTA5 92058,14202,718,13484,0.050556259681734966,11.33404847814654
ZCTA5 38589,74,20,54,0.2702702702702703,11.328961132045455
ZCTA5 78245,21675,1025,20650,0.04728950403690888,11.32739013445206
ZCTA5 60164,6551,384,6167,0.05861700503739887,11.32596324493217
ZCTA5 95123,22645,1064,21581,0.04698608964451314,11.324164598420786
ZCTA5 78719,447,58,389,0.1297539149888143,11.322483280998636
ZCTA5 10562,10900,577,10323,0.05293577981651376,11.310960043747077
ZCTA5 94551,15530,773,14757,0.04977462974887315,11.310430938433639
ZCTA5 38665,854,88,766,0.10304449648711944,11.309423348859111
ZCTA5 99356,88,22,66,0.25,11.296766423639507
ZCTA5 10570,4116,268,3848,0.06511175898931001,11.294774849556125
ZCTA5 91351,9871,532,9339,0.053895248708337555,11.293949664321804
ZCTA5 89501,2427,181,2246,0.07457766790276062,11.266453937446158
ZCTA5 31408,3091,216,2875,0.06988029763830475,11.262238205592988
ZCTA5 33177,14600,733,13867,0.050205479452054794,11.25605689110795
ZCTA5 59417,2245,171,2074,0.07616926503340757,11.255165621735927
ZCTA5 11965,310,46,264,0.14838709677419354,11.253514129156493
ZCTA5 22026,4723,297,4426,0.06288376032182935,11.247478342281514
ZCTA5 28333,3886,256,3630,0.06587750900669069,11.240127036961153
ZCTA5 59448,152,30,122,0.19736842105263158,11.238321311352179
ZCTA5 85307,3369,230,3139,0.06826951617690709,11.237853876546456
ZCTA5 55119,15236,759,14477,0.0498162247309005,11.231412140287688
ZCTA5 42344,289,44,245,0.1522491349480969,11.230777216930994
ZCTA5 74116,1477,127,1350,0.08598510494245092,11.227107197103056
ZCTA5 79407,9145,499,8646,0.054565336249316566,11.22704841812043
ZCTA5 99008,237,39,198,0.16455696202531644,11.224034634850163
ZCTA5 33157,19426,930,18496,0.047873983321321936,11.176661234742522
ZCTA5 99668,30,12,18,0.4,11.164826119094302
ZCTA5 78639,3306,226,3080,0.06836055656382335,11.16139501303927
ZCTA5 33905,11385,595,10790,0.052261747913921824,11.159910253196799
ZCTA5 93535,20976,992,19984,0.04729214340198322,11.145369871068812
ZCTA5 77043,9200,500,8700,0.05434782608695652,11.144737750201958
ZCTA5 84115,10997,578,10419,0.05255978903337274,11.14190804083
ZCTA5 39212,11441,597,10844,0.052180753430644176,11.139144804005245
ZCTA5 71254,1850,148,1702,0.08,11.133431722963035
ZCTA5 98811,51,16,35,0.3137254901960784,11.130810053736818
ZCTA5 96035,1290,115,1175,0.08914728682170543,11.123946902070607
ZCTA5 33916,8169,454,7715,0.05557595788958257,11.119013598132453
ZCTA5 93022,2508,184,2324,0.0733652312599681,11.115252325690555
ZCTA5 29624,6444,376,6068,0.05834885164494103,11.113378497198147
ZCTA5 92282,420,55,365,0.13095238095238096,11.111791549259381
ZCTA5 80620,6490,378,6112,0.058243451463790445,11.105753866161782
ZCTA5 43231,7908,442,7466,0.05589276681841174,11.096618029946093
ZCTA5 00714,5974,354,5620,0.059256779377301644,11.090676776653922
ZCTA5 55420,8745,479,8266,0.05477415666094911,11.08736554956165
ZCTA5 15695,192,34,158,0.17708333333333334,11.06766874754073
ZCTA5 33852,8301,459,7842,0.05529454282616552,11.065902108926771
ZCTA5 20019,23813,1103,22710,0.04631923739134086,11.040267343048802
ZCTA5 92233,1043,99,944,0.09491850431447747,11.03895398964258
ZCTA5 83842,84,21,63,0.25,11.037035925043973
ZCTA5 02301,21401,1006,20395,0.04700714919863558,11.025858376316746
ZCTA5 78602,8931,486,8445,0.05441719852200202,11.017056413410723
ZCTA5 22003,18984,908,18076,0.04782975136957438,11.014886586892002
ZCTA5 92078,16986,826,16160,0.04862828211468268,10.997898939778581
ZCTA5 78549,254,40,214,0.15748031496062992,10.992411371074
ZCTA5 21649,567,66,501,0.1164021164021164,10.98398420335049
ZCTA5 80443,1748,141,1607,0.08066361556064074,10.976453235678203
ZCTA5 94019,7328,414,6914,0.056495633187772926,10.968934328090677
ZCTA5 65456,287,43,244,0.14982578397212543,10.963541305612788
ZCTA5 76661,2293,171,2122,0.07457479284779764,10.950249655952117
ZCTA5 65625,2899,203,2696,0.07002414625733011,10.94992112838588
ZCTA5 42157,149,29,120,0.19463087248322147,10.941033151931721
ZCTA5 79925,14669,729,13940,0.049696639171040974,10.939899465826374
ZCTA5 07504,3554,236,3318,0.06640405177265053,10.923823482437223
ZCTA5 33825,9082,491,8591,0.05406298172208764,10.922075530100754
ZCTA5 63390,3939,255,3684,0.06473724295506474,10.918536834728185
ZCTA5 59521,993,95,898,0.09566968781470292,10.902747084619628
ZCTA5 72527,168,31,137,0.18452380952380953,10.889169371992102
ZCTA5 78332,9349,502,8847,0.05369558241523158,10.883907402965255
ZCTA5 77378,5157,313,4844,0.0606942020554586,10.87847610629273
ZCTA5 38879,301,44,257,0.1461794019933555,10.875950621305746
ZCTA5 05454,1815,144,1671,0.07933884297520662,10.8709713633516
ZCTA5 54812,2013,155,1858,0.07699950322901143,10.864903207343666
ZCTA5 72432,2513,182,2331,0.07242339832869081,10.86376376482164
ZCTA5 78934,2196,165,2031,0.07513661202185792,10.862546364863437
ZCTA5 51442,3270,221,3049,0.06758409785932722,10.853539326459028
ZCTA5 77071,10040,531,9509,0.05288844621513944,10.829205655784106
ZCTA5 56666,238,38,200,0.15966386554621848,10.827895901872875
ZCTA5 97266,12363,630,11733,0.050958505217180296,10.823525255172532
ZCTA5 56347,2711,192,2519,0.07082257469568425,10.820106651179175
ZCTA5 83607,7989,441,7548,0.0552009012392039,10.809404287087903
ZCTA5 33476,2735,193,2542,0.07056672760511883,10.793486899819234
ZCTA5 18101,1563,129,1434,0.08253358925143954,10.790494539073313
ZCTA5 96720,17162,828,16334,0.048246125160237734,10.776316744873494
ZCTA5 97844,1344,116,1228,0.08630952380952381,10.775839493980886
ZCTA5 25431,110,24,86,0.21818181818181817,10.774353105048672
ZCTA5 82514,474,58,416,0.12236286919831224,10.764557619547054
ZCTA5 33440,6467,372,6095,0.05752280810267512,10.763776286517938
ZCTA5 42436,399,52,347,0.13032581453634084,10.760833506388863
ZCTA5 17536,793,81,712,0.1021437578814628,10.756974769361433
ZCTA5 60169,11615,597,11018,0.05139905294877314,10.755025979227097
ZCTA5 94613,4,4,0,1,10.750175610748231
ZCTA5 33189,7943,438,7505,0.05514289311343321,10.749489109663262
ZCTA5 98829,220,36,184,0.16363636363636364,10.738059555782975
ZCTA5 86544,295,43,252,0.14576271186440679,10.727206406440839
ZCTA5 92544,15314,751,14563,0.049040094031605065,10.72600049479923
ZCTA5 29718,1557,128,1429,0.08220937700706486,10.698619734047144
ZCTA5 10710,10118,532,9586,0.052579561178098436,10.69840438544188
ZCTA5 07102,5079,307,4772,0.06044496948218153,10.697116501275326
ZCTA5 75172,1205,107,1098,0.08879668049792531,10.683533205056818
ZCTA5 00670,2833,197,2636,0.06953759265795977,10.680539853594377
ZCTA5 46571,1322,114,1208,0.08623298033282904,10.671803467193163
ZCTA5 72842,479,58,421,0.12108559498956159,10.665725068221379
ZCTA5 95633,1306,113,1193,0.08652373660030628,10.665460885337087
ZCTA5 39837,2471,178,2293,0.07203561311210037,10.66539869338382
ZCTA5 60123,16665,805,15860,0.0483048304830483,10.66127768166328
ZCTA5 65708,4476,278,4198,0.06210902591599642,10.661178446483015
ZCTA5 15953,43,14,29,0.32558139534883723,10.652935336792138
ZCTA5 58528,146,28,118,0.1917808219178082,10.638818149254417
ZCTA5 37738,2400,174,2226,0.0725,10.637572784525155
ZCTA5 20032,14766,726,14040,0.04916700528240553,10.61810324595107
ZCTA5 57716,129,26,103,0.20155038759689922,10.617340335069516
ZCTA5 68105,9458,502,8956,0.05307676041446394,10.612492216798085
ZCTA5 28352,9298,495,8803,0.05323725532372553,10.608407656742767
ZCTA5 86432,1603,130,1473,0.08109794135995009,10.60804411075653
ZCTA5 70651,68,18,50,0.2647058823529412,10.604798277689467
ZCTA5 78590,82,20,62,0.24390243902439024,10.597788978827516
ZCTA5 79347,2219,164,2055,0.07390716538981523,10.59721221709395
ZCTA5 92101,23297,1070,22227,0.04592866034253337,10.58846963896802
ZCTA5 99701,6924,390,6534,0.05632582322357019,10.583705038836433
ZCTA5 75233,5025,303,4722,0.060298507462686564,10.582361331567558
ZCTA5 07086,6461,369,6092,0.05711190218232472,10.575104610473424
ZCTA5 45404,4164,262,3902,0.06292026897214217,10.574016442974354
ZCTA5 43210,335,46,289,0.1373134328358209,10.571350071173445
ZCTA5 78406,383,50,333,0.13054830287206268,10.567084172784716
ZCTA5 92614,9804,516,9288,0.05263157894736842,10.559732846544904
ZCTA5 59066,157,29,128,0.18471337579617833,10.539853185146661
ZCTA5 75644,4528,279,4249,0.06161660777385159,10.538659620991917
ZCTA5 78942,2979,203,2776,0.06814367237327962,10.529202429769292
ZCTA5 85365,18790,888,17902,0.04725918041511442,10.523513914466024
ZCTA5 96741,2047,154,1893,0.07523204689789936,10.511570553090333
ZCTA5 75751,5692,333,5359,0.05850316233309909,10.509558622715016
ZCTA5 87319,474,57,417,0.12025316455696203,10.509126400266883
ZCTA5 14614,69,18,51,0.2608695652173913,10.505274446297758
ZCTA5 55444,5089,305,4784,0.05993318923167616,10.504610800668502
ZCTA5 44624,1358,115,1243,0.08468335787923417,10.498562324455861
ZCTA5 83262,386,50,336,0.12953367875647667,10.497532185177311
ZCTA5 86320,843,83,760,0.09845788849347568,10.495777253600808
ZCTA5 96748,1513,124,1389,0.08195637805684071,10.491640744572342
ZCTA5 97317,7675,422,7253,0.05498371335504886,10.489035545301745
ZCTA5 42280,140,27,113,0.19285714285714287,10.48874110128838
ZCTA5 77327,7795,427,7368,0.054778704297626685,10.47005942115357
ZCTA5 07203,7528,415,7113,0.055127523910733264,10.457490656357907
ZCTA5 74059,2130,158,1972,0.07417840375586854,10.452135335844586
ZCTA5 79705,14442,709,13733,0.049092923417809166,10.451454783880024
ZCTA5 98903,5256,312,4944,0.0593607305936073,10.444778978900466
ZCTA5 98007,11569,589,10980,0.05091191978563402,10.442328430584963
ZCTA5 96738,2587,182,2405,0.07035175879396985,10.436584992033048
ZCTA5 77517,1767,138,1629,0.07809847198641766,10.436303184631788
ZCTA5 91980,84,20,64,0.23809523809523808,10.43026675765861
ZCTA5 52162,1248,108,1140,0.08653846153846154,10.428835482841492
ZCTA5 79930,10279,534,9745,0.051950578850082696,10.428554947882484
ZCTA5 93631,5350,316,5034,0.059065420560747664,10.417643169918307
ZCTA5 98661,18513,874,17639,0.04721006860044293,10.408496689960472
ZCTA5 94404,14260,700,13560,0.04908835904628331,10.382359551573403
ZCTA5 99590,57,16,41,0.2807017543859649,10.380839896258683
ZCTA5 39834,993,92,901,0.09264853977844914,10.373315584046916
ZCTA5 85746,14561,712,13849,0.04889774053979809,10.363447051350082
ZCTA5 96703,590,65,525,0.11016949152542373,10.362649604497848
ZCTA5 34112,12201,614,11587,0.05032374395541349,10.362461560276271
ZCTA5 28212,16004,771,15233,0.04817545613596601,10.356686537641577
ZCTA5 92398,647,69,578,0.10664605873261206,10.353275510375642
ZCTA5 75692,1530,124,1406,0.08104575163398693,10.352334034191205
ZCTA5 93666,231,36,195,0.15584415584415584,10.344624723980926
ZCTA5 29709,2759,190,2569,0.06886553098948894,10.343812580513234
ZCTA5 75155,825,81,744,0.09818181818181818,10.339020984178044
ZCTA5 58316,2093,155,1938,0.0740563784042045,10.329910737492925
ZCTA5 11581,6854,383,6471,0.05587977823168953,10.324710700278072
ZCTA5 76120,7191,398,6793,0.05534696147962731,10.324222561230977
ZCTA5 79549,5379,316,5063,0.05874697899237777,10.31595932827394
ZCTA5 03060,12155,611,11544,0.05026737967914439,10.308351247790876
ZCTA5 83676,1607,128,1479,0.07965152457996266,10.298819502915247
ZCTA5 84026,370,48,322,0.12972972972972974,10.298635883538925
ZCTA5 70456,890,85,805,0.09550561797752809,10.294600921407937
ZCTA5 08346,222,35,187,0.15765765765765766,10.291368950307419
ZCTA5 77975,680,71,609,0.10441176470588236,10.29001489696759
ZCTA5 28217,10531,542,9989,0.05146709714177191,10.27969745278635
ZCTA5 79360,4575,278,4297,0.06076502732240437,10.272893081156196
ZCTA5 30044,26909,1203,25706,0.04470623211564904,10.264575296969037
ZCTA5 71753,6163,351,5812,0.056952782735680677,10.258880916476434
ZCTA5 87018,163,29,134,0.17791411042944785,10.256617091329323
ZCTA5 74115,8094,436,7658,0.05386706202125031,10.212865145282603
ZCTA5 59043,700,72,628,0.10285714285714286,10.21150476851762
ZCTA5 34950,5915,339,5576,0.05731191885038039,10.203955119574285
ZCTA5 55415,1748,135,1613,0.07723112128146453,10.178378278051392
ZCTA5 89146,6836,380,6456,0.05558806319485079,10.177015297088225
ZCTA5 95002,560,62,498,0.11071428571428571,10.167450553308749
ZCTA5 99778,59,16,43,0.2711864406779661,10.154934970809997
ZCTA5 83803,440,53,387,0.12045454545454545,10.14869536143988
ZCTA5 85937,2406,170,2236,0.07065669160432253,10.148045599475775
ZCTA5 77037,5428,316,5112,0.05821665438467207,10.145556873679416
ZCTA5 77988,156,28,128,0.1794871794871795,10.143229358136724
ZCTA5 77504,8697,461,8236,0.053006783948487984,10.140303306050923
ZCTA5 59841,166,29,137,0.1746987951807229,10.120194931496405
ZCTA5 56670,341,45,296,0.13196480938416422,10.116333191507909
ZCTA5 07801,8061,433,7628,0.05371541992308647,10.116310265359337
ZCTA5 32202,1793,137,1656,0.07640825432236475,10.11479197069756
ZCTA5 75789,2802,190,2612,0.06780870806566738,10.113007352623491
ZCTA5 87364,294,41,253,0.13945578231292516,10.107621218592369
ZCTA5 98264,7540,410,7130,0.054376657824933686,10.103235981006181
ZCTA5 30453,2667,183,2484,0.0686164229471316,10.09834883648064
ZCTA5 70560,14483,703,13780,0.04853966719602292,10.096009641665487
ZCTA5 75941,2629,181,2448,0.06884747052111069,10.092029941270326
ZCTA5 95673,4839,288,4551,0.059516429014259145,10.082116063920157
ZCTA5 39322,483,56,427,0.11594202898550725,10.081527202649484
ZCTA5 60018,10029,517,9512,0.05155050353973477,10.078146122406684
ZCTA5 28025,20219,934,19285,0.046194173796923685,10.074183004124079
ZCTA5 20722,1763,135,1628,0.07657402155416904,10.068522879702709
ZCTA5 75401,6626,369,6257,0.055689707214005436,10.065490417873821
ZCTA5 75472,1357,112,1245,0.08253500368459837,10.054588474351586
ZCTA5 93433,5216,305,4911,0.0584739263803681,10.048786933297684
ZCTA5 79839,432,52,380,0.12037037037037036,10.04628181414056
ZCTA5 84780,8203,438,7765,0.053395099353894915,10.043686995290221
ZCTA5 87328,683,70,613,0.10248901903367497,10.033244123691476
ZCTA5 15746,67,17,50,0.2537313432835821,10.026973956605014
ZCTA5 71356,274,39,235,0.14233576642335766,10.022881415044123
ZCTA5 95258,1501,120,1381,0.07994670219853431,10.01696030335092
ZCTA5 57350,6577,366,6211,0.055648471947696516,10.009606522083438
ZCTA5 95428,947,87,860,0.09186906019007392,9.99680248481046
ZCTA5 96756,2126,154,1972,0.07243650047036689,9.995664992919703
ZCTA5 00606,2014,148,1866,0.07348560079443893,9.990635913593207
ZCTA5 66408,141,26,115,0.18439716312056736,9.967481376331136
ZCTA5 96789,17637,828,16809,0.04694675965300221,9.964792577806957
ZCTA5 96750,1197,102,1095,0.08521303258145363,9.958508093764703
ZCTA5 85930,265,38,227,0.14339622641509434,9.952899683554639
ZCTA5 92251,5135,300,4835,0.05842259006815969,9.949999371606122
ZCTA5 10009,29728,1303,28425,0.043830731969860065,9.949383162447852
ZCTA5 92382,1835,138,1697,0.07520435967302452,9.945779096808435
ZCTA5 97038,5553,319,5234,0.057446425355663605,9.942523421759343
ZCTA5 10017,9905,509,9396,0.0513881877839475,9.92581237800151
ZCTA5 29927,3183,207,2976,0.06503298774740811,9.907777433174122
ZCTA5 80909,16284,772,15512,0.04740849914026038,9.902621666401572
ZCTA5 95340,11964,595,11369,0.04973253092611167,9.90170323540086
ZCTA5 77484,3679,231,3448,0.06278880130470237,9.894810939309645
ZCTA5 80601,12547,619,11928,0.049334502271459316,9.892145857549608
ZCTA5 11575,4418,266,4152,0.06020823902218198,9.889277373678485
ZCTA5 85014,12867,632,12235,0.04911789850003886,9.880859969044728
ZCTA5 01851,10165,519,9646,0.05105755041810133,9.869859160779237
ZCTA5 77073,13140,643,12497,0.04893455098934551,9.868252395120134
ZCTA5 99722,55,15,40,0.2727272727272727,9.868206509065013
ZCTA5 79719,162,28,134,0.1728395061728395,9.865917833068698
ZCTA5 97386,5268,305,4963,0.05789673500379651,9.865779377442903
ZCTA5 99737,1485,118,1367,0.07946127946127945,9.859401970789238
ZCTA5 27047,482,55,427,0.11410788381742738,9.847151259044768
ZCTA5 77836,4493,269,4224,0.05987091030491876,9.847121098255093
ZCTA5 99788,37,12,25,0.32432432432432434,9.839273940958861
ZCTA5 96744,16229,768,15461,0.04732269394294165,9.825095561789196
ZCTA5 79782,1297,107,1190,0.08249807247494217,9.822396308396835
ZCTA5 87040,163,28,135,0.17177914110429449,9.821035672618779
ZCTA5 77964,3283,211,3072,0.06427048431312823,9.819246564444068
ZCTA5 14480,366,46,320,0.12568306010928962,9.812288270768786
ZCTA5 95209,13121,641,12480,0.048852983766481214,9.809156052603722
ZCTA5 22150,9062,471,8591,0.05197528139483558,9.804836574962655
ZCTA5 19405,2293,161,2132,0.07021369385085041,9.788905015773453
ZCTA5 46772,808,77,731,0.0952970297029703,9.775924395890863
ZCTA5 39152,486,55,431,0.11316872427983539,9.772787863595997
ZCTA5 93932,260,37,223,0.1423076923076923,9.760947823652657
ZCTA5 98528,3648,228,3420,0.0625,9.756030892479476
ZCTA5 42323,307,41,266,0.13355048859934854,9.753266604694655
ZCTA5 77028,5654,321,5333,0.056773965334276616,9.751340153785499
ZCTA5 95313,447,52,395,0.116331096196868,9.744288379182937
ZCTA5 78361,1735,131,1604,0.07550432276657061,9.740463992263845
ZCTA5 11109,2954,194,2760,0.06567366283006093,9.738364437317475
ZCTA5 98023,17699,825,16874,0.04661280298321939,9.735217680503476
ZCTA5 95422,6129,342,5787,0.055800293685756244,9.72878518303181
ZCTA5 30340,9375,483,8892,0.05152,9.727579685580208
ZCTA5 68333,2818,187,2631,0.06635911994322215,9.713904485084877
ZCTA5 43318,1557,121,1436,0.07771355170199101,9.712074776780451
ZCTA5 91501,7870,418,7452,0.05311308767471411,9.698584734118752
ZCTA5 33848,186,30,156,0.16129032258064516,9.695563191482933
ZCTA5 38232,770,74,696,0.09610389610389611,9.66778840169698
ZCTA5 10011,29128,1271,27857,0.043634990387256246,9.662686088212096
ZCTA5 60402,20764,945,19819,0.04551146214602196,9.661967740554221
ZCTA5 78407,1043,91,952,0.087248322147651,9.661392542220893
ZCTA5 32112,2849,188,2661,0.06598806598806599,9.657047921631602
ZCTA5 45216,3860,237,3623,0.061398963730569946,9.655093296895348
ZCTA5 78017,1044,91,953,0.0871647509578544,9.6510064290372
ZCTA5 65440,138,25,113,0.18115942028985507,9.649357347891998
ZCTA5 68528,2512,171,2341,0.06807324840764331,9.64911476210546
ZCTA5 91602,9557,489,9068,0.05116668410589097,9.629465993464489
ZCTA5 97914,5959,333,5626,0.05588185937237792,9.627928043888293
ZCTA5 79735,3825,235,3590,0.06143790849673202,9.624615071588956
ZCTA5 28110,18297,846,17451,0.046237088047220855,9.615688811780695
ZCTA5 06710,3639,226,3413,0.062104973893926906,9.611469326863375
ZCTA5 85320,325,42,283,0.12923076923076923,9.60204816956614
ZCTA5 40010,168,28,140,0.16666666666666666,9.602017593372782
ZCTA5 33314,8768,455,8313,0.05189324817518248,9.601757967752137
ZCTA5 10547,2423,166,2257,0.06851011143210896,9.596226850584355
ZCTA5 58370,389,47,342,0.12082262210796915,9.582794941936097
ZCTA5 74724,121,23,98,0.19008264462809918,9.58134174765009
ZCTA5 52339,1431,113,1318,0.07896575821104122,9.574237539342521
ZCTA5 93644,3543,221,3322,0.062376517075924356,9.573727577721153
ZCTA5 75057,5022,290,4732,0.05774591796097173,9.573237850848237
ZCTA5 99684,179,29,150,0.16201117318435754,9.565003530618416
ZCTA5 89120,9301,477,8824,0.051284808085152137,9.562972828520989
ZCTA5 11366,4633,272,4361,0.05870925965896827,9.559646817350746
ZCTA5 64679,244,35,209,0.14344262295081966,9.554431269196098
ZCTA5 00771,12373,605,11768,0.048896791400630406,9.552552788511026
ZCTA5 11003,12256,600,11656,0.0489556135770235,9.543494864974122
ZCTA5 86031,513,56,457,0.10916179337231968,9.535884618665767
ZCTA5 94564,6666,363,6303,0.054455445544554455,9.535420158384946
ZCTA5 75638,2356,162,2194,0.06876061120543293,9.530238259978992
ZCTA5 31903,7108,382,6726,0.05374226223972988,9.512099159256621
ZCTA5 88044,1263,103,1160,0.08155186064924783,9.5057925196864
ZCTA5 75402,6517,356,6161,0.05462636182292466,9.504979842826538
ZCTA5 44032,501,55,446,0.10978043912175649,9.500699743203826
ZCTA5 87053,367,45,322,0.1226158038147139,9.498910831786597
ZCTA5 60458,5330,303,5027,0.05684803001876173,9.497890658374766
ZCTA5 27813,281,38,243,0.13523131672597866,9.487815703073624
ZCTA5 19023,7304,390,6914,0.053395399780941946,9.477498824614603
ZCTA5 21628,224,33,191,0.14732142857142858,9.47732379520143
ZCTA5 99507,13951,668,13283,0.04788187226722099,9.476775654466731
ZCTA5 07514,6279,345,5934,0.054945054945054944,9.470242160852742
ZCTA5 90717,8515,442,8073,0.051908396946564885,9.469988752500791
ZCTA5 71857,1886,137,1749,0.07264050901378578,9.463849024605002
ZCTA5 06606,15943,748,15195,0.046917142319513265,9.453367979117335
ZCTA5 44627,1518,117,1401,0.07707509881422925,9.451334888201275
ZCTA5 91708,590,61,529,0.10338983050847457,9.44685699842807
ZCTA5 20770,9681,491,9190,0.05071790104328065,9.446173596599317
ZCTA5 73942,4152,248,3904,0.05973025048169557,9.415667021593316
ZCTA5 75935,4827,279,4548,0.057799875699192045,9.40638497116481
ZCTA5 28689,698,68,630,0.09742120343839542,9.39823997288871
ZCTA5 35653,3667,225,3442,0.06135805835833106,9.396845641543502
ZCTA5 33040,13160,634,12526,0.04817629179331307,9.39202321424236
ZCTA5 77801,6126,337,5789,0.05501142670584394,9.383039363643398
ZCTA5 30168,9353,476,8877,0.05089276168074414,9.378816681164375
ZCTA5 76460,134,24,110,0.1791044776119403,9.376196837573147
ZCTA5 79764,7205,384,6821,0.053296321998612076,9.366280832326263
ZCTA5 72648,174,28,146,0.16091954022988506,9.350389727885453
ZCTA5 28081,9962,501,9461,0.05029110620357358,9.345390118835084
ZCTA5 88210,6799,366,6433,0.05383144580085307,9.343941273298022
ZCTA5 94579,7052,377,6675,0.053460011344299486,9.342742879287083
ZCTA5 99747,53,14,39,0.2641509433962264,9.339904875620595
ZCTA5 79821,1905,137,1768,0.07191601049868766,9.335547732069243
ZCTA5 98601,1076,91,985,0.0845724907063197,9.324921556912512
ZCTA5 19104,16368,762,15606,0.04655425219941349,9.320352664622035
ZCTA5 86435,3,3,0,1,9.30992517405186
ZCTA5 79009,599,61,538,0.1018363939899833,9.307204913804062
ZCTA5 08302,13856,660,13196,0.04763279445727483,9.281405640629227
ZCTA5 17314,2009,142,1867,0.070681931309109,9.279383221794214
ZCTA5 93218,253,35,218,0.1383399209486166,9.277683893343378
ZCTA5 94619,9063,462,8601,0.05097649784839457,9.27660303009927
ZCTA5 75704,3088,196,2892,0.06347150259067358,9.276256358104908
ZCTA5 94037,1064,90,974,0.08458646616541353,9.275313192853847
ZCTA5 33021,18255,836,17419,0.045795672418515475,9.272979639895805
ZCTA5 77447,4842,278,4564,0.05741429161503511,9.271780030930136
ZCTA5 33122,47,13,34,0.2765957446808511,9.269816977516653
ZCTA5 00646,11928,581,11347,0.04870892018779343,9.265093436332073
ZCTA5 55429,10143,507,9636,0.04998521147589471,9.25858228901824
ZCTA5 95212,7038,375,6663,0.05328218243819267,9.250500334086457
ZCTA5 20171,17014,786,16228,0.046197249324086045,9.243534014935317
ZCTA5 28007,278,37,241,0.13309352517985612,9.238811530596093
ZCTA5 11358,13042,626,12416,0.04799877319429535,9.237081025264876
ZCTA5 76270,649,64,585,0.09861325115562404,9.231237365568154
ZCTA5 78877,255,35,220,0.13725490196078433,9.217928210421336
ZCTA5 77520,12442,601,11841,0.04830413116862241,9.211518807018038
ZCTA5 79357,759,71,688,0.09354413702239789,9.206306455529875
ZCTA5 31093,11036,543,10493,0.04920260964117434,9.200349705117597
ZCTA5 28208,14227,673,13554,0.04730442117101286,9.187026607109813
ZCTA5 35968,1571,118,1453,0.07511139401654997,9.1820729384396
ZCTA5 91016,14354,678,13676,0.04723422042636199,9.181167785978472
ZCTA5 95953,3275,204,3071,0.06229007633587786,9.177010118192673
ZCTA5 85712,15901,740,15161,0.046537953587824664,9.175000238365048
ZCTA5 42455,1057,89,968,0.08420056764427625,9.174981137602225
ZCTA5 81631,2459,164,2295,0.06669377795851972,9.166367556942914
ZCTA5 78014,1780,129,1651,0.07247191011235955,9.154494685314466
ZCTA5 07036,15166,710,14456,0.04681524462613741,9.150345310255355
ZCTA5 86434,451,50,401,0.11086474501108648,9.142211547422166
ZCTA5 98596,2625,172,2453,0.06552380952380953,9.13736145148415
ZCTA5 49057,2210,151,2059,0.06832579185520361,9.116548409926708
ZCTA5 00777,12931,619,12312,0.0478694609852293,9.115914137454554
ZCTA5 95337,11538,562,10976,0.048708615011267116,9.112185813349434
ZCTA5 79761,11322,553,10769,0.04884296060766649,9.105985899551431
ZCTA5 44654,6010,328,5682,0.054575707154742095,9.10592928225355
ZCTA5 79512,2115,146,1969,0.0690307328605201,9.098742030454854
ZCTA5 20121,9759,488,9271,0.05000512347576596,9.09257185945292
ZCTA5 65783,25,9,16,0.36,9.079818937854512
ZCTA5 96768,6408,345,6063,0.05383895131086142,9.074626622513401
ZCTA5 77957,3068,193,2875,0.06290743155149935,9.072417944616065
ZCTA5 01843,8578,438,8140,0.051060853345768244,9.068422889990943
ZCTA5 70554,2042,142,1900,0.06953966699314397,9.068234708509564
ZCTA5 59526,802,73,729,0.09102244389027432,9.066359603532815
ZCTA5 71463,3217,200,3017,0.062169723344731115,9.057423343558169
ZCTA5 75480,631,62,569,0.098256735340729,9.052520015885472
ZCTA5 92506,14871,696,14175,0.0468025015130119,9.052272862612275
ZCTA5 20906,25137,1099,24038,0.04372041214146477,9.051655495706779
ZCTA5 98087,14102,665,13437,0.047156431711813926,9.048847010967066
ZCTA5 95125,20966,937,20029,0.04469140513211867,9.048515601787559
ZCTA5 75838,249,34,215,0.13654618473895583,9.046644276285392
ZCTA5 00731,4380,254,4126,0.05799086757990868,9.030564693941468
ZCTA5 68760,543,56,487,0.10313075506445672,9.029203155830777
ZCTA5 12750,95,19,76,0.2,9.027313112774412
ZCTA5 56633,1686,123,1563,0.07295373665480427,9.019519275568511
ZCTA5 98351,486,52,434,0.10699588477366255,9.016013751191291
ZCTA5 97632,545,56,489,0.10275229357798166,8.996682129676854
ZCTA5 33563,9683,483,9200,0.0498812351543943,8.989302497059526
ZCTA5 41815,404,46,358,0.11386138613861387,8.987697098102094
ZCTA5 70548,3827,228,3599,0.05957669192579044,8.986822449742531
ZCTA5 91206,13294,631,12663,0.04746502181435234,8.983654985627252
ZCTA5 72722,1216,97,1119,0.07976973684210527,8.981650971779315
ZCTA5 10923,2595,169,2426,0.0651252408477842,8.972087245403701
ZCTA5 33624,15017,700,14317,0.046613837650662585,8.968029747375422
ZCTA5 38122,9094,458,8636,0.050362876621948535,8.967037231966474
ZCTA5 73159,12246,588,11658,0.048015678588927,8.961160975147651
ZCTA5 78210,12469,597,11872,0.04787873927339803,8.9573475285341
ZCTA5 39326,163,26,137,0.15950920245398773,8.949872835197686
ZCTA5 98802,11328,550,10778,0.04855225988700565,8.936336040626967
ZCTA5 99603,4034,237,3797,0.058750619732275654,8.934891964905287
ZCTA5 79104,2400,159,2241,0.06625,8.934831031614566
ZCTA5 40146,1550,115,1435,0.07419354838709677,8.919541871954463
ZCTA5 49965,196,29,167,0.14795918367346939,8.914877604128625
ZCTA5 56374,3227,199,3028,0.061667183142237375,8.912732654669293
ZCTA5 40210,5371,297,5074,0.05529696518339229,8.902200249255095
ZCTA5 70655,1052,87,965,0.08269961977186312,8.882524739037393
ZCTA5 78757,10720,524,10196,0.04888059701492537,8.882263541974549
ZCTA5 97123,16146,743,15403,0.046017589495850365,8.877705611681115
ZCTA5 96134,722,67,655,0.09279778393351801,8.86758083299024
ZCTA5 60616,24417,1066,23351,0.043658107056558954,8.866938424247483
ZCTA5 65662,509,53,456,0.10412573673870335,8.866786885262012
ZCTA5 18321,629,61,568,0.09697933227344992,8.859999770547583
ZCTA5 91001,12745,606,12139,0.047548058061985095,8.848332619042983
ZCTA5 33570,9311,465,8846,0.049940930082697885,8.84696967061074
ZCTA5 97756,14562,679,13883,0.04662821041065788,8.840768856970966
ZCTA5 84039,256,34,222,0.1328125,8.840708406267753
ZCTA5 41754,107,20,87,0.18691588785046728,8.827848410328798
ZCTA5 27920,526,54,472,0.10266159695817491,8.826900365137563
ZCTA5 99736,44,12,32,0.2727272727272727,8.826392228110105
ZCTA5 95645,616,60,556,0.09740259740259741,8.826384314896401
ZCTA5 72827,73,16,57,0.2191780821917808,8.8245428260764065
ZCTA5 98134,210,30,180,0.14285714285714285,8.816609447063533
ZCTA5 91745,16233,745,15488,0.04589416620464486,8.814141518957268
ZCTA5 95950,126,22,104,0.1746031746031746,8.811016114028458
ZCTA5 96038,294,37,257,0.12585034013605442,8.81029416875573
ZCTA5 41635,1182,94,1088,0.07952622673434856,8.808637499246533
ZCTA5 93258,558,56,502,0.1003584229390681,8.78887843210412
ZCTA5 79416,13048,617,12431,0.047286940527283876,8.7870237946293
ZCTA5 82510,117,21,96,0.1794871794871795,8.784294300558528
ZCTA5 67210,3192,196,2996,0.06140350877192982,8.781422915399608
ZCTA5 98439,2030,139,1891,0.06847290640394088,8.774263111655786
ZCTA5 26631,99,19,80,0.1919191919191919,8.768270558303248
ZCTA5 97329,82,17,65,0.2073170731707317,8.755416337691665
ZCTA5 02071,259,34,225,0.13127413127413126,8.754677725218434
ZCTA5 78666,28183,1207,26976,0.042827236277188374,8.750538276966953
ZCTA5 95691,13266,625,12641,0.047112920247248606,8.74866092302863
ZCTA5 99001,1481,110,1371,0.07427413909520594,8.735997556500358
ZCTA5 60077,10254,502,9752,0.048956504778622977,8.72980800249848
ZCTA5 22715,445,48,397,0.10786516853932585,8.729308099833203
ZCTA5 44866,717,66,651,0.09205020920502092,8.72550150785882
ZCTA5 79088,1843,129,1714,0.06999457406402604,8.723649683677511
ZCTA5 85335,10478,511,9967,0.048768849016987977,8.717821909768599
ZCTA5 85356,1864,130,1734,0.06974248927038626,8.712684854756
ZCTA5 12429,100,19,81,0.19,8.70571470341924
ZCTA5 87499,169,26,143,0.15384615384615385,8.703697413870778
ZCTA5 48211,2081,141,1940,0.06775588659298415,8.70189897682244
ZCTA5 75141,1176,93,1083,0.07908163265306123,8.701464869884559
ZCTA5 70427,7468,385,7083,0.0515532940546331,8.698031069573693
ZCTA5 32352,2383,156,2227,0.06546370121695343,8.689672437295162
ZCTA5 10007,2731,173,2558,0.06334675942878067,8.687331252152637
ZCTA5 11413,12356,587,11769,0.0475072839106507,8.68704780373243
ZCTA5 06604,9886,486,9400,0.049160428889338456,8.684483771301949
ZCTA5 01581,6794,356,6438,0.05239917574330291,8.683980524174299
ZCTA5 10543,7549,388,7161,0.05139753609749636,8.669815540325576
ZCTA5 78064,5398,295,5103,0.05464987032234161,8.660156335230052
ZCTA5 37115,16652,758,15894,0.045520057650732644,8.658701527131035
ZCTA5 71067,1253,97,1156,0.07741420590582601,8.653582477953817
ZCTA5 23523,2554,164,2390,0.06421299921691465,8.644547681484264
ZCTA5 40280,101,19,82,0.18811881188118812,8.64399787985237
ZCTA5 33755,9300,461,8839,0.04956989247311828,8.642756213461157
ZCTA5 95932,2802,176,2626,0.06281227694503926,8.642195511869526
ZCTA5 92082,6021,322,5699,0.05347948845706693,8.641222171055876
ZCTA5 00738,11593,555,11038,0.04787371689812818,8.633965106310006
ZCTA5 35577,6,4,2,0.6666666666666666,8.625577771394598
ZCTA5 48873,480,50,430,0.10416666666666667,8.615479430763695
ZCTA5 77418,4115,237,3878,0.05759416767922236,8.611600285594195
ZCTA5 37333,228,31,197,0.13596491228070176,8.607947565580334
ZCTA5 73051,2894,180,2714,0.06219765031098825,8.59905177511402
ZCTA5 78065,3274,198,3076,0.06047648136835675,8.598519953441249
ZCTA5 27878,892,76,816,0.08520179372197309,8.59479099377912
ZCTA5 10507,2080,140,1940,0.0673076923076923,8.586133931498358
ZCTA5 85371,93,18,75,0.1935483870967742,8.585785831065643
ZCTA5 94940,93,18,75,0.1935483870967742,8.585785831065643
ZCTA5 78535,217,30,187,0.1382488479262673,8.58483421221351
ZCTA5 99607,68,15,53,0.22058823529411764,8.581639602127606
ZCTA5 93450,229,31,198,0.13537117903930132,8.57683825843834
ZCTA5 11798,3601,213,3388,0.059150236045542905,8.575116059461637
ZCTA5 61911,1597,115,1482,0.07201001878522229,8.568503527469346
ZCTA5 98047,2304,151,2153,0.06553819444444445,8.564305467517524
ZCTA5 00976,21395,941,20454,0.04398223884085067,8.56376488515789
ZCTA5 52590,426,46,380,0.107981220657277,8.554239771705884
ZCTA5 98101,8640,432,8208,0.05,8.552764099418795
ZCTA5 31085,412,45,367,0.10922330097087378,8.55270724599215
ZCTA5 93545,829,72,757,0.08685162846803378,8.549886584889387
ZCTA5 85016,16566,752,15814,0.045394180852348184,8.54621493624322
ZCTA5 32810,13447,628,12819,0.046701866587342905,8.543063240460945
ZCTA5 33834,1754,123,1631,0.0701254275940707,8.540883654086151
ZCTA5 95008,18256,818,17438,0.044807186678352325,8.530494380245884
ZCTA5 21779,358,41,317,0.11452513966480447,8.530404062766365
ZCTA5 66078,456,48,408,0.10526315789473684,8.52754253563723
ZCTA5 62240,575,56,519,0.09739130434782609,8.526085785499017
ZCTA5 95935,219,30,189,0.136986301369863,8.520400841237754
ZCTA5 83661,3832,223,3609,0.058194154488517745,8.516750555812267
ZCTA5 99720,61,14,47,0.22950819672131148,8.515372597570268
ZCTA5 59201,1511,110,1401,0.07279947054930509,8.505255622359547
ZCTA5 28344,1234,95,1139,0.07698541329011345,8.50395604285646
ZCTA5 77837,671,62,609,0.09239940387481371,8.491267407136426
ZCTA5 91007,11617,553,11064,0.04760265128690712,8.480423307306893
ZCTA5 76067,6865,356,6509,0.05185724690458849,8.479534011073234
ZCTA5 65707,854,73,781,0.08548009367681499,8.454953427751878
ZCTA5 63956,446,47,399,0.10538116591928251,8.447379776544247
ZCTA5 84128,6994,361,6633,0.05161567057477838,8.44648067074661
ZCTA5 77475,335,39,296,0.11641791044776119,8.444490657560427
ZCTA5 31049,643,60,583,0.09331259720062209,8.44098948870612
ZCTA5 74129,7115,366,6749,0.05144061841180604,8.43711754930824
ZCTA5 61008,12258,578,11680,0.047152879751998694,8.434320579063154
ZCTA5 75602,7140,367,6773,0.051400560224089634,8.433103678435026
ZCTA5 93239,349,40,309,0.11461318051575932,8.431642410708223
ZCTA5 78375,907,76,831,0.08379272326350606,8.430762127513841
ZCTA5 77044,13456,626,12830,0.04652199762187872,8.429889782028567
ZCTA5 97008,11914,564,11350,0.047339264730569076,8.428267486590908
ZCTA5 98953,2227,146,2081,0.0655590480466996,8.425451964836858
ZCTA5 84660,10880,522,10358,0.04797794117647059,8.424703401362509
ZCTA5 75567,1752,122,1630,0.06963470319634703,8.421786132767197
ZCTA5 92065,11969,566,11403,0.04728882947614671,8.41701427556935
ZCTA5 25611,323,38,285,0.11764705882352941,8.414714982005053
ZCTA5 25438,2598,164,2434,0.06312548113933796,8.410431866008441
ZCTA5 54619,1209,93,1116,0.07692307692307693,8.405319462700117
ZCTA5 21804,15055,689,14366,0.04576552640318831,8.40052893320334
ZCTA5 47865,87,17,70,0.19540229885057472,8.400371548572847
ZCTA5 41840,392,43,349,0.1096938775510204,8.394347631497675
ZCTA5 96746,6639,345,6294,0.051965657478535925,8.387913391778625
ZCTA5 85302,14383,662,13721,0.04602655913230898,8.38499795428636
ZCTA5 21632,2295,149,2146,0.06492374727668845,8.383865575072914
ZCTA5 90630,15927,723,15204,0.045394612921454136,8.380070804693485
ZCTA5 96007,9051,446,8605,0.04927632305822561,8.370951642128622
ZCTA5 98593,436,46,390,0.10550458715596331,8.366472988373555
ZCTA5 99758,79,16,63,0.20253164556962025,8.357227872664556
ZCTA5 71275,813,70,743,0.08610086100861009,8.347930894695653
ZCTA5 98233,6116,322,5794,0.052648790058862,8.347849491766247
ZCTA5 41203,326,38,288,0.1165644171779141,8.344995496043941
ZCTA5 07095,7199,368,6831,0.051118210862619806,8.334649554024205
ZCTA5 45225,3987,228,3759,0.05718585402558315,8.33323003103314
ZCTA5 41725,71,15,56,0.2112676056338028,8.33214273585303
ZCTA5 45246,6053,319,5734,0.05270113993061292,8.327393009106146
ZCTA5 94561,12216,574,11642,0.04698755730189915,8.318243390837102
ZCTA5 79096,816,70,746,0.0857843137254902,8.313032830529309
ZCTA5 86022,719,64,655,0.0890125173852573,8.284690546981631
ZCTA5 67501,9817,476,9341,0.048487317917897524,8.283238783735094
ZCTA5 77493,9817,476,9341,0.048487317917897524,8.283238783735094
ZCTA5 78118,1079,85,994,0.07877664504170528,8.279168617722746
ZCTA5 95675,215,29,186,0.13488372093023257,8.270781357629463
ZCTA5 75450,56,13,43,0.23214285714285715,8.268564670501117
ZCTA5 24054,2647,165,2482,0.062334718549301095,8.263125760284655
ZCTA5 41776,471,48,423,0.10191082802547771,8.262068493575917
ZCTA5 92056,19412,856,18556,0.04409643519472491,8.245730327404099
ZCTA5 95204,11186,531,10655,0.047470051850527446,8.243630623329826
ZCTA5 72157,502,50,452,0.099601593625498,8.24190147139322
ZCTA5 79545,674,61,613,0.09050445103857567,8.236643698875948
ZCTA5 99791,49,12,37,0.24489795918367346,8.2310635977262
ZCTA5 40983,138,22,116,0.15942028985507245,8.229172552297324
ZCTA5 77437,6137,321,5816,0.05230568681766335,8.212694739983817
ZCTA5 70535,6517,337,6180,0.051710909927880924,8.1961207702018
ZCTA5 89706,8525,421,8104,0.0493841642228739,8.179444239250138
ZCTA5 89418,129,21,108,0.16279069767441862,8.169188798194412
ZCTA5 92585,6043,316,5727,0.05229190799271885,8.143598752414915
ZCTA5 28341,1502,107,1395,0.07123834886817576,8.143426671162302
ZCTA5 49548,11979,561,11418,0.046831955922865015,8.142449910062968
ZCTA5 79235,1389,101,1288,0.07271418286537078,8.13699089347432
ZCTA5 77983,764,66,698,0.08638743455497382,8.13650423101042
ZCTA5 57570,524,51,473,0.09732824427480916,8.131166801852409
ZCTA5 99781,50,12,38,0.24,8.122026720669867
ZCTA5 60661,5911,310,5601,0.05244459482321096,8.119447769634412
ZCTA5 43006,257,32,225,0.1245136186770428,8.118099071141051
ZCTA5 85392,12719,590,12129,0.046387294598631966,8.111299321514062
ZCTA5 00775,465,47,418,0.1010752688172043,8.109075383321853
ZCTA5 91709,24374,1043,23331,0.04279149913842619,8.106726620712125
ZCTA5 93040,572,54,518,0.0944055944055944,8.106706607663178
ZCTA5 77338,14282,652,13630,0.04565186948606638,8.106488404904114
ZCTA5 33619,13156,607,12549,0.04613864396473092,8.090862567093605
ZCTA5 61054,1645,114,1531,0.06930091185410335,8.085275549124614
ZCTA5 08902,14249,650,13599,0.04561723629728402,8.074127091120669
ZCTA5 94585,9395,455,8940,0.04843001596593933,8.072361507329063
ZCTA5 59075,66,14,52,0.21212121212121213,8.071966852194993
ZCTA5 29547,1248,93,1155,0.07451923076923077,8.067557521690505
ZCTA5 95632,9716,468,9248,0.04816797035817209,8.065465118455185
ZCTA5 29684,1532,108,1424,0.07049608355091384,8.062783779399458
ZCTA5 96816,17268,768,16500,0.04447533009034051,8.053939283822887
ZCTA5 77474,4507,248,4259,0.05502551586421123,8.053461203958431
ZCTA5 85543,1215,91,1124,0.07489711934156379,8.033431774008552
ZCTA5 83655,1672,115,1557,0.0687799043062201,8.03288420256388
ZCTA5 75939,1870,125,1745,0.06684491978609626,8.029880638522762
ZCTA5 40203,8683,425,8258,0.04894621674536451,8.027949318342262
ZCTA5 83641,1272,94,1178,0.07389937106918239,8.02181883601697
ZCTA5 83324,211,28,183,0.13270142180094788,8.017196302524336
ZCTA5 39362,1310,96,1214,0.0732824427480916,8.016585012080476
ZCTA5 78655,1053,82,971,0.0778727445394112,8.015694824939963
ZCTA5 70087,2908,175,2733,0.06017881705639615,8.014400421784615
ZCTA5 67214,6016,313,5703,0.0520279255319149,8.011520175815447
ZCTA5 98001,11002,519,10483,0.04717324122886748,8.002416782113261
ZCTA5 78583,2635,162,2473,0.06148007590132827,8.00040342184291
ZCTA5 32948,1776,120,1656,0.06756756756756757,7.994818218740986
ZCTA5 92309,188,26,162,0.13829787234042554,7.99436718978544
ZCTA5 75090,8286,408,7878,0.049239681390296886,7.990833554027656
ZCTA5 24464,67,14,53,0.208955223880597,7.988773001994705
ZCTA5 22741,44,11,33,0.25,7.988020143635998
ZCTA5 72853,777,66,711,0.08494208494208494,7.981385585438511
ZCTA5 02148,23076,990,22086,0.042901716068642744,7.981027055164181
ZCTA5 98037,10865,513,10352,0.047215830648872525,7.977124179066683
ZCTA5 34139,177,25,152,0.14124293785310735,7.974858173801069
ZCTA5 86036,177,25,152,0.14124293785310735,7.974858173801069
ZCTA5 33401,11588,542,11046,0.04677252329996548,7.972881960797056
ZCTA5 99580,25,8,17,0.32,7.967592682291008
ZCTA5 85653,5845,305,5540,0.05218135158254919,7.962069906550292
ZCTA5 33056,9860,472,9388,0.04787018255578093,7.9605736754648255
ZCTA5 79330,31,9,22,0.2903225806451613,7.953431749059105
ZCTA5 15611,330,37,293,0.11212121212121212,7.947169944152892
ZCTA5 66105,780,66,714,0.08461538461538462,7.946037705400414
ZCTA5 42649,972,77,895,0.07921810699588477,7.934487965106857
ZCTA5 72351,226,29,197,0.12831858407079647,7.93086088930037
ZCTA5 91942,16318,728,15590,0.04461331045471259,7.92728126170423
ZCTA5 87941,291,34,257,0.11683848797250859,7.910311927277193
ZCTA5 71418,2443,152,2291,0.062218583708555056,7.906407769591477
ZCTA5 11434,21462,926,20536,0.043146025533501074,7.895899623303826
ZCTA5 06051,11927,554,11373,0.04644923283306783,7.892316419642192
ZCTA5 72106,1993,130,1863,0.06522829904666332,7.888408040590495
ZCTA5 43219,11555,539,11016,0.046646473388143664,7.886170099778468
ZCTA5 33183,11630,542,11088,0.04660361134995701,7.886016587055991
ZCTA5 38833,1031,80,951,0.07759456838021339,7.881846046459131
ZCTA5 77414,8646,421,8225,0.048693037242655564,7.879908726242417
ZCTA5 08854,16043,716,15327,0.044630056722558126,7.871995671346567
ZCTA5 28801,6677,339,6338,0.050771304478059005,7.869150925310146
ZCTA5 92368,293,34,259,0.11604095563139932,7.861530495235128
ZCTA5 28206,4811,259,4552,0.05383496154645604,7.861405204329176
ZCTA5 77449,34991,1435,33556,0.041010545568860565,7.860502297403933
ZCTA5 32053,1088,83,1005,0.07628676470588236,7.85689906990943
ZCTA5 88230,1580,109,1471,0.0689873417721519,7.8546112677095214
ZCTA5 99827,1052,81,971,0.07699619771863118,7.853782604449916
ZCTA5 60153,7690,381,7309,0.04954486345903771,7.846914791786198
ZCTA5 22971,688,60,628,0.0872093023255814,7.841094005905342
ZCTA5 10805,7549,375,7174,0.04967545370247715,7.837741856098179
ZCTA5 61821,13366,610,12756,0.04563818644321412,7.833422005433383
ZCTA5 05762,181,25,156,0.13812154696132597,7.830931878618782
ZCTA5 83845,739,63,676,0.08525033829499323,7.830370913425961
ZCTA5 76253,96,17,79,0.17708333333333334,7.826023623312473
ZCTA5 99741,193,26,167,0.13471502590673576,7.823175182438341
ZCTA5 76131,12313,568,11745,0.04613010639161862,7.822082993150497
ZCTA5 40019,1566,108,1458,0.06896551724137931,7.8149320230216
ZCTA5 39823,2993,177,2816,0.05913798864016037,7.814024319308608
ZCTA5 18086,230,29,201,0.12608695652173912,7.812525028857608
ZCTA5 94922,230,29,201,0.12608695652173912,7.812525028857608
ZCTA5 28747,931,74,857,0.079484425349087,7.810532128821928
ZCTA5 85546,5919,306,5613,0.051697921946274705,7.805479491349077
ZCTA5 26572,61,13,48,0.21311475409836064,7.803342699861274
ZCTA5 25007,218,28,190,0.12844036697247707,7.7992264666128674
ZCTA5 94602,11854,549,11305,0.046313480681626454,7.7859322051765085
ZCTA5 81125,1207,89,1118,0.07373653686826843,7.78271106162836
ZCTA5 30012,9372,449,8923,0.0479086641058472,7.781795245133751
ZCTA5 99502,8959,432,8527,0.048219667373590805,7.7721050556012
ZCTA5 04027,2157,137,2020,0.06351414000927214,7.763822831919187
ZCTA5 66619,883,71,812,0.08040770101925254,7.759094172435297
ZCTA5 30096,25562,1078,24484,0.04217197402394179,7.751106628911791
ZCTA5 32066,1753,117,1636,0.06674272675413577,7.750826876727815
ZCTA5 68741,271,32,239,0.11808118081180811,7.7474072653586505
ZCTA5 20708,9684,461,9223,0.04760429574555969,7.7436978946581245
ZCTA5 79013,1046,80,966,0.07648183556405354,7.738841875794861
ZCTA5 77488,5379,282,5097,0.05242610150585611,7.7379095884763105
ZCTA5 05732,312,35,277,0.11217948717948718,7.733114233315135
ZCTA5 87007,285,33,252,0.11578947368421053,7.729853275591164
ZCTA5 93105,11356,528,10828,0.04649524480450863,7.728346451877551
ZCTA5 56369,272,32,240,0.11764705882352941,7.7218720516332
ZCTA5 95443,139,21,118,0.1510791366906475,7.712048779974427
ZCTA5 71334,3432,196,3236,0.05710955710955711,7.706645629553603
ZCTA5 96752,1125,84,1041,0.07466666666666667,7.6871879099768465
ZCTA5 95918,1109,83,1026,0.07484220018034266,7.664835609449322
ZCTA5 84321,14884,666,14218,0.04474603601182478,7.66100317359699
ZCTA5 87021,1222,89,1133,0.07283142389525368,7.654966614376775
ZCTA5 61101,7595,374,7221,0.04924292297564187,7.651959869205057
ZCTA5 95333,823,67,756,0.08140947752126367,7.650662193436739
ZCTA5 78240,23610,1001,22609,0.04239728928420161,7.641811324831223
ZCTA5 23356,556,51,505,0.09172661870503597,7.641229082484799
ZCTA5 16820,373,39,334,0.10455764075067024,7.6367377836086625
ZCTA5 55107,5318,278,5040,0.052275291462956,7.632748985981635
ZCTA5 00740,638,56,582,0.0877742946708464,7.630159390457803
ZCTA5 15054,141,21,120,0.14893617021276595,7.625822681872572
ZCTA5 33974,4580,246,4334,0.053711790393013104,7.623995192086123
ZCTA5 37335,1040,79,961,0.07596153846153846,7.623303771773044
ZCTA5 75861,707,60,647,0.08486562942008487,7.602074410793337
ZCTA5 79915,12274,562,11712,0.045787844223562,7.598815249389163
ZCTA5 97124,20834,894,19940,0.04291062685994048,7.590568058415955
ZCTA5 99348,450,44,406,0.09777777777777778,7.588208641525856
ZCTA5 78147,658,57,601,0.08662613981762918,7.585045591256533
ZCTA5 39429,6205,315,5890,0.05076551168412571,7.5833792846740735
ZCTA5 06106,13782,621,13161,0.045058772311710925,7.576115068111893
ZCTA5 60512,391,40,351,0.10230179028132992,7.570768367935419
ZCTA5 70510,9292,442,8850,0.0475678002582867,7.565785806916159
ZCTA5 07103,11085,514,10571,0.046368967072620657,7.561638552821673
ZCTA5 63120,3006,175,2831,0.0582168995342648,7.5501357098609265
ZCTA5 28572,2576,155,2421,0.06017080745341615,7.540785439254725
ZCTA5 76885,101,17,84,0.16831683168316833,7.537291391638684
ZCTA5 76623,56,12,44,0.21428571428571427,7.525427244627347
ZCTA5 79355,646,56,590,0.08668730650154799,7.524208377419938
ZCTA5 33444,8257,399,7858,0.04832263533971176,7.513427785529684
ZCTA5 48228,19265,832,18433,0.04318712691409291,7.512576614785005
ZCTA5 98675,2035,129,1906,0.06339066339066339,7.510089814380032
ZCTA5 34982,10036,471,9565,0.04693104822638501,7.508102980018723
ZCTA5 24089,1034,78,956,0.07543520309477757,7.507160785833206
ZCTA5 89506,13823,621,13202,0.04492512479201331,7.4999931234217065
ZCTA5 76108,15336,680,14656,0.04434011476264997,7.496907593540742
ZCTA5 59053,92,16,76,0.17391304347826086,7.492141939407449
ZCTA5 80019,981,75,906,0.0764525993883792,7.489441654774178
ZCTA5 77480,2933,171,2762,0.05830207978179339,7.4835498060765735
ZCTA5 31069,7151,353,6798,0.04936372535309747,7.4817365602377475
ZCTA5 54422,411,41,370,0.09975669099756691,7.4750410195191765
ZCTA5 87037,229,28,201,0.1222707423580786,7.474368562052019
ZCTA5 99602,65,13,52,0.2,7.467124319550735
ZCTA5 92865,6340,319,6021,0.050315457413249214,7.466145749648496
ZCTA5 99643,83,15,68,0.18072289156626506,7.4612651926984155
ZCTA5 66753,427,42,385,0.09836065573770492,7.458725931178963
ZCTA5 93245,12194,556,11638,0.04559619484992619,7.456319717903754
ZCTA5 46312,10160,475,9685,0.04675196850393701,7.453961713109997
ZCTA5 55408,15208,674,14534,0.04431877958968964,7.450924319654859
ZCTA5 39845,3006,174,2832,0.05788423153692615,7.4487051881810595
ZCTA5 29162,1171,85,1086,0.07258753202391119,7.447111817883597
ZCTA5 46563,8927,425,8502,0.04760837907471715,7.437022344047863
ZCTA5 58757,205,26,179,0.12682926829268293,7.434825515831557
ZCTA5 33618,11423,525,10898,0.04595990545390878,7.432924429936576
ZCTA5 71232,2619,156,2463,0.05956471935853379,7.430971334881885
ZCTA5 45838,22,7,15,0.3181818181818182,7.426838970087183
ZCTA5 15539,218,27,191,0.12385321100917432,7.422579130228898
ZCTA5 99676,555,50,505,0.09009009009009009,7.419950203924448
ZCTA5 10026,15458,683,14775,0.04418424116962091,7.4188944030132475
ZCTA5 95444,244,29,215,0.11885245901639344,7.418341576069114
ZCTA5 83464,135,20,115,0.14814814814814814,7.410889666472918
ZCTA5 76667,3704,205,3499,0.05534557235421166,7.40918852191088
ZCTA5 77423,3592,200,3392,0.0556792873051225,7.407536883291543
ZCTA5 94539,16317,716,15601,0.043880615309186737,7.406555275359365
ZCTA5 98849,461,44,417,0.09544468546637744,7.4018162867822115
ZCTA5 21850,1102,81,1021,0.073502722323049,7.393326843177775
ZCTA5 61104,7865,381,7484,0.04844246662428481,7.392009066391603
ZCTA5 95320,4530,241,4289,0.0532008830022075,7.3910359943825705
ZCTA5 79707,14550,647,13903,0.04446735395189003,7.387617613204264
ZCTA5 75801,5844,297,5547,0.05082135523613963,7.383218191698496
ZCTA5 75708,2393,145,2248,0.060593397409109906,7.38296325460688
ZCTA5 79240,12,5,7,0.4166666666666667,7.382328107239947
ZCTA5 96779,830,66,764,0.07951807228915662,7.38009872759496
ZCTA5 08641,1179,85,1094,0.0720949957591179,7.378457103700316
ZCTA5 59527,286,32,254,0.11188811188811189,7.376490145516479
ZCTA5 74352,2501,150,2351,0.059976009596161534,7.376024284467551
ZCTA5 00952,2825,165,2660,0.0584070796460177,7.375512210145785
ZCTA5 25021,94,16,78,0.1702127659574468,7.3736319371451184
ZCTA5 61322,510,47,463,0.09215686274509804,7.372345356069928
ZCTA5 30341,12749,576,12173,0.045180014118754414,7.362789517474667
ZCTA5 33604,14951,662,14289,0.044277974717410205,7.359952852358848
ZCTA5 01453,16941,739,16202,0.043621982173425417,7.359643780529289
ZCTA5 29303,8639,412,8227,0.0476907049427017,7.358626532543295
ZCTA5 96790,3604,200,3404,0.05549389567147614,7.358006368173323
ZCTA5 13630,512,47,465,0.091796875,7.34148807976213
ZCTA5 17219,115,18,97,0.1565217391304348,7.339313005631996
ZCTA5 45041,17,6,11,0.35294117647058826,7.325557814406594
ZCTA5 58002,17,6,11,0.35294117647058826,7.325557814406594
ZCTA5 94945,7306,357,6949,0.048863947440459896,7.324822604227452
ZCTA5 42153,137,20,117,0.145985401459854,7.3248071702449
ZCTA5 95227,261,30,231,0.11494252873563218,7.321137251615086
ZCTA5 34759,11633,531,11102,0.04564600704891258,7.3126592023974535
ZCTA5 84745,1283,90,1193,0.0701480904130943,7.309196725291834
ZCTA5 32443,1264,89,1175,0.07041139240506329,7.306932160799734
ZCTA5 78362,3641,201,3440,0.055204614117000825,7.298607876621773
ZCTA5 76632,531,48,483,0.0903954802259887,7.29688091625526
ZCTA5 76543,11899,541,11358,0.0454660055466846,7.286599308121814
ZCTA5 95570,1021,76,945,0.07443682664054849,7.282412663491513
ZCTA5 28001,10469,484,9985,0.04623173177953959,7.270445772841931
ZCTA5 77434,1624,107,1517,0.06588669950738917,7.268351454491924
ZCTA5 95692,1787,115,1672,0.06435366536094013,7.263997649795609
ZCTA5 79044,305,33,272,0.10819672131147541,7.259062307563538
ZCTA5 87312,186,24,162,0.12903225806451613,7.248991617042079
ZCTA5 17240,1252,88,1164,0.07028753993610223,7.247793830686965
ZCTA5 98409,9956,463,9493,0.046504620329449575,7.241498559747791
ZCTA5 06516,19576,837,18739,0.04275643645279935,7.237860293124026
ZCTA5 25916,68,13,55,0.19117647058823528,7.232867151753033
ZCTA5 11222,17256,748,16508,0.04334724153917478,7.227047006222262
ZCTA5 41035,4023,217,3806,0.05393984588615461,7.2258140066743
ZCTA5 79343,536,48,488,0.08955223880597014,7.222587943739546
ZCTA5 39108,619,53,566,0.08562197092084006,7.217891361449335
ZCTA5 71018,619,53,566,0.08562197092084006,7.217891361449335
ZCTA5 08010,4324,230,4094,0.05319148936170213,7.21759339339137
ZCTA5 16832,175,23,152,0.13142857142857142,7.207662437014239
ZCTA5 05736,252,29,223,0.11507936507936507,7.20588335485836
ZCTA5 78069,1715,111,1604,0.06472303206997085,7.201221743619327
ZCTA5 27379,2111,130,1981,0.06158218853623875,7.186959182791259
ZCTA5 29075,995,74,921,0.0743718592964824,7.177694102136513
ZCTA5 95045,1378,94,1284,0.06821480406386067,7.175868217388512
ZCTA5 22719,108,17,91,0.1574074074074074,7.163621333901475
ZCTA5 86314,15323,672,14651,0.0438556418455916,7.160222743905632
ZCTA5 72744,2074,128,1946,0.06171648987463838,7.157710210498391
ZCTA5 43228,21369,903,20466,0.04225747578267584,7.156441400783588
ZCTA5 32680,4550,239,4311,0.05252747252747253,7.154724840192859
ZCTA5 33325,9099,427,8672,0.04692823387185405,7.147530609097825
ZCTA5 57642,558,49,509,0.08781362007168458,7.140928215493155
ZCTA5 10523,2898,166,2732,0.05728088336783989,7.13304611688496
ZCTA5 16801,17841,768,17073,0.043046914410627204,7.12544553279716
ZCTA5 50065,311,33,278,0.10610932475884244,7.125400823939793
ZCTA5 92117,20865,883,19982,0.04231967409537503,7.121506735441969
ZCTA5 12734,355,36,319,0.10140845070422536,7.120223670351693
ZCTA5 46117,216,26,190,0.12037037037037036,7.103793996489881
ZCTA5 80045,561,49,512,0.0873440285204991,7.09824494544943
ZCTA5 33527,4753,247,4506,0.05196717862402693,7.097774482295608
ZCTA5 27880,1369,93,1276,0.0679327976625274,7.094370136811036
ZCTA5 94021,61,12,49,0.19672131147540983,7.09131280215228
ZCTA5 70465,191,24,167,0.1256544502617801,7.086172142499824
ZCTA5 85020,15522,678,14844,0.04367993815229996,7.084832033947668
ZCTA5 53225,9701,450,9251,0.04638697041542109,7.0837187588454364
ZCTA5 97461,257,29,228,0.11284046692607004,7.077417556558374
ZCTA5 77373,19975,848,19127,0.042453066332916144,7.072809493362203
ZCTA5 29355,388,38,350,0.0979381443298969,7.063667891704689
ZCTA5 96059,245,28,217,0.11428571428571428,7.036013097125262
ZCTA5 54748,583,50,533,0.08576329331046312,7.0238334870266215
ZCTA5 94044,13954,616,13338,0.04414504801490612,7.022999820340422
ZCTA5 84096,12186,547,11639,0.04488757590677827,7.018856155221947
ZCTA5 06519,5227,266,4961,0.05088961163191123,7.0100380151019195
ZCTA5 78019,391,38,353,0.09718670076726342,7.00829137356306
ZCTA5 74873,4244,224,4020,0.0527803958529689,7.001580755533968
ZCTA5 11426,6356,313,6043,0.04924480805538074,7.0008792667265745
ZCTA5 54427,470,43,427,0.09148936170212765,6.996855514415345
ZCTA5 87320,157,21,136,0.1337579617834395,6.9892404366435965
ZCTA5 10310,8346,394,7952,0.04720824346992571,6.987650450861878
ZCTA5 41008,2665,154,2511,0.05778611632270169,6.9853341747485045
ZCTA5 78870,289,31,258,0.10726643598615918,6.978147416247008
ZCTA5 55423,15117,660,14457,0.04365945624131772,6.977787950039968
ZCTA5 78357,869,66,803,0.0759493670886076,6.966458789377489
ZCTA5 96783,639,53,586,0.08294209702660407,6.956842036079019
ZCTA5 07020,5746,287,5459,0.049947789766794294,6.952801764134438
ZCTA5 94403,16382,708,15674,0.04321816628006348,6.949774030418882
ZCTA5 98125,19008,808,18200,0.04250841750841751,6.9419249642464465
ZCTA5 22737,1003,73,930,0.07278165503489531,6.9264214273628175
ZCTA5 97205,4992,255,4737,0.05108173076923077,6.926130994892157
ZCTA5 99645,8670,406,8264,0.046828143021914646,6.925171962186265
ZCTA5 98109,16400,708,15692,0.04317073170731707,6.9198094848949125
ZCTA5 93561,11574,521,11053,0.0450146880940038,6.916385682242539
ZCTA5 75137,6776,329,6447,0.04855371900826446,6.912124303969695
ZCTA5 95829,8279,390,7889,0.047107138543302333,6.908386933122306
ZCTA5 99801,11554,520,11034,0.04500605850787606,6.905248852130112
ZCTA5 93924,2550,148,2402,0.05803921568627451,6.904032950408205
ZCTA5 75933,444,41,403,0.09234234234234234,6.9005248291438885
ZCTA5 77575,5765,287,5478,0.049783174327840414,6.894779739579745
ZCTA5 81146,237,27,210,0.11392405063291139,6.889223100136015
ZCTA5 65667,1141,80,1061,0.07011393514460999,6.8864390472802715
ZCTA5 78376,224,26,198,0.11607142857142858,6.876342804643238
ZCTA5 36582,8917,415,8502,0.04654031624985982,6.87197651746088
ZCTA5 65759,544,47,497,0.08639705882352941,6.867040062095238
ZCTA5 24815,280,30,250,0.10714285714285714,6.85713207344794
ZCTA5 75052,29698,1206,28492,0.040608795205064316,6.856600092000037
ZCTA5 69331,25,7,18,0.28,6.855366426727505
ZCTA5 99733,25,7,18,0.28,6.855366426727505
ZCTA5 48756,1979,121,1858,0.06114199090449722,6.849731953651668
ZCTA5 33585,480,43,437,0.08958333333333333,6.838671153867253
ZCTA5 35087,956,70,886,0.07322175732217573,6.837864180568865
ZCTA5 30329,11463,515,10948,0.0449271569397191,6.831023650390645
ZCTA5 75493,126,18,108,0.14285714285714285,6.829316311698408
ZCTA5 75435,497,44,453,0.08853118712273642,6.8282769508816115
ZCTA5 75558,465,42,423,0.09032258064516129,6.819618944345638
ZCTA5 63780,2349,138,2211,0.05874840357598978,6.817494840052786
ZCTA5 13757,498,44,454,0.08835341365461848,6.813080998710804
ZCTA5 93625,2350,138,2212,0.05872340425531915,6.812206371087006
ZCTA5 92880,17575,750,16825,0.04267425320056899,6.797385746486301
ZCTA5 98610,1191,82,1109,0.0688497061293031,6.793077186476407
ZCTA5 32805,7706,365,7341,0.04736568907344926,6.791250154682556
ZCTA5 60455,5559,277,5282,0.04982910595430833,6.789518715635937
ZCTA5 70083,943,69,874,0.07317073170731707,6.782499496815669
ZCTA5 33765,5899,291,5608,0.049330394982200376,6.781057381187036
ZCTA5 55950,65,12,53,0.18461538461538463,6.7773508774908935
ZCTA5 78044,116,17,99,0.14655172413793102,6.773997782092449
ZCTA5 29560,4801,245,4556,0.05103103520099979,6.7728032841473915
ZCTA5 46241,10578,479,10099,0.04528266212894687,6.7653676183000835
ZCTA5 76950,1494,97,1397,0.06492637215528782,6.764948320249221
ZCTA5 02111,3476,188,3288,0.05408515535097814,6.764276184513758
ZCTA5 95319,569,48,521,0.0843585237258348,6.752638982400979
ZCTA5 80705,437,40,397,0.09153318077803203,6.751845300748219
ZCTA5 33463,18184,772,17412,0.042454905411350635,6.74966199505666
ZCTA5 11946,5813,287,5526,0.049372097023911925,6.749127818760267
ZCTA5 75234,12016,535,11481,0.04452396804260985,6.748071750026181
ZCTA5 77660,359,35,324,0.09749303621169916,6.747664294406193
ZCTA5 60136,2406,140,2266,0.058187863674147966,6.746810983026948
ZCTA5 03466,639,52,587,0.081377151799687,6.736847082768286
ZCTA5 97218,5481,273,5208,0.04980842911877394,6.733204664225162
ZCTA5 75554,819,62,757,0.0757020757020757,6.723717647404345
ZCTA5 58784,1141,79,1062,0.06923751095530237,6.721804745904728
ZCTA5 28083,9390,431,8959,0.04589989350372737,6.706768607252339
ZCTA5 10549,5900,290,5610,0.04915254237288136,6.705660848759665
ZCTA5 57719,2924,163,2761,0.05574555403556772,6.703279365610803
ZCTA5 53825,165,21,144,0.12727272727272726,6.701831465783565
ZCTA5 93940,13044,574,12470,0.04400490647040785,6.701130130895122
ZCTA5 46254,15147,655,14492,0.04324288638014128,6.699597082709103
ZCTA5 92604,9698,443,9255,0.045679521550835225,6.695187974341214
ZCTA5 60016,22895,948,21947,0.04140642061585499,6.6914339587287435
ZCTA5 41772,96,15,81,0.15625,6.690862454705412
ZCTA5 75110,10283,466,9817,0.04531751434406302,6.690018159856962
ZCTA5 83628,1546,99,1447,0.06403622250970246,6.687031898483075
ZCTA5 88232,643,52,591,0.08087091757387248,6.686512615812829
ZCTA5 78606,2029,122,1907,0.06012814194184327,6.681755331291507
ZCTA5 91902,6249,304,5945,0.04864778364538326,6.679242632463408
ZCTA5 64040,2529,145,2384,0.057334914986160536,6.678577805043098
ZCTA5 75686,4829,245,4584,0.050735141851314974,6.678176893087397
ZCTA5 86409,11232,503,10729,0.04478276353276353,6.676742808973071
ZCTA5 96727,1527,98,1429,0.06417812704649639,6.6766512755492515
ZCTA5 54135,1050,74,976,0.07047619047619047,6.671400031358468
ZCTA5 79040,575,48,527,0.08347826086956522,6.670764137677272
ZCTA5 07109,12493,552,11941,0.04418474345633555,6.66985261877146
ZCTA5 60090,14019,611,13408,0.04358370782509451,6.669724472893038
ZCTA5 81525,491,43,448,0.08757637474541752,6.669276705719154
ZCTA5 01080,955,69,886,0.07225130890052356,6.667509520710514
ZCTA5 70517,9787,446,9341,0.04557065495044447,6.665945282854071
ZCTA5 29728,3893,205,3688,0.05265861803236579,6.663545753137071
ZCTA5 19947,6695,322,6373,0.04809559372666169,6.662226500816131
ZCTA5 17535,734,57,677,0.0776566757493188,6.659740192019524
ZCTA5 41669,232,26,206,0.11206896551724138,6.6590302919010105
ZCTA5 25634,130,18,112,0.13846153846153847,6.6581606577314165
ZCTA5 41723,594,49,545,0.08249158249158249,6.646350083280398
ZCTA5 60428,4015,210,3805,0.052303860523038606,6.642144479952101
ZCTA5 98357,493,43,450,0.0872210953346856,6.638977059969697
ZCTA5 72916,3392,183,3209,0.053950471698113206,6.638422551180528
ZCTA5 67581,119,17,102,0.14285714285714285,6.636902481365958
ZCTA5 11422,9653,440,9213,0.04558168445042992,6.626180461177554
ZCTA5 84062,13294,582,12712,0.04377914848803972,6.62028677223053
ZCTA5 43824,1292,86,1206,0.06656346749226007,6.618252453616516
ZCTA5 89503,11671,519,11152,0.044469197155342303,6.617586478201759
ZCTA5 79110,6911,330,6581,0.04774996382578498,6.609056418804774
ZCTA5 95556,248,27,221,0.10887096774193548,6.60475357653628
ZCTA5 10963,962,69,893,0.07172557172557173,6.6012191640533935
ZCTA5 97731,168,21,147,0.125,6.59866344326104
ZCTA5 72472,3609,192,3417,0.05320033250207814,6.596864288552604
ZCTA5 39501,9263,424,8839,0.045773507502968803,6.593614243327708
ZCTA5 28385,982,70,912,0.07128309572301425,6.5923762854134855
ZCTA5 76064,547,46,501,0.08409506398537477,6.586542429169158
ZCTA5 84646,547,46,501,0.08409506398537477,6.586542429169158
ZCTA5 90623,4952,249,4703,0.050282714054927305,6.585639619314434
ZCTA5 18505,8587,397,8190,0.04623267730289973,6.585083820073257
ZCTA5 05261,946,68,878,0.07188160676532769,6.572782106378337
ZCTA5 79412,5582,275,5307,0.04926549623790756,6.569376966474066
ZCTA5 11542,9958,451,9507,0.045290218919461736,6.568301022788976
ZCTA5 76180,14390,623,13767,0.04329395413481584,6.564106412945807
ZCTA5 61874,3388,182,3206,0.05371900826446281,6.559583873342227
ZCTA5 32446,3968,207,3761,0.05216733870967742,6.555328659495086
ZCTA5 39179,417,38,379,0.09112709832134293,6.549416058984486
ZCTA5 95681,354,34,320,0.096045197740113,6.549019904873882
ZCTA5 99754,34,8,26,0.23529411764705882,6.544998629332184
ZCTA5 96772,874,64,810,0.07322654462242563,6.538822051720063
ZCTA5 92356,2229,130,2099,0.05832211754149843,6.529151385242295
ZCTA5 79772,3282,177,3105,0.05393053016453382,6.5235427465618105
ZCTA5 96708,3630,192,3438,0.05289256198347107,6.512909185906649
ZCTA5 08629,3957,206,3751,0.052059641142279504,6.508561190163392
ZCTA5 95917,1147,78,1069,0.06800348735832606,6.50703779959851
ZCTA5 85202,15762,674,15088,0.042761070930085014,6.497857710951321
ZCTA5 85345,19806,827,18979,0.04175502373018277,6.4965104926905735
ZCTA5 08110,5703,279,5424,0.048921620199894794,6.495780354905946
ZCTA5 61462,4384,224,4160,0.051094890510948905,6.495502971786083
ZCTA5 28052,12377,544,11833,0.04395249252646037,6.49512436405951
ZCTA5 49459,503,43,460,0.08548707753479125,6.489699265302391
ZCTA5 99768,69,12,57,0.17391304347826086,6.488385248285663
ZCTA5 40328,437,39,398,0.08924485125858124,6.485820314872616
ZCTA5 75431,842,62,780,0.07363420427553444,6.483785490816502
ZCTA5 79014,1310,86,1224,0.06564885496183206,6.480102932010684
ZCTA5 19602,6271,302,5969,0.04815818848668474,6.475379768489714
ZCTA5 86004,13247,577,12670,0.043557031780780554,6.466405209959355
ZCTA5 72833,1393,90,1303,0.06460875807609476,6.466356031202328
ZCTA5 64664,185,22,163,0.11891891891891893,6.464510264054552
ZCTA5 57636,51,10,41,0.19607843137254902,6.4585252299409515
ZCTA5 95939,212,24,188,0.11320754716981132,6.457727695021861
ZCTA5 81635,2529,143,2386,0.056544088572558326,6.457411619213883
ZCTA5 96031,60,11,49,0.18333333333333332,6.456242028301013
ZCTA5 27703,19701,822,18879,0.04172377036698645,6.454872050322327
ZCTA5 93668,359,34,325,0.0947075208913649,6.454159011279678
ZCTA5 91214,10240,460,9780,0.044921875,6.453370997046075
ZCTA5 86025,1728,106,1622,0.061342592592592594,6.447000907232253
ZCTA5 00965,2598,146,2452,0.056197074672825253,6.446546748502004
ZCTA5 30747,5501,270,5231,0.04908198509361934,6.4458475324161855
ZCTA5 15078,160,20,140,0.125,6.439636135641267
ZCTA5 86321,772,58,714,0.07512953367875648,6.439473627641873
ZCTA5 77018,11067,492,10575,0.04445649227432909,6.4366416620940985
ZCTA5 17550,329,32,297,0.0972644376899696,6.436519995097406
ZCTA5 94005,1836,111,1725,0.06045751633986928,6.434514681724302
ZCTA5 98408,7448,349,7099,0.04685821697099893,6.433041473811768
ZCTA5 22303,6902,327,6575,0.04737757171834251,6.432703043095506
ZCTA5 97481,300,30,270,0.1,6.409794453855205
ZCTA5 86442,13981,604,13377,0.04320148773335241,6.409348000918302
ZCTA5 64124,4101,211,3890,0.05145086564252621,6.409127171173792
ZCTA5 77840,21152,875,20277,0.04136724659606657,6.3999986253682195
ZCTA5 87041,271,28,243,0.1033210332103321,6.396148596375703
ZCTA5 33351,11425,505,10920,0.044201312910284465,6.388237722992724
ZCTA5 00783,10580,472,10108,0.0446124763705104,6.382652118971438
ZCTA5 70633,2589,145,2444,0.05600617999227501,6.381354915336616
ZCTA5 16881,986,69,917,0.06997971602434078,6.378188912124413
ZCTA5 63945,379,35,344,0.09234828496042216,6.376084542478932
ZCTA5 39213,8373,385,7988,0.04598112982204706,6.374507352415732
ZCTA5 62943,162,20,142,0.12345679012345678,6.370527932967918
ZCTA5 89449,1468,93,1375,0.06335149863760219,6.370263658936765
ZCTA5 79938,22438,922,21516,0.041091006328549784,6.36156823008235
ZCTA5 77868,4589,231,4358,0.05033776421878405,6.360408960517932
ZCTA5 97216,6609,314,6295,0.04751096988954456,6.354992376874639
ZCTA5 77476,71,12,59,0.16901408450704225,6.352188156056437
ZCTA5 11428,5558,271,5287,0.04875854623965455,6.345060983025855
ZCTA5 04937,2799,154,2645,0.05501964987495534,6.344861186830787
ZCTA5 45681,600,48,552,0.08,6.340431444008932
ZCTA5 30165,15097,645,14452,0.042723719944359806,6.333786292731698
ZCTA5 25503,514,43,471,0.08365758754863813,6.329615114977807
ZCTA5 75241,10811,480,10331,0.044399223013597264,6.328645973705321
ZCTA5 89701,10070,451,9619,0.04478649453823237,6.324028886499207
ZCTA5 54302,12752,555,12197,0.04352258469259724,6.322807667458238
ZCTA5 20706,12830,558,12272,0.043491816056118474,6.322734125700584
ZCTA5 46806,8775,400,8375,0.045584045584045586,6.318881560228274
ZCTA5 77049,10639,473,10166,0.04445906570166369,6.312426743718135
ZCTA5 77051,6427,306,6121,0.047611638400497897,6.311759814300318
ZCTA5 98936,1921,114,1807,0.059344091618948464,6.310390487431049
ZCTA5 99555,62,11,51,0.1774193548387097,6.304000397095256
ZCTA5 12153,305,30,275,0.09836065573770492,6.303773955589818
ZCTA5 73571,36,8,28,0.2222222222222222,6.298580869096265
ZCTA5 87102,9318,421,8897,0.045181369392573514,6.2952918823202415
ZCTA5 32626,3639,190,3449,0.052212146194009344,6.292718701474329
ZCTA5 80736,218,24,194,0.11009174311926606,6.292637121076989
ZCTA5 95471,261,27,234,0.10344827586206896,6.288461098333783
ZCTA5 36869,8060,371,7689,0.04602977667493797,6.278514092188605
ZCTA5 78355,1992,117,1875,0.058734939759036146,6.274754584591628
ZCTA5 92064,15796,670,15126,0.04241580146872626,6.263541289720539
ZCTA5 31827,883,63,820,0.07134767836919592,6.2619184281829865
ZCTA5 78947,1715,104,1611,0.060641399416909623,6.2612189915090655
ZCTA5 45788,468,40,428,0.08547008547008547,6.25779969397172
ZCTA5 42103,8426,385,8041,0.04569190600522193,6.247009104932277
ZCTA5 63662,590,47,543,0.07966101694915254,6.241582877183845
ZCTA5 50309,4293,217,4076,0.05054740274866061,6.228246342021988
ZCTA5 59633,94,14,80,0.14893617021276595,6.2264581465100575
ZCTA5 64648,681,52,629,0.0763582966226138,6.226370584697713
ZCTA5 19152,13142,568,12574,0.043220210013696546,6.225996171897119
ZCTA5 00624,7581,351,7230,0.04629996042738425,6.21991636846006
ZCTA5 72438,1043,71,972,0.06807286673058485,6.217488923666678
ZCTA5 63563,235,25,210,0.10638297872340426,6.217212698885156
ZCTA5 27107,17254,724,16530,0.04196128433986322,6.214214831415673
ZCTA5 77365,11176,492,10684,0.04402290622763064,6.213354633260678
ZCTA5 93531,129,17,112,0.13178294573643412,6.210667568694329
ZCTA5 39144,180,21,159,0.11666666666666667,6.208512191378799
ZCTA5 80729,250,26,224,0.104,6.203031843015458
ZCTA5 00962,6888,323,6565,0.046893147502903604,6.202594348519865
ZCTA5 75080,19098,793,18305,0.041522672531155096,6.200771962815616
ZCTA5 00765,2403,135,2268,0.056179775280898875,6.195180658849857
ZCTA5 79924,19824,820,19004,0.04136400322841001,6.193294928098053
ZCTA5 75705,987,68,919,0.06889564336372847,6.192022406698049
ZCTA5 63349,684,52,632,0.07602339181286549,6.191360608591852
ZCTA5 43223,8526,388,8138,0.04550785831574009,6.189462124767805
ZCTA5 93650,1308,84,1224,0.06422018348623854,6.187812211943368
ZCTA5 62272,630,49,581,0.07777777777777778,6.186823801339613
ZCTA5 67216,8832,400,8432,0.04528985507246377,6.18561900340236
ZCTA5 55379,14738,628,14110,0.04261093771203691,6.181884078804711
ZCTA5 76692,4116,209,3907,0.05077745383867833,6.180577581593771
ZCTA5 99830,181,21,160,0.11602209944751381,6.177509348493267
ZCTA5 88203,10652,471,10181,0.04421704844160721,6.177374905727117
ZCTA5 37820,2973,160,2813,0.053817692566431215,6.174642470704288
ZCTA5 48633,95,14,81,0.14736842105263157,6.174512960702197
ZCTA5 93444,7148,333,6815,0.046586457750419696,6.174377594585147
ZCTA5 28114,2634,145,2489,0.055049354593773726,6.1634852003758676
ZCTA5 95323,392,35,357,0.08928571428571429,6.147311267147172
ZCTA5 70647,3490,182,3308,0.052148997134670486,6.141797185954994
ZCTA5 41603,634,49,585,0.07728706624605679,6.137721205174108
ZCTA5 66093,224,24,200,0.10714285714285714,6.133205378769469
ZCTA5 76133,18264,760,17504,0.04161191414805081,6.130938397814924
ZCTA5 64625,210,23,187,0.10952380952380952,6.130327831001147
ZCTA5 44822,1014,69,945,0.06804733727810651,6.125921898208909
ZCTA5 31328,1441,90,1351,0.062456627342123525,6.122499328245459
ZCTA5 32216,15592,659,14933,0.0422652642380708,6.118429995076253
ZCTA5 40995,46,9,37,0.1956521739130435,6.117688445002737
ZCTA5 95119,3263,172,3091,0.05271222801103279,6.117618426598005
ZCTA5 78203,1976,115,1861,0.05819838056680162,6.116864038960335
ZCTA5 04259,1318,84,1234,0.0637329286798179,6.113047648657021
ZCTA5 50001,254,26,228,0.10236220472440945,6.107301626311218
ZCTA5 88022,411,36,375,0.08759124087591241,6.103489136627122
ZCTA5 05068,1424,89,1335,0.0625,6.095379451861588
ZCTA5 30607,3386,177,3209,0.0522740696987596,6.090067378443238
ZCTA5 83530,2223,126,2097,0.05668016194331984,6.089836963906858
ZCTA5 76639,584,46,538,0.07876712328767123,6.089633822227289
ZCTA5 35990,30,7,23,0.23333333333333334,6.088231042247328
ZCTA5 96755,1058,71,987,0.0671077504725898,6.0874615849840366
ZCTA5 00915,10980,482,10498,0.04389799635701275,6.085841817967555
ZCTA5 95066,5644,271,5373,0.04801559177888023,6.083563769242685
ZCTA5 17562,1322,84,1238,0.06354009077155824,6.083325248849083
ZCTA5 21227,12097,525,11572,0.043399189881788876,6.082808974940447
ZCTA5 74432,4217,212,4005,0.05027270571496324,6.07366844481501
ZCTA5 26036,158,19,139,0.12025316455696203,6.067446956141888
ZCTA5 40155,430,37,393,0.08604651162790698,6.064838319444919
ZCTA5 22043,9012,405,8607,0.044940079893475364,6.063678174855937
ZCTA5 84083,447,38,409,0.08501118568232663,6.061833608279633
ZCTA5 94041,6368,300,6068,0.0471105527638191,6.060351750791863
ZCTA5 78742,256,26,230,0.1015625,6.060142767358994
ZCTA5 40117,1002,68,934,0.06786427145708583,6.0573401153879844
ZCTA5 30439,3960,201,3759,0.05075757575757576,6.055365198819958
ZCTA5 95448,6893,321,6572,0.046568983026258524,6.055175878894165
ZCTA5 95415,414,36,378,0.08695652173913043,6.053904224474245
ZCTA5 97885,587,46,541,0.07836456558773425,6.051016136376244
ZCTA5 04047,771,56,715,0.07263294422827497,6.049790017627654
ZCTA5 35975,172,20,152,0.11627906976744186,6.040708426200427
ZCTA5 79731,1411,88,1323,0.06236711552090716,6.039733835295732
ZCTA5 78007,56,10,46,0.17857142857142858,6.03915239287981
ZCTA5 33441,11029,483,10546,0.04379363496237193,6.0384565887372705
ZCTA5 81144,2661,145,2516,0.05449079293498685,6.03475952687288
ZCTA5 97135,366,33,333,0.09016393442622951,6.0333834202836565
ZCTA5 76426,4205,211,3994,0.050178359096313914,6.03099760660913
ZCTA5 16222,946,65,881,0.06871035940803383,6.030358185307195
ZCTA5 75143,5466,263,5203,0.048115623856567875,6.027991737102857
ZCTA5 78412,14775,626,14149,0.04236886632825719,6.0260062836308395
ZCTA5 95494,47,9,38,0.19148936170212766,6.02511951128654
ZCTA5 07062,3992,202,3790,0.05060120240480962,6.024837980683414
ZCTA5 98855,2595,142,2453,0.054720616570327556,6.024557270431467
ZCTA5 99682,98,14,84,0.14285714285714285,6.022890861783619
ZCTA5 30429,66,11,55,0.16666666666666666,6.018383030639911
ZCTA5 78409,967,66,901,0.06825232678386763,6.01771526145352
ZCTA5 99765,87,13,74,0.14942528735632185,6.015508128242173
ZCTA5 52635,335,31,304,0.09253731343283582,6.013794184859833
ZCTA5 27953,417,36,381,0.08633093525179857,6.004756518314022
ZCTA5 19946,1974,114,1860,0.057750759878419454,6.003169778479975
ZCTA5 28457,3951,200,3751,0.050620096178182736,6.00042338692961
ZCTA5 78159,368,33,335,0.08967391304347826,5.997569647178314
ZCTA5 19390,4867,238,4629,0.04890076022190261,5.992723150647354
ZCTA5 58568,201,22,179,0.10945273631840796,5.991921597543951
ZCTA5 40067,2064,118,1946,0.05717054263565891,5.991903440839005
ZCTA5 88007,8610,388,8222,0.045063879210220675,5.990776212759718
ZCTA5 36276,892,62,830,0.06950672645739911,5.987984730547817
ZCTA5 67204,7802,356,7446,0.045629325813893874,5.980504447025774
ZCTA5 83540,740,54,686,0.07297297297297298,5.97835797569018
ZCTA5 79846,17,5,12,0.29411764705882354,5.97678536403202
ZCTA5 15752,17,5,12,0.29411764705882354,5.97678536403202
ZCTA5 92019,14566,617,13949,0.04235891802828505,5.976556989290865
ZCTA5 95674,290,28,262,0.09655172413793103,5.975498270090924
ZCTA5 34753,1783,105,1678,0.05888951205832866,5.97275975753604
ZCTA5 59211,57,10,47,0.17543859649122806,5.961300904645216
ZCTA5 82322,57,10,47,0.17543859649122806,5.961300904645216
ZCTA5 63960,1093,72,1021,0.06587374199451052,5.960455394256139
ZCTA5 20130,123,16,107,0.13008130081300814,5.959563209259012
ZCTA5 93035,9982,441,9541,0.04417952314165498,5.959095117088043
ZCTA5 25264,111,15,96,0.13513513513513514,5.957498718012604
ZCTA5 65459,2496,137,2359,0.05488782051282051,5.954975444318839
ZCTA5 77642,13815,588,13227,0.04256243213897937,5.953472194257122
ZCTA5 60640,34969,1370,33599,0.03917755726500615,5.951848463831998
ZCTA5 56187,5075,246,4829,0.048472906403940884,5.949935680511756
ZCTA5 84751,668,50,618,0.0748502994011976,5.949908429518383
ZCTA5 28430,819,58,761,0.07081807081807082,5.9464310349302
ZCTA5 77422,4834,236,4598,0.048820852296235,5.9414759029676425
ZCTA5 78208,1552,94,1458,0.06056701030927835,5.9399494741412475
ZCTA5 94030,8047,365,7682,0.04535851870262209,5.938583848958574
ZCTA5 72801,6588,307,6281,0.046599878567091683,5.933641739297808
ZCTA5 07740,12019,519,11500,0.043181629087278475,5.930525600864823
ZCTA5 38953,149,18,131,0.12080536912751678,5.9295912692482755
ZCTA5 93001,12806,549,12257,0.04287052943932532,5.925831035484678
ZCTA5 63543,100,14,86,0.14,5.925149064510481
ZCTA5 33607,10644,466,10178,0.04378053363397219,5.924608498934887
ZCTA5 70660,597,46,551,0.07705192629815745,5.923981066973709
ZCTA5 29168,1386,86,1300,0.06204906204906205,5.920140565956834
ZCTA5 23108,78,12,66,0.15384615384615385,5.912998016321756
ZCTA5 48896,89,13,76,0.14606741573033707,5.908092965627347
ZCTA5 67219,4553,224,4329,0.04919833077092027,5.90784781531751
ZCTA5 17088,357,32,325,0.0896358543417367,5.903253010551583
ZCTA5 38873,1100,72,1028,0.06545454545454546,5.902194088531187
ZCTA5 49455,1861,108,1753,0.05803331542181623,5.896600580422219
ZCTA5 77371,2510,137,2373,0.05458167330677291,5.886356420945313
ZCTA5 97754,8299,374,7925,0.0450656705627184,5.882492866959408
ZCTA5 78747,6558,305,6253,0.04650808173223544,5.878775631029983
ZCTA5 83424,125,16,109,0.128,5.878413988392347
ZCTA5 49507,12151,523,11628,0.043041724960908564,5.8772400559810425
ZCTA5 79401,3321,172,3149,0.051791629027401385,5.876718149906774
ZCTA5 71642,264,26,238,0.09848484848484848,5.8760145966145805
ZCTA5 21841,442,37,405,0.083710407239819,5.87575346596132
ZCTA5 00745,15976,668,15308,0.04181271907861793,5.875217477166708
ZCTA5 74342,1144,74,1070,0.06468531468531469,5.874392468233471
ZCTA5 40390,2332,129,2203,0.05531732418524871,5.871359349176937
ZCTA5 72638,2720,146,2574,0.05367647058823529,5.865113983713407
ZCTA5 92262,13233,564,12669,0.042620720924960324,5.864007262709679
ZCTA5 92241,3584,183,3401,0.051060267857142856,5.861493689999434
ZCTA5 77089,16997,706,16291,0.041536741777960816,5.859959181020968
ZCTA5 66769,151,18,133,0.11920529801324503,5.859911549245864
ZCTA5 13751,40,8,32,0.2,5.85769424858653
ZCTA5 85618,639,48,591,0.07511737089201878,5.856867269525356
ZCTA5 43229,20861,850,20011,0.040745889458798715,5.856739854827046
ZCTA5 97383,3444,177,3267,0.05139372822299652,5.85469858855089
ZCTA5 72539,79,12,67,0.1518987341772152,5.854523266211048
ZCTA5 50653,235,24,211,0.10212765957446808,5.854444493839563
ZCTA5 78612,3919,197,3722,0.050267925491196734,5.853470809669741
ZCTA5 77962,1209,77,1132,0.06368899917287014,5.846321267935946
ZCTA5 95427,126,16,110,0.12698412698412698,5.838466410533383
ZCTA5 63430,221,23,198,0.10407239819004525,5.838154891855018
ZCTA5 89318,532,42,490,0.07894736842105263,5.835320000371805
ZCTA5 84622,568,44,524,0.07746478873239436,5.83302726368023
ZCTA5 76448,1894,109,1785,0.05755015839493136,5.831717124793693
ZCTA5 10703,7457,340,7117,0.045594743194314065,5.830174745366263
ZCTA5 04461,1170,75,1095,0.0641025641025641,5.829921100670143
ZCTA5 94710,2936,155,2781,0.05279291553133515,5.8273041963602354
ZCTA5 96712,2500,136,2364,0.0544,5.824103453493418
ZCTA5 37874,5385,257,5128,0.04772516248839369,5.823817590197984
ZCTA5 83420,812,57,755,0.07019704433497537,5.822551673130633
ZCTA5 73746,7,3,4,0.42857142857142855,5.813505397134141
ZCTA5 72081,2805,149,2656,0.05311942959001782,5.791986105073961
ZCTA5 00906,115,15,100,0.13043478260869565,5.7835785088858644
ZCTA5 72401,22291,901,21390,0.04041990040823651,5.783485325597189
ZCTA5 59072,1881,108,1773,0.05741626794258373,5.779375943197679
ZCTA5 77065,15104,633,14471,0.0419094279661017,5.7787235978953175
ZCTA5 32209,13207,561,12646,0.04247747406678277,5.766695361368304
ZCTA5 92308,14291,602,13689,0.04212441396683227,5.763971173331059
ZCTA5 38619,2061,116,1945,0.056283357593401265,5.763563607429451
ZCTA5 78252,2743,146,2597,0.05322639445862195,5.758771413760864
ZCTA5 38621,574,44,530,0.07665505226480836,5.7558691445258185
ZCTA5 60459,9173,406,8767,0.044260329227079474,5.755552469637323
ZCTA5 44055,7488,340,7148,0.045405982905982904,5.751444956889147
ZCTA5 05404,3164,164,3000,0.051833122629582805,5.7491053638104495
ZCTA5 77303,6707,309,6398,0.04607126882361712,5.746244138902647
ZCTA5 33566,7035,322,6713,0.045771144278606964,5.745084684847375
ZCTA5 39336,521,41,480,0.07869481765834933,5.742619757236864
ZCTA5 87567,557,43,514,0.07719928186714542,5.741422257222524
ZCTA5 75246,1306,81,1225,0.062021439509954056,5.7411945175112065
ZCTA5 31771,1866,107,1759,0.05734190782422294,5.738422863960689
ZCTA5 70512,3474,177,3297,0.05094991364421416,5.734670787066103
ZCTA5 92672,14230,599,13631,0.042094167252283904,5.7315912769065
ZCTA5 87560,487,39,448,0.08008213552361396,5.7223360091253666
ZCTA5 22952,822,57,765,0.06934306569343066,5.722136203388479
ZCTA5 99110,595,45,550,0.07563025210084033,5.721198907613895
ZCTA5 87722,211,22,189,0.10426540284360189,5.72013190848327
ZCTA5 94518,10539,458,10081,0.043457633551570354,5.710968945788321
ZCTA5 27828,3504,178,3326,0.050799086757990865,5.70972812186217
ZCTA5 28432,633,47,586,0.07424960505529225,5.707891728378163
ZCTA5 79754,33,7,26,0.21212121212121213,5.707742498700109
ZCTA5 84053,319,29,290,0.09090909090909091,5.7067010220161665
ZCTA5 96722,863,59,804,0.06836616454229433,5.703510153941852
ZCTA5 39149,652,48,604,0.0736196319018405,5.703465946500101
ZCTA5 39194,6147,286,5861,0.04652676102163657,5.699723552426174
ZCTA5 39208,11407,491,10916,0.04304374506881739,5.695667622659139
ZCTA5 74730,1742,101,1641,0.05797933409873708,5.6924305323764095
ZCTA5 25141,71,11,60,0.15492957746478872,5.692203296124238
ZCTA5 92314,4495,219,4276,0.04872080088987764,5.692053108457137
ZCTA5 70346,3987,198,3789,0.04966139954853273,5.6910568246321835
ZCTA5 24977,227,23,204,0.1013215859030837,5.686393131657555
ZCTA5 39062,198,21,177,0.10606060606060606,5.681596499765542
ZCTA5 64497,143,17,126,0.11888111888111888,5.681011363017987
ZCTA5 28723,3488,177,3311,0.0507454128440367,5.679048826437536
ZCTA5 99780,544,42,502,0.07720588235294118,5.674882379673417
ZCTA5 98814,337,30,307,0.08902077151335312,5.672719551802508
ZCTA5 99692,61,10,51,0.16393442622950818,5.667253006734291
ZCTA5 79230,42,8,34,0.19047619047619047,5.659109982432603
ZCTA5 95442,1381,84,1297,0.0608254887762491,5.656586727440962
ZCTA5 32190,371,32,339,0.0862533692722372,5.655575255642059
ZCTA5 97526,14831,620,14211,0.041804328770817883,5.65508283650205
ZCTA5 39886,694,50,644,0.07204610951008646,5.653775960826845
ZCTA5 39189,1297,80,1217,0.06168080185042406,5.653156043059882
ZCTA5 84076,94,13,81,0.13829787234042554,5.652871251192527
ZCTA5 04416,2307,126,2181,0.054616384915474644,5.65257634439345
ZCTA5 78829,306,28,278,0.0915032679738562,5.647012414247187
ZCTA5 84118,19955,811,19144,0.04064144324730644,5.646097516083664
ZCTA5 27834,22908,920,21988,0.040160642570281124,5.644763469222514
ZCTA5 76554,714,51,663,0.07142857142857142,5.642899073059963
ZCTA5 32542,658,48,610,0.0729483282674772,5.633886373733331
ZCTA5 83350,4561,221,4340,0.048454286340714754,5.633593587922477
ZCTA5 57639,83,12,71,0.14457831325301204,5.630024814452932
ZCTA5 60506,17759,729,17030,0.04104960864913565,5.628863587035961
ZCTA5 72583,754,53,701,0.07029177718832891,5.625217216185278
ZCTA5 37326,158,18,140,0.11392405063291139,5.625027106509366
ZCTA5 95356,11628,498,11130,0.04282765737874097,5.620994770603928
ZCTA5 74070,5403,255,5148,0.04719600222098834,5.617237222487095
ZCTA5 54639,992,65,927,0.0655241935483871,5.617165083686324
ZCTA5 97638,172,19,153,0.11046511627906977,5.616676141550876
ZCTA5 89419,1494,89,1405,0.059571619812583666,5.6139416629692205
ZCTA5 14213,9393,412,8981,0.04386245076120515,5.609717564671308
ZCTA5 93518,425,35,390,0.08235294117647059,5.606022713417781
ZCTA5 08536,7801,350,7451,0.04486604281502372,5.6052138858829705
ZCTA5 13167,1283,79,1204,0.06157443491816056,5.601375116706037
ZCTA5 79908,854,58,796,0.06791569086651054,5.600483506644645
ZCTA5 07204,5087,242,4845,0.04757224297228229,5.599728841264805
ZCTA5 31066,443,36,407,0.08126410835214447,5.596061430505397
ZCTA5 76452,26,6,20,0.23076923076923078,5.595126142844375
ZCTA5 40313,1138,72,1066,0.0632688927943761,5.59324571062207
ZCTA5 83286,409,34,375,0.08312958435207823,5.586831921137748
ZCTA5 02171,7886,353,7533,0.044762870910474255,5.584717434956498
ZCTA5 95826,15032,626,14406,0.041644491750931344,5.584294146932662
ZCTA5 76006,11700,500,11200,0.042735042735042736,5.582660044528291
ZCTA5 57521,73,11,62,0.1506849315068493,5.570136903756176
ZCTA5 96029,73,11,62,0.1506849315068493,5.570136903756176
ZCTA5 38254,19,5,14,0.2631578947368421,5.56811037076901
ZCTA5 27827,19,5,14,0.2631578947368421,5.56811037076901
ZCTA5 78359,645,47,598,0.07286821705426356,5.56664032063042
ZCTA5 92359,3092,159,2933,0.051423027166882275,5.556501405913436
ZCTA5 25871,311,28,283,0.09003215434083602,5.548686703136795
ZCTA5 85027,15536,644,14892,0.04145211122554068,5.5437884972936
ZCTA5 10065,14844,618,14226,0.041632983023443815,5.541466172007696
ZCTA5 92563,17952,734,17218,0.04088680926916221,5.5380642006907
ZCTA5 30436,4493,217,4276,0.04829735143556644,5.532940894921254
ZCTA5 11361,10026,435,9591,0.04338719329742669,5.531016857059557
ZCTA5 76272,1550,91,1459,0.05870967741935484,5.529472854926191
ZCTA5 80223,7781,348,7433,0.04472432849248169,5.528506451432341
ZCTA5 46103,53,9,44,0.16981132075471697,5.520504233052054
ZCTA5 38804,7047,319,6728,0.04526748971193416,5.514857861881916
ZCTA5 74462,2987,154,2833,0.05155674589889521,5.501982844732808
ZCTA5 47519,250,24,226,0.096,5.499598194811218
ZCTA5 83670,162,18,144,0.1111111111111111,5.496680457942723
ZCTA5 81623,5569,260,5309,0.04668701741784881,5.491645022020311
ZCTA5 50158,11747,500,11247,0.04256405890865753,5.490803852328587
ZCTA5 36915,282,26,256,0.09219858156028368,5.485973086313075
ZCTA5 79027,1601,93,1508,0.05808869456589631,5.481527526595501
ZCTA5 40359,2502,133,2369,0.05315747402078337,5.480801955433316
ZCTA5 76071,1321,80,1241,0.06056018168054504,5.478717480401023
ZCTA5 49444,9949,431,9518,0.043320936777565586,5.47298468450608
ZCTA5 73546,469,37,432,0.07889125799573561,5.472166466669057
ZCTA5 98526,86,12,74,0.13953488372093023,5.470770307007927
ZCTA5 74010,3975,195,3780,0.04905660377358491,5.470434883930539
ZCTA5 25287,299,27,272,0.0903010033444816,5.466437821327964
ZCTA5 87577,163,18,145,0.11042944785276074,5.4652214855133225
ZCTA5 38485,2506,133,2373,0.05307262569832402,5.461560415244643
ZCTA5 78239,9020,395,8625,0.04379157427937916,5.4597729625243465
ZCTA5 84058,11213,479,10734,0.04271827343262285,5.455364002703207
ZCTA5 79346,790,54,736,0.06835443037974684,5.455120805144312
ZCTA5 76622,400,33,367,0.0825,5.454997159530814
ZCTA5 83448,580,43,537,0.07413793103448275,5.448756394775566
ZCTA5 07032,13568,568,13000,0.04186320754716981,5.447073785095546
ZCTA5 45303,951,62,889,0.06519453207150368,5.443324140710547
ZCTA5 72315,8769,385,8384,0.04390466415782871,5.442165082165234
ZCTA5 46619,7560,338,7222,0.04470899470899471,5.442014798612389
ZCTA5 74110,4990,236,4754,0.047294589178356716,5.437010525457415
ZCTA5 66612,1242,76,1166,0.061191626409017714,5.436123761053083
ZCTA5 71944,317,28,289,0.08832807570977919,5.433229162297803
ZCTA5 27851,1897,106,1791,0.0558777016341592,5.431243693395931
ZCTA5 30830,4968,235,4733,0.047302737520128826,5.428205805659922
ZCTA5 37028,402,33,369,0.08208955223880597,5.422852585004188
ZCTA5 16633,99,13,86,0.13131313131313133,5.414782220406815
ZCTA5 96780,208,21,187,0.10096153846153846,5.414339486538778
ZCTA5 29540,1878,105,1773,0.05591054313099041,5.411890769761233
ZCTA5 93221,4800,228,4572,0.0475,5.411637781866027
ZCTA5 39425,854,57,797,0.06674473067915691,5.410185511904162
ZCTA5 73169,736,51,685,0.06929347826086957,5.4070540586833
ZCTA5 81069,835,56,779,0.06706586826347305,5.401269110357918
ZCTA5 73620,474,37,437,0.07805907172995781,5.400502014663485
ZCTA5 55768,1311,79,1232,0.060259344012204424,5.397365620276788
ZCTA5 92066,194,20,174,0.10309278350515463,5.394033423479405
ZCTA5 47921,404,33,371,0.08168316831683169,5.390901011407614
ZCTA5 73033,138,16,122,0.11594202898550725,5.388802961107981
ZCTA5 75757,4315,208,4107,0.04820393974507532,5.388109977427292
ZCTA5 60188,14961,619,14342,0.0413742396898603,5.387262165666059
ZCTA5 48141,9130,398,8732,0.043592552026286965,5.387208556413473
ZCTA5 30537,585,43,542,0.0735042735042735,5.386961387842777
ZCTA5 72014,20,5,15,0.25,5.385522082192998
ZCTA5 86016,20,5,15,0.25,5.385522082192998
ZCTA5 71772,1,1,0,1,5.375087805374116
ZCTA5 27924,1487,87,1400,0.05850706119704102,5.372483721753158
ZCTA5 84719,36,7,29,0.19444444444444445,5.371725656126679
ZCTA5 02908,12232,516,11716,0.04218443427076521,5.369518293929576
ZCTA5 84773,100,13,87,0.13,5.369035936728729
ZCTA5 58329,1001,64,937,0.06393606393606394,5.3631630813409705
ZCTA5 27007,859,57,802,0.06635622817229336,5.362678333184255
ZCTA5 83210,1147,71,1076,0.06190061028770706,5.357615870908169
ZCTA5 17948,1910,106,1804,0.05549738219895288,5.357388596650219
ZCTA5 81650,4670,222,4448,0.04753747323340471,5.3520932419798015
ZCTA5 54766,664,47,617,0.07078313253012049,5.349241234432815
ZCTA5 25422,703,49,654,0.06970128022759602,5.344575882155627
ZCTA5 82730,742,51,691,0.06873315363881402,5.344169055906336
ZCTA5 71965,126,15,111,0.11904761904761904,5.34304145995087
ZCTA5 54651,533,40,493,0.075046904315197,5.340026290156546
ZCTA5 97734,1045,66,979,0.06315789473684211,5.339874423767855
ZCTA5 47226,77,11,66,0.14285714285714285,5.338722142868239
ZCTA5 98857,1213,74,1139,0.06100577081615829,5.33628645129
ZCTA5 94122,23141,920,22221,0.039756276738256775,5.331316855118117
ZCTA5 35651,461,36,425,0.07809110629067245,5.329754642656265
ZCTA5 33334,12280,517,11763,0.04210097719869707,5.328612271759726
ZCTA5 70377,1495,87,1408,0.05819397993311037,5.319596718309682
ZCTA5 78883,140,16,124,0.11428571428571428,5.31872596468194
ZCTA5 49826,89,12,77,0.1348314606741573,5.318614229134983
ZCTA5 92385,89,12,77,0.1348314606741573,5.318614229134983
ZCTA5 84713,1237,75,1162,0.060630557801131774,5.315430697722326
ZCTA5 20111,10210,438,9772,0.04289911851126347,5.307279556625799
ZCTA5 72950,127,15,112,0.11811023622047244,5.305455602534078
ZCTA5 57370,291,26,265,0.08934707903780069,5.302317615765243
ZCTA5 89427,445,35,410,0.07865168539325842,5.3022103320054175
ZCTA5 41839,592,43,549,0.07263513513513513,5.301493713471242
ZCTA5 95827,7232,323,6909,0.04466261061946902,5.30071527199013
ZCTA5 72301,9588,414,9174,0.043178973717146435,5.295469373840794
ZCTA5 98055,9511,411,9100,0.04321312164861739,5.29268287741744
ZCTA5 50320,7647,339,7308,0.04433111023930953,5.28947131707436
ZCTA5 98272,9643,416,9227,0.043140101628124025,5.289408049650151
ZCTA5 13428,631,45,586,0.07131537242472266,5.288972625247472
ZCTA5 80644,1072,67,1005,0.0625,5.28862951849396
ZCTA5 89118,8137,358,7779,0.04399655892835197,5.288482486875917
ZCTA5 00718,8241,362,7879,0.04392670792379565,5.2869080278298375
ZCTA5 79316,3589,177,3412,0.04931735859570911,5.284917249252913
ZCTA5 27807,2451,129,2322,0.05263157894736842,5.279866423272452
ZCTA5 64874,309,27,282,0.08737864077669903,5.271420236842386
ZCTA5 17540,3690,181,3509,0.04905149051490515,5.268950488685739
ZCTA5 28650,4352,208,4144,0.04779411764705882,5.2608116494159125
ZCTA5 65635,245,23,222,0.09387755102040816,5.25957487298237
ZCTA5 81022,558,41,517,0.07347670250896057,5.2575565393663375
ZCTA5 40006,1951,107,1844,0.0548436699128652,5.25400887071356
ZCTA5 42101,21179,846,20333,0.03994522876434204,5.253226231199922
ZCTA5 36761,378,31,347,0.082010582010582,5.249947075432909
ZCTA5 95219,10895,463,10432,0.04249655805415328,5.248752497211557
ZCTA5 68132,5828,267,5561,0.04581331503088538,5.2469697336914205
ZCTA5 95350,19826,796,19030,0.040149298900433776,5.242452373948726
ZCTA5 06105,9613,414,9199,0.04306668053677312,5.241141225773095
ZCTA5 58830,103,13,90,0.1262135922330097,5.235274079852116
ZCTA5 95841,8212,360,7852,0.043838285435947394,5.233037010398902
ZCTA5 98350,129,15,114,0.11627906976744186,5.231406953944287
ZCTA5 23830,432,34,398,0.0787037037037037,5.230200853770372
ZCTA5 28027,22810,905,21905,0.0396755808855765,5.22527480294161
ZCTA5 28537,57,9,48,0.15789473684210525,5.224711072709638
ZCTA5 29611,11331,479,10852,0.04227340923131233,5.2206488518493614
ZCTA5 02126,10095,432,9663,0.042793462109955424,5.218270383325353
ZCTA5 78881,696,48,648,0.06896551724137931,5.209954682014399
ZCTA5 28464,1145,70,1075,0.0611353711790393,5.208942667119967
ZCTA5 99556,1061,66,995,0.06220546654099906,5.208073139572364
ZCTA5 84663,9291,401,8890,0.04316004735765795,5.202662166559135
ZCTA5 21530,816,54,762,0.0661764705882353,5.198176281332064
ZCTA5 78872,544,40,504,0.07352941176470588,5.198019306704689
ZCTA5 37018,857,56,801,0.06534422403733955,5.19167780977281
ZCTA5 62246,3324,165,3159,0.04963898916967509,5.189187664561654
ZCTA5 74068,4,2,2,0.5,5.1890443329307105
ZCTA5 20632,117,14,103,0.11965811965811966,5.1854069210122855
ZCTA5 94931,3229,161,3068,0.049860637968411274,5.184539220783881
ZCTA5 40050,621,44,577,0.07085346215780998,5.182883040813985
ZCTA5 97446,1783,99,1684,0.055524397083567024,5.182556663027335
ZCTA5 18344,1407,82,1325,0.05828002842928216,5.178608529889014
ZCTA5 42045,920,59,861,0.0641304347826087,5.174381140152432
ZCTA5 92307,12868,536,12332,0.04165371464096985,5.1725441367506875
ZCTA5 83873,739,50,689,0.06765899864682003,5.170967141473468
ZCTA5 95324,2757,141,2616,0.051142546245919476,5.164966981597469
ZCTA5 83639,1279,76,1203,0.05942142298670837,5.164438398151308
ZCTA5 99181,681,47,634,0.06901615271659324,5.1608555167142205
ZCTA5 24599,349,29,320,0.0830945558739255,5.1571565538313
ZCTA5 80640,3526,173,3353,0.04906409529211571,5.154694343561762
ZCTA5 32055,6165,279,5886,0.04525547445255475,5.152960128781501
ZCTA5 29080,1026,64,962,0.06237816764132553,5.152214715106815
ZCTA5 65663,882,57,825,0.06462585034013606,5.148213490335475
ZCTA5 37356,903,58,845,0.06423034330011074,5.143047335582261
ZCTA5 38141,7629,336,7293,0.04404246952418404,5.143040191602204
ZCTA5 61937,842,55,787,0.06532066508313539,5.142240810274917
ZCTA5 94546,16325,664,15661,0.04067381316998469,5.129803175229801
ZCTA5 76039,14872,610,14262,0.04101667563206025,5.128720002309211
ZCTA5 30628,2250,119,2131,0.05288888888888889,5.126617271798455
ZCTA5 38913,160,17,143,0.10625,5.12069804525832
ZCTA5 97541,646,45,601,0.0696594427244582,5.117410756920312
ZCTA5 67010,5293,244,5049,0.04609862081995088,5.115773882897664
ZCTA5 79244,301,26,275,0.08637873754152824,5.106261617072957
ZCTA5 38461,496,37,459,0.07459677419354839,5.095595267327231
ZCTA5 74764,1442,83,1359,0.057558945908460474,5.090347677086002
ZCTA5 97125,59,9,50,0.15254237288135594,5.086951596646775
ZCTA5 72051,269,24,245,0.08921933085501858,5.086295976279149
ZCTA5 94304,1845,101,1744,0.054742547425474256,5.0851325173987
ZCTA5 96716,889,57,832,0.06411698537682789,5.084226992104963
ZCTA5 28386,1868,102,1766,0.05460385438972163,5.083394851381593
ZCTA5 45849,406,32,374,0.07881773399014778,5.083145861147322
ZCTA5 98587,237,22,215,0.09282700421940929,5.083051627338455
ZCTA5 94542,4330,205,4125,0.04734411085450346,5.08282328543858
ZCTA5 96730,497,37,460,0.0744466800804829,5.08212114243322
ZCTA5 38666,2587,133,2454,0.05141090065713181,5.079099385198777
ZCTA5 35443,611,43,568,0.07037643207855974,5.075409867555694
ZCTA5 20020,21143,840,20303,0.03972946128742373,5.074284933301861
ZCTA5 25644,191,19,172,0.09947643979057591,5.074225457836748
ZCTA5 84655,3184,158,3026,0.04962311557788945,5.073752107646457
ZCTA5 20902,16605,673,15932,0.04052996085516411,5.0705223865253
ZCTA5 32550,3866,186,3680,0.04811174340403518,5.0682006326597335
ZCTA5 70528,891,57,834,0.06397306397306397,5.066052201565662
ZCTA5 12160,320,27,293,0.084375,5.06562379984667
ZCTA5 10128,30691,1186,29505,0.038643250464305494,5.055363991895055
ZCTA5 64783,355,29,326,0.08169014084507042,5.054144255050993
ZCTA5 62030,49,8,41,0.16326530612244897,5.053274296116189
ZCTA5 89438,49,8,41,0.16326530612244897,5.053274296116189
ZCTA5 28520,148,16,132,0.10810810810810811,5.050638276392159
ZCTA5 76031,5848,265,5583,0.045314637482900134,5.043891442021752
ZCTA5 29577,13393,553,12840,0.0412902262375868,5.0430726893763405
ZCTA5 39150,2128,113,2015,0.0531015037593985,5.040235488105139
ZCTA5 41537,2013,108,1905,0.05365126676602087,5.039323915856485
ZCTA5 83335,653,45,608,0.06891271056661562,5.038945052615914
ZCTA5 31096,2478,128,2350,0.0516545601291364,5.038399522306343
ZCTA5 79111,576,41,535,0.07118055555555555,5.03522259429655
ZCTA5 66544,163,17,146,0.10429447852760736,5.029640066802777
ZCTA5 01525,163,17,146,0.10429447852760736,5.029640066802777
ZCTA5 85923,163,17,146,0.10429447852760736,5.029640066802777
ZCTA5 38574,3219,159,3060,0.049394221808014914,5.0293423844776095
ZCTA5 10601,5626,256,5370,0.04550302168503377,5.025807030179795
ZCTA5 77489,11963,499,11464,0.041711945164256456,5.02275598096678
ZCTA5 04917,1000,62,938,0.062,5.020010379886403
ZCTA5 21224,19380,774,18606,0.039938080495356035,5.019630272693738
ZCTA5 64767,224,21,203,0.09375,5.018499239958817
ZCTA5 56627,149,16,133,0.10738255033557047,5.018420017851284
ZCTA5 80234,10667,450,10217,0.04218618168182244,5.015273900587654
ZCTA5 30076,16694,675,16019,0.04043368875044926,5.014918651590706
ZCTA5 24133,980,61,919,0.06224489795918367,5.0121912511217745
ZCTA5 93643,1257,74,1183,0.0588703261734288,5.0111718987220915
ZCTA5 38454,393,31,362,0.07888040712468193,5.008012767875869
ZCTA5 39095,2605,133,2472,0.05105566218809981,4.99590924492749
ZCTA5 78935,394,31,363,0.07868020304568528,4.992280649281425
ZCTA5 49663,2232,117,2115,0.05241935483870968,4.982708780110148
ZCTA5 67868,109,13,96,0.11926605504587157,4.982226151205644
ZCTA5 39885,40,7,33,0.175,4.978402188331231
ZCTA5 33173,10977,461,10516,0.04199690261455771,4.97734516142448
ZCTA5 38664,1349,78,1271,0.05782060785767235,4.976909594885222
ZCTA5 12468,413,32,381,0.0774818401937046,4.97580205296618
ZCTA5 26267,72,10,62,0.1388888888888889,4.975224851166275
ZCTA5 72846,1571,88,1483,0.056015276893698285,4.972904459130311
ZCTA5 39341,2492,128,2364,0.051364365971107544,4.972051060759305
ZCTA5 24880,84,11,73,0.13095238095238096,4.969344251190336
ZCTA5 94609,9740,414,9326,0.04250513347022587,4.967451439601863
ZCTA5 28729,1505,85,1420,0.05647840531561462,4.9672396754243415
ZCTA5 12474,450,34,416,0.07555555555555556,4.966666216450269
ZCTA5 73029,640,44,596,0.06875,4.965643728984846
ZCTA5 96064,1889,102,1787,0.05399682371625199,4.9651685295628845
ZCTA5 82718,9138,391,8747,0.04278835631429197,4.9620541286363355
ZCTA5 04614,1199,71,1128,0.05921601334445371,4.960761366254348
ZCTA5 56313,31,6,25,0.1935483870967742,4.957005760770223
ZCTA5 99575,31,6,25,0.1935483870967742,4.957005760770223
ZCTA5 91740,8357,361,7996,0.04319731961230106,4.9531808227844065
ZCTA5 44235,583,41,542,0.07032590051457976,4.950966765226996
ZCTA5 30552,661,45,616,0.0680786686838124,4.950469348328102
ZCTA5 78402,137,15,122,0.10948905109489052,4.949209623859104
ZCTA5 77003,4544,212,4332,0.04665492957746479,4.94855748316375
ZCTA5 27043,2687,136,2551,0.05061406773353182,4.946632738940084
ZCTA5 31826,946,59,887,0.06236786469344609,4.9455103431649095
ZCTA5 02903,4620,215,4405,0.046536796536796536,4.945115560079739
ZCTA5 80835,344,28,316,0.08139534883720931,4.9448185356614145
ZCTA5 92104,21017,832,20185,0.03958700099919113,4.944289448067288
ZCTA5 50128,166,17,149,0.10240963855421686,4.940664973736405
ZCTA5 95073,3926,187,3739,0.04763117677024962,4.939925631448827
ZCTA5 04292,327,27,300,0.08256880733944955,4.939093680209961
ZCTA5 54855,244,22,222,0.09016393442622951,4.926236934087636
ZCTA5 79359,845,54,791,0.06390532544378698,4.922595453865436
ZCTA5 30511,1313,76,1237,0.057882711348057884,4.922566991791463
ZCTA5 78956,1828,99,1729,0.05415754923413567,4.922557704290416
ZCTA5 97825,138,15,123,0.10869565217391304,4.91540802924309
ZCTA5 76943,1358,78,1280,0.05743740795287187,4.914953481547176
ZCTA5 77375,17002,684,16318,0.04023056111045759,4.913676172759842
ZCTA5 32130,1945,104,1841,0.05347043701799486,4.909127529044063
ZCTA5 85533,1163,69,1094,0.05932932072226999,4.907209066446826
ZCTA5 95355,21291,841,20450,0.0395002583251139,4.9060273470539135
ZCTA5 64835,725,48,677,0.06620689655172414,4.904317269503923
ZCTA5 88250,111,13,98,0.11711711711711711,4.901820274458641
ZCTA5 30833,1229,72,1157,0.05858421480878763,4.899265557225208
ZCTA5 62534,607,42,565,0.06919275123558484,4.89659107066035
ZCTA5 26234,607,42,565,0.06919275123558484,4.89659107066035
ZCTA5 78229,13932,570,13362,0.0409130060292851,4.895942626689524
ZCTA5 46406,3963,188,3775,0.04743880898309362,4.8958035017638695
ZCTA5 30731,952,59,893,0.06197478991596639,4.893722897032445
ZCTA5 76457,1318,76,1242,0.057663125948406675,4.887598119882014
ZCTA5 02136,11955,496,11459,0.04148891677122543,4.885464278685216
ZCTA5 79350,139,15,124,0.1079136690647482,4.881914788169315
ZCTA5 83442,6598,292,6306,0.044255835101545925,4.8792921288988635
ZCTA5 75979,3525,170,3355,0.04822695035460993,4.8775599480512435
ZCTA5 84101,2967,147,2820,0.04954499494438827,4.874141004919575
ZCTA5 76058,6115,273,5842,0.0446443172526574,4.866246449001105
ZCTA5 95492,10056,424,9632,0.042163882259347654,4.85708417997806
ZCTA5 66533,591,41,550,0.06937394247038917,4.856121065014076
ZCTA5 13202,2518,128,2390,0.050833995234312944,4.849918407534821
ZCTA5 74080,1042,63,979,0.060460652591170824,4.848012765412234
ZCTA5 28398,2853,142,2711,0.04977216964598668,4.847064965032508
ZCTA5 87322,32,6,26,0.1875,4.846049648738275
ZCTA5 84651,7154,313,6841,0.04375174727425216,4.843611796373315
ZCTA5 89032,13966,570,13396,0.04081340398109695,4.836454367556853
ZCTA5 29123,3049,150,2899,0.04919645785503444,4.834009724676974
ZCTA5 50315,14183,578,13605,0.04075301417189593,4.833887834921765
ZCTA5 97467,2168,113,2055,0.05212177121771218,4.83369735324386
ZCTA5 87513,216,20,196,0.09259259259259259,4.8334716592757605
ZCTA5 28619,652,44,608,0.06748466257668712,4.8323031090790085
ZCTA5 60064,5134,234,4900,0.045578496299181925,4.831098062875838
ZCTA5 57541,63,9,54,0.14285714285714285,4.829055874869846
ZCTA5 99688,939,58,881,0.0617678381256656,4.824928294957863
ZCTA5 93260,87,11,76,0.12643678160919541,4.823076418076836
ZCTA5 94402,9623,407,9216,0.04229450275381898,4.822620681581969
ZCTA5 39503,19844,786,19058,0.03960894980850635,4.821527827043968
ZCTA5 95912,1506,84,1422,0.055776892430278883,4.817494733078404
ZCTA5 63845,2265,117,2148,0.051655629139072845,4.817276363320798
ZCTA5 85346,2597,131,2466,0.050442818636888716,4.814552511471597
ZCTA5 63551,75,10,65,0.13333333333333333,4.810257547050998
ZCTA5 95960,352,28,324,0.07954545454545454,4.80897526460472
ZCTA5 98355,406,31,375,0.07635467980295567,4.807151549928015
ZCTA5 67470,186,18,168,0.0967741935483871,4.802420042601225
ZCTA5 88220,13528,553,12975,0.04087817859254879,4.801907263059444
ZCTA5 63601,6217,276,5941,0.04439440244490912,4.797080212551794
ZCTA5 46374,353,28,325,0.07932011331444759,4.792256759100432
ZCTA5 84144,202,19,183,0.09405940594059406,4.7901422401205505
ZCTA5 62380,114,13,101,0.11403508771929824,4.784618932933321
ZCTA5 96754,986,60,926,0.060851926977687626,4.784266419341041
ZCTA5 82501,7152,312,6840,0.0436241610738255,4.782930644058206
ZCTA5 36855,578,40,538,0.06920415224913495,4.779714244089744
ZCTA5 84766,88,11,77,0.125,4.7757619766589325
ZCTA5 78059,1924,102,1822,0.05301455301455302,4.771349985192149
ZCTA5 99606,101,12,89,0.1188118811881188,4.770525171104468
ZCTA5 71282,3578,171,3407,0.04779206260480715,4.769427318190138
ZCTA5 45685,427,32,395,0.07494145199063232,4.767505880635024
ZCTA5 27853,219,20,199,0.091324200913242,4.76253657062996
ZCTA5 92653,9970,419,9551,0.04202607823470411,4.759750840475539
ZCTA5 73624,719,47,672,0.06536856745479833,4.758972136133289
ZCTA5 95316,2114,110,2004,0.05203405865657521,4.750692177099452
ZCTA5 70534,286,24,262,0.08391608391608392,4.745797457279594
ZCTA5 65324,660,44,616,0.06666666666666667,4.744993275318012
ZCTA5 67444,236,21,215,0.08898305084745763,4.743921006690097
ZCTA5 95124,17057,682,16375,0.03998358445213109,4.742238916835457
ZCTA5 28147,8974,381,8593,0.04245598395364386,4.7422274972231175
ZCTA5 99836,33,6,27,0.18181818181818182,4.739673801395721
ZCTA5 49680,701,46,655,0.06562054208273894,4.7361251098775154
ZCTA5 67877,824,52,772,0.06310679611650485,4.7335694419648675
ZCTA5 91367,18236,725,17511,0.03975652555384953,4.73287867439288
ZCTA5 27248,1610,88,1522,0.0546583850931677,4.731476213180704
ZCTA5 91344,16820,673,16147,0.04001189060642093,4.729593301842255
ZCTA5 95968,486,35,451,0.0720164609053498,4.727627114231285
ZCTA5 64123,3368,162,3206,0.04809976247030879,4.726653658306124
ZCTA5 53551,3491,167,3324,0.047837295903752505,4.72594820734947
ZCTA5 33756,13356,545,12811,0.040805630428271934,4.724657037010013
ZCTA5 26810,189,18,171,0.09523809523809523,4.723555123551366
ZCTA5 67870,412,31,381,0.07524271844660194,4.717025418567982
ZCTA5 28718,159,16,143,0.10062893081761007,4.710503438959269
ZCTA5 28332,116,13,103,0.11206896551724138,4.70864547552984
ZCTA5 41534,116,13,103,0.11206896551724138,4.70864547552984
ZCTA5 83462,288,24,264,0.08333333333333333,4.707364852181379
ZCTA5 30701,14419,584,13835,0.04050211526458145,4.706394752676595
ZCTA5 84721,6949,303,6646,0.04360339617211109,4.704937279611165
ZCTA5 71854,14073,571,13502,0.04057414907979819,4.6971060806861
ZCTA5 75140,2337,119,2218,0.050919982884039365,4.695472847682044
ZCTA5 30137,645,43,602,0.06666666666666667,4.690762999722689
ZCTA5 75974,1236,71,1165,0.05744336569579288,4.690148929627868
ZCTA5 94116,16247,651,15596,0.04006893580353296,4.688770761834178
ZCTA5 12422,103,12,91,0.11650485436893204,4.687319533077235
ZCTA5 77486,2673,133,2540,0.049756827534605315,4.687258640511588
ZCTA5 04962,54,8,46,0.14814814814814814,4.687058166852
ZCTA5 68307,175,17,158,0.09714285714285714,4.685370373707724
ZCTA5 67645,360,28,332,0.07777777777777778,4.676799195348541
ZCTA5 77954,3802,179,3623,0.04708048395581273,4.672454334073888
ZCTA5 75501,12874,526,12348,0.040857542333385115,4.671376121310682
ZCTA5 40874,207,19,188,0.09178743961352658,4.667282073075823
ZCTA5 28009,568,39,529,0.06866197183098592,4.666327838833955
ZCTA5 96150,11536,476,11060,0.0412621359223301,4.663631923534247
ZCTA5 63653,510,36,474,0.07058823529411765,4.663584004027134
ZCTA5 45883,1262,72,1190,0.05705229793977813,4.661964002217528
ZCTA5 99036,668,44,624,0.0658682634730539,4.658908654934151
ZCTA5 29849,146,15,131,0.10273972602739725,4.655665658598051
ZCTA5 27407,19823,781,19042,0.03939867830298138,4.6543386400855455
ZCTA5 46144,78,10,68,0.1282051282051282,4.653649770374562
ZCTA5 71953,5781,257,5524,0.04445597647465836,4.651847842034507
ZCTA5 45205,6996,304,6692,0.04345340194396798,4.651052520852645
ZCTA5 29377,492,35,457,0.07113821138211382,4.64838676748736
ZCTA5 23690,1309,74,1235,0.05653170359052712,4.643237187664789
ZCTA5 19311,2781,137,2644,0.04926285508809781,4.636147130886946
ZCTA5 73701,8389,357,8032,0.042555727738705446,4.635858660922665
ZCTA5 33155,14518,586,13932,0.040363686458189836,4.629767813407987
ZCTA5 76681,258,22,236,0.08527131782945736,4.628559379606283
ZCTA5 99569,17,4,13,0.23529411764705882,4.628012913657447
ZCTA5 99588,225,20,205,0.08888888888888889,4.624189617105623
ZCTA5 12531,1092,64,1028,0.05860805860805861,4.62251394272179
ZCTA5 79241,878,54,824,0.06150341685649203,4.622004683713164
ZCTA5 47037,1674,90,1584,0.053763440860215055,4.620973830040264
ZCTA5 57623,310,25,285,0.08064516129032258,4.620642454976774
ZCTA5 46767,2688,133,2555,0.049479166666666664,4.620336184734024
ZCTA5 95626,1999,104,1895,0.05202601300650325,4.617667868505886
ZCTA5 97230,15260,613,14647,0.04017038007863696,4.613808396416987
ZCTA5 95549,364,28,336,0.07692307692307693,4.612026200348589
ZCTA5 89451,3770,177,3593,0.04694960212201592,4.608059349666384
ZCTA5 78592,259,22,237,0.08494208494208494,4.6080551162591235
ZCTA5 41819,178,17,161,0.09550561797752809,4.603885492300024
ZCTA5 75422,1095,64,1031,0.058447488584474884,4.5993107465637
ZCTA5 49421,2286,116,2170,0.05074365704286964,4.597072738885831
ZCTA5 39572,496,35,461,0.07056451612903226,4.596190935945751
ZCTA5 62343,347,27,320,0.07780979827089338,4.594897658890213
ZCTA5 87028,92,11,81,0.11956521739130435,4.5932018646859705
ZCTA5 37719,67,9,58,0.13432835820895522,4.591771410977525
ZCTA5 78632,402,30,372,0.07462686567164178,4.590760529662715
ZCTA5 86438,402,30,372,0.07462686567164178,4.590760529662715
ZCTA5 38663,4477,205,4272,0.0457895912441367,4.5899492704885105
ZCTA5 79562,1295,73,1222,0.05637065637065637,4.586110965107592
ZCTA5 28215,20945,820,20125,0.03915015516829792,4.584227152598789
ZCTA5 19601,11283,465,10818,0.0412124434990694,4.58285466646801
ZCTA5 33404,10002,417,9585,0.04169166166766647,4.581391198494536
ZCTA5 42729,595,40,555,0.06722689075630252,4.581278132519218
ZCTA5 63663,278,23,255,0.08273381294964029,4.569328676961551
ZCTA5 77320,9105,383,8722,0.042064799560680946,4.569135378019526
ZCTA5 40009,385,29,356,0.07532467532467532,4.568786788352082
ZCTA5 16861,106,12,94,0.11320754716981132,4.566303044206131
ZCTA5 78238,8974,378,8596,0.0421216848673947,4.566114515765738
ZCTA5 52738,1433,79,1354,0.05512909979064899,4.562914719620316
ZCTA5 74426,4058,188,3870,0.046328240512567766,4.560709133114671
ZCTA5 60194,7476,321,7155,0.04293739967897271,4.559848659247074
ZCTA5 35233,864,53,811,0.061342592592592594,4.55871805981975
ZCTA5 88262,5,2,3,0.4,4.558021176446536
ZCTA5 36006,423,31,392,0.07328605200945626,4.555785757900819
ZCTA5 65664,56,8,48,0.14285714285714285,4.552877541132272
ZCTA5 86032,519,36,483,0.06936416184971098,4.549473850136433
ZCTA5 38751,3911,182,3729,0.04653541293786755,4.549392758951182
ZCTA5 28337,4112,190,3922,0.046206225680933855,4.547442309929007
ZCTA5 32351,6206,272,5934,0.04382855301321302,4.544938268558244
ZCTA5 12489,135,14,121,0.1037037037037037,4.539133823131529
ZCTA5 10162,741,47,694,0.06342780026990553,4.537435321212992
ZCTA5 10566,9598,401,9197,0.041779537403625756,4.53578843114739
ZCTA5 95468,599,40,559,0.0667779632721202,4.535549968326416
ZCTA5 19964,369,28,341,0.07588075880758807,4.532247655933822
ZCTA5 55101,4596,209,4387,0.04547432550043516,4.531691908912884
ZCTA5 40312,2134,109,2025,0.05107778819119025,4.5274480405942885
ZCTA5 37691,263,22,241,0.08365019011406843,4.526990880734319
ZCTA5 36525,701,45,656,0.06419400855920114,4.52608408036511
ZCTA5 74339,868,53,815,0.06105990783410138,4.522943064175534
ZCTA5 40820,298,24,274,0.08053691275167785,4.519936168189736
ZCTA5 11364,13554,548,13006,0.04043086911612808,4.516915248724711
ZCTA5 53221,15839,632,15207,0.0399015089336448,4.512343814969444
ZCTA5 37862,8655,365,8290,0.042172154823801274,4.510335407952793
ZCTA5 12421,151,15,136,0.09933774834437085,4.5022362137661025
ZCTA5 76690,371,28,343,0.07547169811320754,4.500697054778441
ZCTA5 87105,19931,781,19150,0.0391851889017109,4.499388763815191
ZCTA5 60714,11004,453,10551,0.04116684841875681,4.4992403483121235
ZCTA5 40504,11514,472,11042,0.04099357304151468,4.49892392397136
ZCTA5 08031,4379,200,4179,0.04567252797442339,4.496355534849426
ZCTA5 47108,808,50,758,0.06188118811881188,4.493646673347293
ZCTA5 10591,8742,368,8374,0.04209563029055136,4.493158086367763
ZCTA5 81122,3578,168,3410,0.046953605366126326,4.490517223003927
ZCTA5 78588,57,8,49,0.14035087719298245,4.488121240774061
ZCTA5 83520,108,12,96,0.1111111111111111,4.488020800362481
ZCTA5 37160,12031,491,11540,0.04081123763610672,4.487599336764757
ZCTA5 58366,466,33,433,0.07081545064377683,4.485149643276622
ZCTA5 28655,21186,826,20360,0.038988010950627774,4.479278612940978
ZCTA5 01510,5533,245,5288,0.044279775890113865,4.478086841775469
ZCTA5 76112,16491,655,15836,0.03971863440664605,4.473681771104118
ZCTA5 54612,1862,97,1765,0.05209452201933405,4.473065384774076
ZCTA5 12418,152,15,137,0.09868421052631579,4.472311668984992
ZCTA5 78382,8144,345,7799,0.042362475442043225,4.47067665857291
ZCTA5 03103,13987,563,13424,0.04025166225781082,4.470633689528661
ZCTA5 98605,429,31,398,0.07226107226107226,4.46992135558081
ZCTA5 30360,5202,232,4970,0.04459823144944252,4.469806543749377
ZCTA5 89820,1933,100,1833,0.05173305742369374,4.469170743431215
ZCTA5 77521,19650,770,18880,0.03918575063613232,4.467996443484911
ZCTA5 11693,4845,218,4627,0.04499484004127967,4.467227562309681
ZCTA5 95304,3734,174,3560,0.04659882163899304,4.466802630537291
ZCTA5 42166,960,57,903,0.059375,4.4662840283524625
ZCTA5 46507,3361,159,3202,0.04730734900327284,4.466263704728562
ZCTA5 31539,5101,228,4873,0.04469711821211527,4.465477999707976
ZCTA5 70753,355,27,328,0.07605633802816901,4.463835850679364
ZCTA5 78962,2076,106,1970,0.051059730250481696,4.460922870444454
ZCTA5 80727,216,19,197,0.08796296296296297,4.4550846030734075
ZCTA5 56057,1564,84,1480,0.05370843989769821,4.454473842796031
ZCTA5 80103,940,56,884,0.059574468085106386,4.4535248867672665
ZCTA5 71943,1749,92,1657,0.052601486563750716,4.453117655671179
ZCTA5 12543,1382,76,1306,0.05499276410998553,4.452797251889227
ZCTA5 39354,1005,59,946,0.05870646766169154,4.4519032074036575
ZCTA5 39209,9744,405,9339,0.04156403940886699,4.451858955356711
ZCTA5 48091,11755,480,11275,0.040833687792428755,4.449362377843207
ZCTA5 95638,750,47,703,0.06266666666666666,4.448988417780134
ZCTA5 46556,233,20,213,0.08583690987124463,4.446606108984763
ZCTA5 72579,547,37,510,0.06764168190127971,4.446551199105142
ZCTA5 64622,184,17,167,0.09239130434782608,4.445908186667294
ZCTA5 89025,338,26,312,0.07692307692307693,4.444259650260932
ZCTA5 77590,11086,455,10631,0.041042756629983766,4.443313328937408
ZCTA5 95075,153,15,138,0.09803921568627451,4.442631588350328
ZCTA5 99155,431,31,400,0.07192575406032482,4.441615451498746
ZCTA5 31566,1384,76,1308,0.05491329479768786,4.439576990618678
ZCTA5 22802,11224,460,10764,0.040983606557377046,4.43603411736169
ZCTA5 08640,878,53,825,0.06036446469248292,4.434325593572597
ZCTA5 65034,303,24,279,0.07920792079207921,4.429048241834689
ZCTA5 95458,1206,68,1138,0.05638474295190713,4.428434287050015
ZCTA5 75937,339,26,313,0.07669616519174041,4.4275953594380875
ZCTA5 08520,9276,387,8889,0.041720569210866754,4.427470979963634
ZCTA5 63623,321,25,296,0.0778816199376947,4.426559171500425
ZCTA5 38869,169,16,153,0.09467455621301775,4.425904123241916
ZCTA5 97905,70,9,61,0.12857142857142856,4.425589517250744
ZCTA5 89447,3224,153,3071,0.04745657568238213,4.421410708328375
ZCTA5 56434,96,11,85,0.11458333333333333,4.420540117491292
ZCTA5 99777,96,11,85,0.11458333333333333,4.420540117491292
ZCTA5 54436,816,50,766,0.061274509803921566,4.419462144032753
ZCTA5 25969,471,33,438,0.07006369426751592,4.418417444570239
ZCTA5 50101,11,3,8,0.2727272727272727,4.413196114055053
ZCTA5 99784,83,10,73,0.12048192771084337,4.40919789562261
ZCTA5 83311,269,22,247,0.08178438661710037,4.4081596597625206
ZCTA5 71024,713,45,668,0.06311360448807854,4.404226203127727
ZCTA5 78644,6000,262,5738,0.043666666666666666,4.399135365008007
ZCTA5 95404,16294,646,15648,0.039646495642567815,4.395671459323204
ZCTA5 83429,323,25,298,0.07739938080495357,4.392129902153033
ZCTA5 33615,17479,689,16790,0.039418731048687,4.38524789458573
ZCTA5 66101,4667,210,4457,0.04499678594386115,4.385138430530135
ZCTA5 99540,155,15,140,0.0967741935483871,4.383989646579353
ZCTA5 84512,236,20,216,0.0847457627118644,4.381922194249866
ZCTA5 52583,140,14,126,0.1,4.378723212571678
ZCTA5 59213,203,18,185,0.08866995073891626,4.374956704305933
ZCTA5 75656,1554,83,1471,0.05341055341055341,4.374906410288294
ZCTA5 38240,993,58,935,0.05840886203423968,4.373091910889514
ZCTA5 53715,5106,227,4879,0.04445750097924011,4.372447436149736
ZCTA5 63363,737,46,691,0.06241519674355495,4.372297010545098
ZCTA5 88346,950,56,894,0.05894736842105263,4.36966279914618
ZCTA5 24087,1532,82,1450,0.05352480417754569,4.368696836786204
ZCTA5 92596,7927,335,7592,0.04226062823262268,4.36028566192258
ZCTA5 74601,7348,313,7035,0.04259662493195427,4.358196221248185
ZCTA5 37201,437,31,406,0.07093821510297482,4.3576204278677855
ZCTA5 76520,2944,141,2803,0.04789402173913043,4.357048534336264
ZCTA5 99166,1374,75,1299,0.05458515283842795,4.355866692551673
ZCTA5 39113,156,15,141,0.09615384615384616,4.355020408336535
ZCTA5 04056,126,13,113,0.10317460317460317,4.352191558785845
ZCTA5 70460,8011,338,7673,0.04219198601922357,4.349160802725611
ZCTA5 71301,8303,349,7954,0.042033000120438396,4.3471509123703616
ZCTA5 81123,344,26,318,0.0755813953488372,4.345146327825969
ZCTA5 02839,803,49,754,0.06102117061021171,4.344193742326431
ZCTA5 95694,3594,167,3427,0.046466332776850305,4.338094643641264
ZCTA5 93620,2826,136,2690,0.048124557678697805,4.336990467571429
ZCTA5 97041,804,49,755,0.060945273631840796,4.334930041343614
ZCTA5 84634,401,29,372,0.07231920199501247,4.328062029886213
ZCTA5 65764,478,33,445,0.06903765690376569,4.326379682660928
ZCTA5 85173,1198,67,1131,0.055926544240400666,4.325526544571679
ZCTA5 45779,291,23,268,0.07903780068728522,4.324319748948261
ZCTA5 12130,256,21,235,0.08203125,4.32228924304102
ZCTA5 79902,8050,339,7711,0.04211180124223603,4.319725903829291
ZCTA5 31788,3574,166,3408,0.046446558477895916,4.319433245267758
ZCTA5 33936,8130,342,7788,0.04206642066420664,4.318382231805542
ZCTA5 98560,85,10,75,0.11764705882352941,4.316657705251901
ZCTA5 38722,142,14,128,0.09859154929577464,4.316552941655648
ZCTA5 26817,142,14,128,0.09859154929577464,4.316552941655648
ZCTA5 39819,4129,188,3941,0.04553160571566965,4.3157618320484765
ZCTA5 76656,722,45,677,0.062326869806094184,4.314375568385277
ZCTA5 58630,274,22,252,0.08029197080291971,4.311557558017754
ZCTA5 70041,1133,64,1069,0.05648720211827008,4.311493336460702
ZCTA5 76015,6267,271,5996,0.043242380724429555,4.309161632081614
ZCTA5 81151,599,39,560,0.0651085141903172,4.308328304256053
ZCTA5 33565,6085,264,5821,0.04338537387017256,4.308160413429545
ZCTA5 07008,7950,335,7615,0.04213836477987421,4.305982882498042
ZCTA5 01604,14575,581,13994,0.039862778730703256,4.302548837711985
ZCTA5 96050,223,19,204,0.08520179372197309,4.29739549688956
ZCTA5 58467,240,20,220,0.08333333333333333,4.297216526577856
ZCTA5 92821,13516,542,12974,0.040100621485646644,4.2970647005842
ZCTA5 80750,99,11,88,0.1111111111111111,4.296952774441336
ZCTA5 95257,190,17,173,0.08947368421052632,4.294164437692894
ZCTA5 29070,5961,259,5702,0.043449085723871836,4.29139407052762
ZCTA5 94521,16088,636,15452,0.039532570860268526,4.2874379145009
ZCTA5 92059,481,33,448,0.06860706860706861,4.287418194599968
ZCTA5 21061,20966,813,20153,0.038777067633311076,4.28610274785763
ZCTA5 95616,17381,683,16698,0.03929578275128014,4.282796028399269
ZCTA5 36318,581,38,543,0.06540447504302926,4.2827738649078535
ZCTA5 17563,1204,67,1137,0.05564784053156146,4.282565090906661
ZCTA5 05061,462,32,430,0.06926406926406926,4.280418890389314
ZCTA5 34705,896,53,843,0.05915178571428571,4.277683429395923
ZCTA5 79758,768,47,721,0.061197916666666664,4.275703933708676
ZCTA5 75951,5448,239,5209,0.043869309838472835,4.27507258899278
ZCTA5 64432,28,5,23,0.17857142857142858,4.27032560962428
ZCTA5 28077,191,17,174,0.08900523560209424,4.269446783971518
ZCTA5 73047,1433,77,1356,0.05373342637822749,4.269102368981961
ZCTA5 88012,9992,411,9581,0.041132906325060045,4.268493524310873
ZCTA5 93283,1028,59,969,0.057392996108949414,4.268360724581303
ZCTA5 66776,542,36,506,0.06642066420664207,4.268099252073397
ZCTA5 78052,2090,105,1985,0.050239234449760764,4.267340036839288
ZCTA5 81637,2500,122,2378,0.0488,4.266986695704514
ZCTA5 63878,38,6,32,0.15789473684210525,4.265958727202652
ZCTA5 78839,2672,129,2543,0.048278443113772454,4.261401526080047
ZCTA5 76432,503,34,469,0.06759443339960239,4.258071972452544
ZCTA5 23126,100,11,89,0.11,4.256809681165225
ZCTA5 98674,4554,204,4350,0.04479578392621871,4.256292653901842
ZCTA5 51231,144,14,130,0.09722222222222222,4.2554648214662505
ZCTA5 76055,1008,58,950,0.057539682539682536,4.252534788065477
ZCTA5 28205,19859,772,19087,0.038874062138073415,4.247428926561331
ZCTA5 73145,504,34,470,0.06746031746031746,4.2455585623290775
ZCTA5 78072,160,15,145,0.09375,4.24140598500302
ZCTA5 20037,6320,272,6048,0.043037974683544304,4.236976398773639
ZCTA5 85347,209,18,191,0.0861244019138756,4.234487611927203
ZCTA5 15948,209,18,191,0.0861244019138756,4.234487611927203
ZCTA5 77455,794,48,746,0.060453400503778336,4.230809869122544
ZCTA5 28560,11575,469,11106,0.040518358531317494,4.226501719868609
ZCTA5 78650,506,34,472,0.06719367588932806,4.220618540699095
ZCTA5 15922,74,9,65,0.12162162162162163,4.217808954347918
ZCTA5 73438,1373,74,1299,0.053896576839038604,4.212391787061928
ZCTA5 98682,19829,770,19059,0.038832013717282766,4.2112916845604
ZCTA5 28756,1745,90,1655,0.05157593123209169,4.209779657636897
ZCTA5 78659,970,56,914,0.0577319587628866,4.204910179374484
ZCTA5 32433,6306,271,6035,0.04297494449730416,4.204446103931219
ZCTA5 37357,2007,101,1906,0.050323866467364226,4.202832279897667
ZCTA5 25405,4648,207,4441,0.04453528399311532,4.201230595356718
ZCTA5 99921,776,47,729,0.06056701030927835,4.200178553070742
ZCTA5 96725,1059,60,999,0.056657223796033995,4.1990861903765415
ZCTA5 12508,7123,302,6821,0.04239786606766812,4.197665215239379
ZCTA5 73149,1913,97,1816,0.05070569785676947,4.196103563957673
ZCTA5 10028,25318,967,24351,0.03819417015562051,4.194198016224969
ZCTA5 80759,1985,100,1885,0.05037783375314862,4.1931051618108786
ZCTA5 68945,116,12,104,0.10344827586206896,4.192307398889188
ZCTA5 25401,5946,257,5689,0.04322233434241507,4.188755676898029
ZCTA5 82644,756,46,710,0.06084656084656084,4.188444129762913
ZCTA5 32180,1240,68,1172,0.054838709677419356,4.187668396292809
ZCTA5 97840,39,6,33,0.15384615384615385,4.1811209944837175
ZCTA5 39111,3086,145,2941,0.046986390149060274,4.180494111082996
ZCTA5 76155,2888,137,2751,0.047437673130193904,4.179027809997519
ZCTA5 10560,1727,89,1638,0.05153445280833816,4.178425174125638
ZCTA5 45433,570,37,533,0.06491228070175438,4.176688783807648
ZCTA5 95546,1219,67,1152,0.054963084495488104,4.176205788489319
ZCTA5 94588,12551,504,12047,0.040156162855549356,4.175429262649547
ZCTA5 99901,5327,233,5094,0.04373944058569551,4.174619204883873
ZCTA5 28698,930,54,876,0.05806451612903226,4.1736972490416555
ZCTA5 95010,4095,185,3910,0.045177045177045176,4.171779074281544
ZCTA5 55780,75,9,66,0.12,4.16811341900164
ZCTA5 06120,4479,200,4279,0.044652824291136414,4.167891829970625
ZCTA5 01103,1449,77,1372,0.05314009661835749,4.167268193663779
ZCTA5 25024,147,14,133,0.09523809523809523,4.165784053673963
ZCTA5 54410,866,51,815,0.05889145496535797,4.162857012188299
ZCTA5 94803,9400,387,9013,0.04117021276595745,4.1602289694347645
ZCTA5 35962,3141,147,2994,0.04680038204393505,4.159609428646353
ZCTA5 18828,117,12,105,0.10256410256410256,4.157153383999072
ZCTA5 98923,375,27,348,0.072,4.1510244248022286
ZCTA5 70652,846,50,796,0.0591016548463357,4.1485064248194075
ZCTA5 65050,196,17,179,0.08673469387755102,4.148193651713608
ZCTA5 75416,1133,63,1070,0.05560458958517211,4.146278824295108
ZCTA5 78161,301,23,278,0.07641196013289037,4.14464678303416
ZCTA5 95941,283,22,261,0.07773851590106007,4.142913075059303
ZCTA5 63383,6015,259,5756,0.043059019118869495,4.1425515561193125
ZCTA5 95555,148,14,134,0.0945945945945946,4.136393926046812
ZCTA5 41735,63,8,55,0.12698412698412698,4.128419190618037
ZCTA5 85551,118,12,106,0.1016949152542373,4.122374158417773
ZCTA5 80701,5892,254,5638,0.04310930074677529,4.121441182087859
ZCTA5 94929,76,9,67,0.11842105263157894,4.119260168657295
ZCTA5 43755,721,44,677,0.06102635228848821,4.117187739826646
ZCTA5 19950,2533,122,2411,0.048164232135807346,4.117114134361902
ZCTA5 80214,11905,479,11426,0.04023519529609408,4.11451006949316
ZCTA5 77456,596,38,558,0.06375838926174497,4.11422690162213
ZCTA5 64722,181,16,165,0.08839779005524862,4.110731185836373
ZCTA5 66026,181,16,165,0.08839779005524862,4.110731185836373
ZCTA5 13468,181,16,165,0.08839779005524862,4.110731185836373
ZCTA5 33073,11338,458,10880,0.04039513141647557,4.11003990797438
ZCTA5 63952,149,14,135,0.09395973154362416,4.107248766454293
ZCTA5 64831,2170,107,2063,0.04930875576036867,4.107198948115343
ZCTA5 29657,6030,259,5771,0.04295190713101161,4.101458488606413
ZCTA5 97368,1506,79,1427,0.05245683930942895,4.100987356839666
ZCTA5 38565,456,31,425,0.06798245614035088,4.100337382162225
ZCTA5 70374,2586,124,2462,0.04795050270688322,4.099521592931889
ZCTA5 29320,215,18,197,0.08372093023255814,4.098855299853339
ZCTA5 38744,341,25,316,0.07331378299120235,4.093290333796347
ZCTA5 10588,1163,64,1099,0.055030094582975066,4.091860533220346
ZCTA5 12430,537,35,502,0.06517690875232775,4.088084635981027
ZCTA5 70665,3942,178,3764,0.04515474378488077,4.0853161567273935
ZCTA5 28315,4891,215,4676,0.04395829073809037,4.085247782641682
ZCTA5 98852,6,2,4,0.3333333333333333,4.084933096966355
ZCTA5 17518,477,32,445,0.06708595387840671,4.0848039334322666
ZCTA5 77708,4867,214,4653,0.043969591123895625,4.079596525422324
ZCTA5 43536,64,8,56,0.125,4.072783498270281
ZCTA5 77058,8210,341,7869,0.0415347137637028,4.071655708453757
ZCTA5 28425,3946,178,3768,0.0451089711099848,4.071398361391411
ZCTA5 36260,1581,82,1499,0.05186590765338393,4.071195788250817
ZCTA5 75453,1122,62,1060,0.05525846702317291,4.0616274421965
ZCTA5 76670,499,33,466,0.06613226452905811,4.059467700494232
ZCTA5 50220,3468,159,3309,0.045847750865051905,4.058791253744531
ZCTA5 11727,11121,449,10672,0.04037406708029853,4.058165203998411
ZCTA5 71659,30,5,25,0.16666666666666666,4.057593011508538
ZCTA5 78643,2253,110,2143,0.048823790501553485,4.05699661370267
ZCTA5 84648,2060,102,1958,0.04951456310679612,4.05369232711818
ZCTA5 45776,288,22,266,0.0763888888888889,4.0519792459124835
ZCTA5 60712,4260,190,4070,0.04460093896713615,4.045887988391445
ZCTA5 98363,5658,244,5414,0.0431247790738777,4.045245495264191
ZCTA5 76559,2062,102,1960,0.049466537342386034,4.043531868865541
ZCTA5 83111,235,19,216,0.08085106382978724,4.040603468611598
ZCTA5 29437,1035,58,977,0.05603864734299517,4.040562610051807
ZCTA5 47471,1035,58,977,0.05603864734299517,4.040562610051807
ZCTA5 80734,1125,62,1063,0.05511111111111111,4.039568089736774
ZCTA5 46320,4906,215,4691,0.043823889115368934,4.039155645890055
ZCTA5 37339,837,49,788,0.05854241338112306,4.0364051979938775
ZCTA5 38460,461,31,430,0.06724511930585683,4.034716115077549
ZCTA5 85745,16110,631,15479,0.03916821849782744,4.033191177515691
ZCTA5 77485,1494,78,1416,0.05220883534136546,4.031307509209221
ZCTA5 76148,7775,324,7451,0.04167202572347267,4.029653138806863
ZCTA5 04061,1104,61,1043,0.0552536231884058,4.028020787326636
ZCTA5 57652,106,11,95,0.10377358490566038,4.026158225320437
ZCTA5 76273,3579,163,3416,0.0455434478904722,4.021994815890784
ZCTA5 61910,1449,76,1373,0.05244996549344375,4.0211753459801205
ZCTA5 56681,121,12,109,0.09917355371900827,4.02021046983257
ZCTA5 94596,9736,397,9339,0.04077649958915366,4.017889574959399
ZCTA5 75835,4526,200,4326,0.04418912947414936,4.016221170617207
ZCTA5 49340,1061,59,1002,0.05560791705937795,4.012975206308599
ZCTA5 65650,544,35,509,0.06433823529411764,4.005861624282867
ZCTA5 97489,385,27,358,0.07012987012987013,4.001943800960955
ZCTA5 46517,9125,374,8751,0.04098630136986301,4.001224271458116
ZCTA5 29040,3788,171,3617,0.04514255543822598,4.000550054181521
ZCTA5 20658,328,24,304,0.07317073170731707,4.000099973720431
ZCTA5 57536,137,13,124,0.0948905109489051,3.9989706053047844
ZCTA5 45872,1476,77,1399,0.0521680216802168,3.9982290251242523
ZCTA5 00623,13523,536,12987,0.03963617540486578,3.9978222170629603
ZCTA5 52595,153,14,139,0.0915032679738562,3.993040771558803
ZCTA5 70112,1477,77,1400,0.052132701421800945,3.992034420753135
ZCTA5 30114,18846,729,18117,0.03868194842406877,3.991014637260422
ZCTA5 43802,310,23,287,0.07419354838709677,3.988940390769181
ZCTA5 95503,9863,401,9462,0.04065700091250127,3.978012093765447
ZCTA5 47925,79,9,70,0.11392405063291139,3.9774948113709163
ZCTA5 85716,14825,583,14242,0.03932546374367622,3.9754696073732005
ZCTA5 79045,6156,262,5894,0.04256010396361273,3.9731335630136413
ZCTA5 35771,1387,73,1314,0.05263157894736842,3.9718195600548136
ZCTA5 84759,651,40,611,0.06144393241167435,3.971473073231035
ZCTA5 97040,547,35,512,0.06398537477148081,3.970997592424248
ZCTA5 08863,4388,194,4194,0.04421148587055606,3.962754559150543
ZCTA5 48201,8338,344,7994,0.04125689613816263,3.9621967758179735
ZCTA5 47443,427,29,398,0.06791569086651054,3.9601398654718434
ZCTA5 95139,2249,109,2140,0.048465984882169855,3.9590298810964843
ZCTA5 05661,2470,118,2352,0.04777327935222672,3.957539178367581
ZCTA5 38622,257,20,237,0.07782101167315175,3.9553730128103384
ZCTA5 27217,14179,559,13620,0.039424501022639113,3.9534712726950696
ZCTA5 99714,468,31,437,0.06623931623931624,3.9442292356919926
ZCTA5 56464,1745,88,1657,0.0504297994269341,3.9435260951882256
ZCTA5 63770,42,6,36,0.14285714285714285,3.9429076109401784
ZCTA5 60076,10692,431,10261,0.04031051253273475,3.9425762572596588
ZCTA5 12446,1865,93,1772,0.04986595174262735,3.941451603218169
ZCTA5 71667,2796,131,2665,0.046852646638054364,3.9398944035908317
ZCTA5 92595,9504,387,9117,0.04071969696969697,3.938934300972499
ZCTA5 55421,11455,459,10996,0.04006983849847228,3.9375784555454967
ZCTA5 24565,409,28,381,0.06845965770171149,3.9369504560257464
ZCTA5 73560,258,20,238,0.07751937984496124,3.9361175583676213
ZCTA5 44046,827,48,779,0.05804111245465538,3.932049941254924
ZCTA5 88340,982,55,927,0.0560081466395112,3.930433832569583
ZCTA5 02802,223,18,205,0.08071748878923767,3.9249946021422306
ZCTA5 77498,15216,596,14620,0.03916929547844374,3.920424883848574
ZCTA5 95466,333,24,309,0.07207207207207207,3.9189800132068475
ZCTA5 17572,1513,78,1435,0.051553205551883675,3.9150394297354003
ZCTA5 00925,3355,153,3202,0.04560357675111774,3.913466721584656
ZCTA5 72901,8870,363,8507,0.04092446448703495,3.9125334766573205
ZCTA5 78624,8978,367,8611,0.040877701047003785,3.9116396057196754
ZCTA5 27701,9464,385,9079,0.040680473372781065,3.909416433186117
ZCTA5 28649,372,26,346,0.06989247311827956,3.9083353048834044
ZCTA5 33326,10847,436,10411,0.04019544574536738,3.904405781362276
ZCTA5 73063,224,18,206,0.08035714285714286,3.9037931011481635
ZCTA5 92313,4407,194,4213,0.04402087587928296,3.9009558070233434
ZCTA5 75446,1190,64,1126,0.05378151260504202,3.899559395740375
ZCTA5 23607,8689,356,8333,0.04097134307745425,3.896709327985988
ZCTA5 78351,125,12,113,0.096,3.8888031773523073
ZCTA5 56116,316,23,293,0.07278481012658228,3.8880946372548832
ZCTA5 41539,575,36,539,0.06260869565217392,3.8877816659446527
ZCTA5 11379,13504,533,12971,0.03946978672985782,3.8874855848259475
ZCTA5 12028,335,24,311,0.07164179104477612,3.886934771246815
ZCTA5 25061,279,21,258,0.07526881720430108,3.8841219919181085
ZCTA5 84662,493,32,461,0.06490872210953347,3.883908740711527
ZCTA5 05076,157,14,143,0.08917197452229299,3.8824542817034153
ZCTA5 22193,23469,892,22577,0.03800758447313477,3.8791810984471353
ZCTA5 64401,555,35,520,0.06306306306306306,3.8790970606726973
ZCTA5 36740,433,29,404,0.06697459584295612,3.878962621299313
ZCTA5 64701,5429,233,5196,0.04291766439491619,3.8776709739473416
ZCTA5 47016,317,23,294,0.07255520504731862,3.8715079093167715
ZCTA5 78413,15026,588,14438,0.039132170903766805,3.8705637729138966
ZCTA5 42642,4910,213,4697,0.04338085539714868,3.868162228576044
ZCTA5 54670,556,35,521,0.06294964028776978,3.8677170934113176
ZCTA5 32330,280,21,259,0.075,3.866061631867615
ZCTA5 07094,7285,303,6982,0.04159231297185999,3.8627713894465585
ZCTA5 11238,24547,930,23617,0.03788650344237585,3.8617753683344325
ZCTA5 75929,705,42,663,0.059574468085106386,3.8568656883266685
ZCTA5 76936,1105,60,1045,0.05429864253393665,3.8533063916711923
ZCTA5 28772,435,29,406,0.06666666666666667,3.852194989110345
ZCTA5 88038,142,13,129,0.09154929577464789,3.8498731717171375
ZCTA5 95988,3220,147,3073,0.04565217391304348,3.8492580462353656
ZCTA5 97031,7264,302,6962,0.04157488986784141,3.8489418577009737
ZCTA5 75142,5781,246,5535,0.0425531914893617,3.8472954178144443
ZCTA5 98845,111,11,100,0.0990990990990991,3.8461418309046804
ZCTA5 84021,1337,70,1267,0.05235602094240838,3.843539615977999
ZCTA5 95391,4399,193,4206,0.04387360763809957,3.8430948255719355
ZCTA5 92866,5468,234,5234,0.042794440380395024,3.8409014035676385
ZCTA5 95937,517,33,484,0.06382978723404255,3.840894655433735
ZCTA5 98304,338,24,314,0.07100591715976332,3.8392883213973352
ZCTA5 86441,1199,64,1135,0.05337781484570475,3.8365406192274194
ZCTA5 49905,601,37,564,0.06156405990016639,3.83228943513475
ZCTA5 07022,5393,231,5162,0.042833302429074724,3.830340222592772
ZCTA5 78057,282,21,261,0.07446808510638298,3.8301703442369868
ZCTA5 83651,11457,457,11000,0.039888277908702106,3.829848441829856
ZCTA5 13613,1040,57,983,0.05480769230769231,3.8295498404439154
ZCTA5 17527,1886,93,1793,0.049310710498409335,3.829483999067007
ZCTA5 06757,883,50,833,0.056625141562853906,3.8290078437729798
ZCTA5 38568,861,49,812,0.056910569105691054,3.827582817227045
ZCTA5 01040,15275,596,14679,0.03901800327332242,3.824033341296534
ZCTA5 38629,730,43,687,0.0589041095890411,3.8239304001618946
ZCTA5 87418,378,26,352,0.06878306878306878,3.8197784325225554
ZCTA5 63434,246,19,227,0.07723577235772358,3.818752975021821
ZCTA5 12419,246,19,227,0.07723577235772358,3.818752975021821
ZCTA5 04922,478,31,447,0.06485355648535565,3.8176592344090166
ZCTA5 85339,12695,502,12193,0.03954312721543915,3.81519519615915
ZCTA5 38725,283,21,262,0.07420494699646643,3.812338133730794
ZCTA5 80928,438,29,409,0.06621004566210045,3.812311370104787
ZCTA5 63556,1319,69,1250,0.052312357846853674,3.808760592817341
ZCTA5 63013,667,40,627,0.05997001499250375,3.8082919621521674
ZCTA5 73625,302,22,280,0.0728476821192053,3.807066350868752
ZCTA5 76641,646,39,607,0.06037151702786378,3.8046120548296076
ZCTA5 32340,3896,173,3723,0.04440451745379877,3.800995660783447
ZCTA5 32347,2880,133,2747,0.04618055555555556,3.798059461289786
ZCTA5 99776,44,6,38,0.13636363636363635,3.796159721265455
ZCTA5 28364,5117,220,4897,0.04299394176275161,3.7949427427111435
ZCTA5 80428,284,21,263,0.07394366197183098,3.794580703028204
ZCTA5 83536,1797,89,1708,0.04952698942682248,3.789021828989843
ZCTA5 32824,13039,514,12525,0.03942020093565458,3.788480136715161
ZCTA5 81225,584,36,548,0.06164383561643835,3.7884213258209942
ZCTA5 41465,4572,199,4373,0.04352580927384077,3.78715429304906
ZCTA5 79903,6067,256,5811,0.04219548376462832,3.7863687891968447
ZCTA5 78390,1895,93,1802,0.04907651715039578,3.7819156011259323
ZCTA5 45204,2534,119,2415,0.04696132596685083,3.781184037834312
ZCTA5 02210,1945,95,1850,0.04884318766066838,3.774258213165467
ZCTA5 98934,502,32,470,0.06374501992031872,3.774203624677112
ZCTA5 40801,195,16,179,0.08205128205128205,3.7738984114736547
ZCTA5 30810,714,42,672,0.058823529411764705,3.7698181061955798
ZCTA5 37807,3700,165,3535,0.0445945945945946,3.7684491488451246
ZCTA5 83619,2913,134,2779,0.046000686577411604,3.7657701415633467
ZCTA5 33140,9181,372,8809,0.04051846204117199,3.7641932148424164
ZCTA5 96785,1467,75,1392,0.05112474437627812,3.7638033139341496
ZCTA5 74015,3497,157,3340,0.044895624821275376,3.762609965890562
ZCTA5 20866,4945,213,4732,0.04307381193124368,3.7618512562838076
ZCTA5 64672,70,8,62,0.11428571428571428,3.760907196899562
ZCTA5 23915,249,19,230,0.07630522088353414,3.760308649630683
ZCTA5 64644,1211,64,1147,0.05284888521882741,3.753330855053696
ZCTA5 44618,2318,110,2208,0.04745470232959448,3.748538281715882
ZCTA5 65011,760,44,716,0.05789473684210526,3.7469664764251256
ZCTA5 72740,3578,160,3418,0.044717719396310786,3.7467569691740317
ZCTA5 74851,3272,148,3124,0.04523227383863081,3.746642435085384
ZCTA5 96024,443,29,414,0.0654627539503386,3.746540186024729
ZCTA5 86431,250,19,231,0.076,3.74101407430062
ZCTA5 99925,325,23,302,0.07076923076923076,3.741003008590829
ZCTA5 95065,3199,145,3054,0.045326664582682086,3.7343012047096686
ZCTA5 73559,197,16,181,0.08121827411167512,3.728182599763272
ZCTA5 94530,10202,409,9793,0.04009017839639287,3.7274132145671928
ZCTA5 52573,45,6,39,0.13333333333333333,3.7260094741394116
ZCTA5 81241,45,6,39,0.13333333333333333,3.7260094741394116
ZCTA5 28112,9173,371,8802,0.04044478360405538,3.7233101314304524
ZCTA5 85741,14150,553,13597,0.039081272084805656,3.722374264619949
ZCTA5 77446,719,42,677,0.0584144645340751,3.721996132942601
ZCTA5 22580,2053,99,1954,0.04822211397954213,3.7211341300327176
ZCTA5 99760,215,17,198,0.07906976744186046,3.719589294600964
ZCTA5 68810,385,26,359,0.06753246753246753,3.7185223072653915
ZCTA5 99757,7,2,5,0.2857142857142857,3.7115953443787113
ZCTA5 99774,7,2,5,0.2857142857142857,3.7115953443787113
ZCTA5 99324,3742,166,3576,0.04436130411544629,3.7104153895033787
ZCTA5 16123,786,45,741,0.05725190839694656,3.710296855749029
ZCTA5 61866,5514,234,5280,0.042437431991294884,3.7095972225927
ZCTA5 32773,11056,440,10616,0.03979739507959479,3.709085557846589
ZCTA5 95233,198,16,182,0.08080808080808081,3.705534546135064
ZCTA5 27536,6336,265,6071,0.04182449494949495,3.7051767718528863
ZCTA5 36830,15294,594,14700,0.03883876029815614,3.7031384929534013
ZCTA5 79556,4651,201,4450,0.04321651257794023,3.7024297819690672
ZCTA5 37313,508,32,476,0.06299212598425197,3.7023227503436567
ZCTA5 08821,131,12,119,0.0916030534351145,3.7011746791471745
ZCTA5 98056,13887,543,13344,0.03910131777921797,3.7007556882167227
ZCTA5 85926,100,10,90,0.1,3.7006965533834726
ZCTA5 39772,635,38,597,0.05984251968503937,3.6979491461109357
ZCTA5 49948,234,18,216,0.07692307692307693,3.6978475501134103
ZCTA5 79233,58,7,51,0.1206896551724138,3.6946213013279308
ZCTA5 15562,58,7,51,0.1206896551724138,3.6946213013279308
ZCTA5 28684,967,53,914,0.05480868665977249,3.692874226743514
ZCTA5 74441,1912,93,1819,0.04864016736401674,3.692734994865716
ZCTA5 95551,572,35,537,0.06118881118881119,3.688777589871526
ZCTA5 38676,2183,104,2079,0.04764086120018323,3.6861134832442595
ZCTA5 30808,1456,74,1382,0.050824175824175824,3.6858852868188894
ZCTA5 31714,2258,107,2151,0.04738706820194863,3.681833175847945
ZCTA5 84520,448,29,419,0.06473214285714286,3.6816258521812557
ZCTA5 40870,148,13,135,0.08783783783783784,3.679271750874138
ZCTA5 04488,552,34,518,0.06159420289855073,3.676681944242599
ZCTA5 75154,12580,495,12085,0.03934817170111288,3.6762740421691844
ZCTA5 05904,116,11,105,0.09482758620689655,3.675969322248535
ZCTA5 22433,116,11,105,0.09482758620689655,3.675969322248535
ZCTA5 50276,902,50,852,0.05543237250554324,3.6707686897457528
ZCTA5 75755,1942,94,1848,0.04840370751802266,3.6636435452497653
ZCTA5 04263,858,48,810,0.055944055944055944,3.663468923313208
ZCTA5 74428,470,30,440,0.06382978723404255,3.662149363189406
ZCTA5 97639,330,23,307,0.0696969696969697,3.6613471231613306
ZCTA5 75667,450,29,421,0.06444444444444444,3.6558950039124767
ZCTA5 49930,2688,124,2564,0.046130952380952384,3.6549723507695364
ZCTA5 22831,350,24,326,0.06857142857142857,3.653564623743485
ZCTA5 02121,10675,425,10250,0.03981264637002342,3.653379024095578
ZCTA5 13904,3810,168,3642,0.04409448818897638,3.652388878200599
ZCTA5 93003,19191,733,18458,0.038194987233599084,3.652228100476682
ZCTA5 28107,2664,123,2541,0.04617117117117117,3.650163003099552
ZCTA5 56481,793,45,748,0.05674653215636822,3.6476385377680747
ZCTA5 99517,6945,287,6658,0.04132469402447804,3.6475272291989267
ZCTA5 99705,8370,340,8030,0.04062126642771804,3.646400064556169
ZCTA5 87528,727,42,685,0.0577716643741403,3.646261061476425
ZCTA5 63624,1558,78,1480,0.05006418485237484,3.6459845164028177
ZCTA5 80483,255,19,236,0.07450980392156863,3.6459034230889706
ZCTA5 32083,492,31,461,0.06300813008130081,3.6455261259658895
ZCTA5 29475,883,49,834,0.05549263873159683,3.6418608757414406
ZCTA5 39083,3530,157,3373,0.044475920679886684,3.6416479263473858
ZCTA5 44076,1655,82,1573,0.04954682779456193,3.64072420464245
ZCTA5 85645,728,42,686,0.057692307692307696,3.6368606708715876
ZCTA5 99515,7889,322,7567,0.04081632653061224,3.636423798396408
ZCTA5 56159,1205,63,1142,0.05228215767634855,3.6346177716608694
ZCTA5 32616,391,26,365,0.06649616368286446,3.6334294073289115
ZCTA5 30464,24,4,20,0.16666666666666666,3.629221519504471
ZCTA5 30070,184,15,169,0.08152173913043478,3.625964112631697
ZCTA5 12585,313,22,291,0.07028753993610223,3.6238969153434826
ZCTA5 77041,11484,454,11030,0.0395332636711947,3.622787875655162
ZCTA5 39218,2445,114,2331,0.046625766871165646,3.621916158661298
ZCTA5 59422,1091,58,1033,0.05316223648029331,3.6200768696778924
ZCTA5 43008,1045,56,989,0.053588516746411484,3.619571204441971
ZCTA5 59524,238,18,220,0.07563025210084033,3.6184038989854317
ZCTA5 83872,238,18,220,0.07563025210084033,3.6184038989854317
ZCTA5 00735,4443,192,4251,0.04321404456448346,3.617778795951843
ZCTA5 84070,9965,398,9567,0.039939789262418465,3.600376638591755
ZCTA5 26412,239,18,221,0.07531380753138076,3.5987919296280264
ZCTA5 39069,1808,88,1720,0.048672566371681415,3.598561980376608
ZCTA5 20164,12431,488,11943,0.03925669696725927,3.5977204011847603
ZCTA5 25125,315,22,293,0.06984126984126984,3.591409437175022
ZCTA5 28328,9889,395,9494,0.039943371422793,3.588601875703101
ZCTA5 22738,518,32,486,0.06177606177606178,3.584669075759799
ZCTA5 96101,2304,108,2196,0.046875,3.5824586978059942
ZCTA5 12175,222,17,205,0.07657657657657657,3.573072474602219
ZCTA5 21607,222,17,205,0.07657657657657657,3.573072474602219
ZCTA5 98283,204,16,188,0.0784313725490196,3.572480812290171
ZCTA5 95118,11265,445,10820,0.039502885042166,3.5701476133758083
ZCTA5 10302,6149,256,5893,0.041632785818832334,3.5664898166438004
ZCTA5 53224,8109,329,7780,0.040572203724256996,3.564527727243084
ZCTA5 95441,670,39,631,0.058208955223880594,3.563348665847396
ZCTA5 05036,437,28,409,0.06407322654462243,3.559545470240975
ZCTA5 71378,916,50,866,0.05458515283842795,3.5565502614454028
ZCTA5 83526,104,10,94,0.09615384615384616,3.5558592732772505
ZCTA5 77807,3425,152,3273,0.04437956204379562,3.555718005534205
ZCTA5 66442,3812,167,3645,0.043809024134312695,3.555332727919759
ZCTA5 63621,458,29,429,0.06331877729257641,3.554279205322086
ZCTA5 93252,542,33,509,0.06088560885608856,3.551486126092184
ZCTA5 41836,479,30,449,0.06263048016701461,3.551077004933396
ZCTA5 26610,397,26,371,0.0654911838790932,3.5498447046898436
ZCTA5 83852,377,25,352,0.06631299734748011,3.5480099905652334
ZCTA5 29816,438,28,410,0.0639269406392694,3.546590239252246
ZCTA5 65747,1696,83,1613,0.04893867924528302,3.546265862189352
ZCTA5 11801,12680,496,12184,0.039116719242902206,3.545917931615977
ZCTA5 86322,4283,185,4098,0.04319402288115807,3.544753526386525
ZCTA5 95688,13234,516,12718,0.03899047906906453,3.541790059337521
ZCTA5 98244,1172,61,1111,0.05204778156996587,3.5398825582276396
ZCTA5 70583,4389,189,4200,0.0430622009569378,3.539783859150487
ZCTA5 52241,8012,325,7687,0.04056415376934598,3.539137044266964
ZCTA5 52401,941,51,890,0.05419766206163656,3.538654542440411
ZCTA5 11004,5178,219,4959,0.042294322132097335,3.537529017316417
ZCTA5 84320,784,44,740,0.05612244897959184,3.5297033510121993
ZCTA5 49030,829,46,783,0.05548854041013269,3.528088693634743
ZCTA5 12406,419,27,392,0.06443914081145585,3.5271192073910638
ZCTA5 35950,7424,303,7121,0.0408135775862069,3.5263084863755783
ZCTA5 59864,2618,120,2498,0.04583651642475172,3.5232879255921334
ZCTA5 26167,359,24,335,0.06685236768802229,3.5191061800145174
ZCTA5 05777,1364,69,1295,0.050586510263929615,3.518722452866229
ZCTA5 34771,5265,222,5043,0.042165242165242166,3.5150377257645644
ZCTA5 85137,944,51,893,0.05402542372881356,3.5148616081163957
ZCTA5 78379,482,30,452,0.06224066390041494,3.5145865421572346
ZCTA5 33179,15886,611,15275,0.038461538461538464,3.5097250367641695
ZCTA5 75670,5931,247,5684,0.041645590962738156,3.508182254443468
ZCTA5 01151,3335,148,3187,0.044377811094452775,3.5081272184306775
ZCTA5 33634,7568,308,7260,0.040697674418604654,3.5042709686169573
ZCTA5 55425,3984,173,3811,0.043423694779116465,3.4994018136599463
ZCTA5 92620,17819,680,17139,0.03816151299175038,3.494405769946689
ZCTA5 96776,463,29,434,0.06263498920086392,3.4918046711411783
ZCTA5 70755,766,43,723,0.05613577023498695,3.490998839380439
ZCTA5 49733,879,48,831,0.05460750853242321,3.4876659026850145
ZCTA5 77562,3676,161,3515,0.04379760609357998,3.4874854340996366
ZCTA5 15462,190,15,175,0.07894736842105263,3.4872707045327833
ZCTA5 59843,106,10,96,0.09433962264150944,3.4860134064347426
ZCTA5 55432,12135,475,11660,0.03914297486608982,3.484961758883005
ZCTA5 66016,122,11,111,0.09016393442622951,3.4833755418249948
ZCTA5 33160,19617,744,18873,0.037926288423306316,3.483253102766597
ZCTA5 01029,283,20,263,0.0706713780918728,3.4817631924022847
ZCTA5 61315,76,8,68,0.10526315789473684,3.481354662031774
ZCTA5 33853,4225,182,4043,0.043076923076923075,3.4783418690677492
ZCTA5 37385,3112,139,2973,0.04466580976863753,3.4781555696307707
ZCTA5 04668,635,37,598,0.05826771653543307,3.4772623830633043
ZCTA5 79345,342,23,319,0.06725146198830409,3.475818452124277
ZCTA5 84015,19399,736,18663,0.0379401000051549,3.474542509547081
ZCTA5 64769,227,17,210,0.07488986784140969,3.471761650884418
ZCTA5 20724,6613,272,6341,0.04113110539845758,3.471728907596279
ZCTA5 38040,1980,94,1886,0.047474747474747475,3.4694384404069547
ZCTA5 82937,1540,76,1464,0.04935064935064935,3.469143702792899
ZCTA5 95966,11181,440,10741,0.03935247294517485,3.4683642658232086
ZCTA5 57522,209,16,193,0.07655502392344497,3.4651446238623214
ZCTA5 74560,246,18,228,0.07317073170731707,3.4641881949193585
ZCTA5 77629,265,19,246,0.07169811320754717,3.462165686286517
ZCTA5 74081,681,39,642,0.05726872246696035,3.456031407940635
ZCTA5 00791,16394,628,15766,0.03830669757228254,3.4551469464267894
ZCTA5 63111,8782,352,8430,0.04008198588020952,3.4540219993124817
ZCTA5 97868,748,42,706,0.05614973262032086,3.451861651236296
ZCTA5 53923,704,40,664,0.056818181818181816,3.4474297024243032
ZCTA5 95113,1115,58,1057,0.05201793721973094,3.4471869622744267
ZCTA5 05040,247,18,229,0.0728744939271255,3.445330893428941
ZCTA5 74632,266,19,247,0.07142857142857142,3.4442446709623473
ZCTA5 20687,210,16,194,0.0761904761904762,3.444046214938763
ZCTA5 64501,4603,196,4407,0.042580925483380404,3.4434697663102916
ZCTA5 04101,9033,361,8672,0.03996457433853648,3.44097740573192
ZCTA5 21403,12988,505,12483,0.03888204496458269,3.439994696071027
ZCTA5 99694,552,33,519,0.059782608695652176,3.4399844783101536
ZCTA5 33847,37,5,32,0.13513513513513514,3.4395634885414275
ZCTA5 78353,140,12,128,0.08571428571428572,3.4387204604614166
ZCTA5 99124,157,13,144,0.08280254777070063,3.438627688140532
ZCTA5 74830,77,8,69,0.1038961038961039,3.437472964304817
ZCTA5 72521,2036,96,1940,0.047151277013752456,3.4369907790046756
ZCTA5 11901,9828,390,9438,0.03968253968253968,3.433717565590884
ZCTA5 78662,863,47,816,0.054461181923522596,3.431872831191923
ZCTA5 00705,8222,331,7891,0.04025784480661639,3.4307602210915538
ZCTA5 37342,1402,70,1332,0.04992867332382311,3.4304207649807896
ZCTA5 84401,13881,537,13344,0.038685973633023556,3.427822873606787
ZCTA5 77465,2691,122,2569,0.045336306205871424,3.427769595752203
ZCTA5 72553,16,3,13,0.1875,3.4266745685895206
ZCTA5 80610,1165,60,1105,0.05150214592274678,3.4257266279806835
ZCTA5 76209,9122,364,8758,0.039903529927647445,3.425464354530224
ZCTA5 96008,490,30,460,0.061224489795918366,3.41854127080705
ZCTA5 79325,842,46,796,0.05463182897862233,3.4173976495785934
ZCTA5 23224,14055,543,13512,0.03863393810032017,3.414933380384307
ZCTA5 76430,888,48,840,0.05405405405405406,3.413758018257106
ZCTA5 31634,2091,98,1993,0.0468675274988044,3.4109479654498154
ZCTA5 71852,3672,160,3512,0.04357298474945534,3.4098927769181655
ZCTA5 50033,8,2,6,0.25,3.4061032337724826
ZCTA5 88414,8,2,6,0.25,3.4061032337724826
ZCTA5 62424,889,48,841,0.05399325084364454,3.4055977813372365
ZCTA5 01104,9077,362,8715,0.03988101795747494,3.405077324425506
ZCTA5 12194,50,6,44,0.12,3.4032503555338134
ZCTA5 93243,776,43,733,0.055412371134020616,3.401646638660067
ZCTA5 76379,176,14,162,0.07954545454545454,3.4004590201603686
ZCTA5 23083,799,44,755,0.05506883604505632,3.3976878132977753
ZCTA5 81321,6026,249,5777,0.04132094258214404,3.3960175484454918
ZCTA5 33830,9437,375,9062,0.03973720462011232,3.394252078387535
ZCTA5 74574,471,29,442,0.06157112526539278,3.3934438315020587
ZCTA5 28704,7940,320,7620,0.04030226700251889,3.393425113697384
ZCTA5 58327,125,11,114,0.088,3.3914004745922974
ZCTA5 71658,250,18,232,0.072,3.3892972501985
ZCTA5 08215,5071,213,4858,0.042003549595740486,3.3856380114178233
ZCTA5 84667,109,10,99,0.09174311926605505,3.3842468371679115
ZCTA5 64857,142,12,130,0.08450704225352113,3.3831934017786263
ZCTA5 08872,7430,301,7129,0.040511440107671604,3.3829019530497497
ZCTA5 36580,1874,89,1785,0.047491995731056565,3.3794446074402305
ZCTA5 25022,177,14,163,0.07909604519774012,3.3768557140098507
ZCTA5 47270,195,15,180,0.07692307692307693,3.3756575290205504
ZCTA5 62250,195,15,180,0.07692307692307693,3.3756575290205504
ZCTA5 75160,8328,334,7994,0.04010566762728146,3.375575024618342
ZCTA5 79081,1339,67,1272,0.05003734129947722,3.3745739104691785
ZCTA5 15490,251,18,233,0.07171314741035857,3.370795964078144
ZCTA5 15413,251,18,233,0.07171314741035857,3.370795964078144
ZCTA5 89007,329,22,307,0.0668693009118541,3.3705690753523063
ZCTA5 79371,537,32,505,0.0595903165735568,3.3681430521180022
ZCTA5 91505,12835,498,12337,0.03880015582391897,3.3680803237840196
ZCTA5 76645,3606,157,3449,0.04353854686633389,3.3676089772947386
ZCTA5 32244,21611,812,20799,0.03757345796122345,3.3675524260105227
ZCTA5 54416,713,40,673,0.056100981767180924,3.362896187771981
ZCTA5 74126,3660,159,3501,0.04344262295081967,3.360457970969678
ZCTA5 14726,581,34,547,0.058519793459552494,3.3599154588854896
ZCTA5 34945,1438,71,1367,0.04937413073713491,3.3572402244696065
ZCTA5 20874,21816,819,20997,0.037541254125412545,3.357034888762385
ZCTA5 43152,350,23,327,0.06571428571428571,3.3563096533939767
ZCTA5 79098,143,12,131,0.08391608391608392,3.355785564180276
ZCTA5 31525,11298,442,10856,0.03912196848999823,3.350211718060626
ZCTA5 38930,8258,331,7927,0.040082344393315573,3.3495719715035692
ZCTA5 89833,51,6,45,0.11764705882352941,3.3436686807437073
ZCTA5 13656,943,50,893,0.053022269353128315,3.341687831928105
ZCTA5 93402,6503,266,6237,0.04090419806243272,3.3409756252670495
ZCTA5 50007,161,13,148,0.08074534161490683,3.3369940336700306
ZCTA5 78748,19385,732,18653,0.03776115553262832,3.3347360268620676
ZCTA5 83660,2157,100,2057,0.04636068613815485,3.333454859987773
ZCTA5 70372,1155,59,1096,0.05108225108225108,3.3316335273559816
ZCTA5 15615,127,11,116,0.08661417322834646,3.3315731868985066
ZCTA5 56688,65,7,58,0.1076923076923077,3.328483667191685
ZCTA5 92365,1038,54,984,0.05202312138728324,3.326958223014235
ZCTA5 27553,830,45,785,0.05421686746987952,3.3264753506281703
ZCTA5 04493,762,42,720,0.05511811023622047,3.325649618079942
ZCTA5 70722,2134,99,2035,0.04639175257731959,3.323615884583198
ZCTA5 75124,1614,78,1536,0.048327137546468404,3.3228460893157634
ZCTA5 16503,5813,240,5573,0.04128677103044899,3.3209697091618913
ZCTA5 27509,1590,77,1513,0.048427672955974846,3.320342012432901
ZCTA5 64866,435,27,408,0.06206896551724138,3.318923316619141
ZCTA5 71075,2693,121,2572,0.04493130337913108,3.312163371326535
ZCTA5 37146,2490,113,2377,0.04538152610441767,3.309818029152867
ZCTA5 12428,2694,121,2573,0.04491462509279881,3.307964191445916
ZCTA5 78548,180,14,166,0.07777777777777778,3.3069964252787427
ZCTA5 33592,3989,171,3818,0.04286788668839308,3.3063789581609195
ZCTA5 65610,1939,91,1848,0.04693140794223827,3.3002769846141846
ZCTA5 74451,1496,73,1423,0.04879679144385027,3.300093673200815
ZCTA5 89421,217,16,201,0.07373271889400922,3.2996355541979634
ZCTA5 53144,9812,387,9425,0.039441500203832046,3.2981421632631442
ZCTA5 60604,479,29,450,0.060542797494780795,3.29698243124454
ZCTA5 18201,9869,389,9480,0.03941635424055122,3.293815993119945
ZCTA5 13302,632,36,596,0.056962025316455694,3.2864969196333487
ZCTA5 68050,275,19,256,0.06909090909090909,3.2864458780552366
ZCTA5 57361,52,6,46,0.11538461538461539,3.2855623578393214
ZCTA5 68731,974,51,923,0.052361396303901436,3.2814714147604165
ZCTA5 62814,722,40,682,0.055401662049861494,3.2795561900659664
ZCTA5 91020,3450,150,3300,0.043478260869565216,3.274268212295361
ZCTA5 98274,6691,272,6419,0.040651621581228516,3.2740297856759666
ZCTA5 42354,81,8,73,0.09876543209876543,3.2688365505138193
ZCTA5 59866,356,23,333,0.06460674157303371,3.2687442521154306
ZCTA5 35115,5405,224,5181,0.04144310823311748,3.266222348973463
ZCTA5 38563,1260,63,1197,0.05,3.266140740557287
ZCTA5 94952,13726,528,13198,0.038467142648987325,3.2660558358084493
ZCTA5 97760,2935,130,2805,0.044293015332197615,3.265480086122736
ZCTA5 97479,3923,168,3755,0.04282436910527657,3.263754192725029
ZCTA5 95303,316,21,295,0.06645569620253164,3.2624184856415055
ZCTA5 01607,3714,160,3554,0.043080236941303175,3.2623413021202015
ZCTA5 84036,2501,113,2388,0.045181927229108354,3.2616099394797504
ZCTA5 30901,6483,264,6219,0.04072188801480796,3.254201828525137
ZCTA5 24069,839,45,794,0.05363528009535161,3.2507791958567687
ZCTA5 58379,97,9,88,0.09278350515463918,3.2495102800155125
ZCTA5 73447,462,28,434,0.06060606060606061,3.24550992119686
ZCTA5 53203,909,48,861,0.052805280528052806,3.2445106311765435
ZCTA5 78012,130,11,119,0.08461538461538462,3.2439563091911157
ZCTA5 27915,399,25,374,0.06265664160401002,3.243904239798745
ZCTA5 70811,4721,198,4523,0.0419402668926075,3.242530520978846
ZCTA5 01603,7110,287,6823,0.040365682137834036,3.2409030276771293
ZCTA5 77571,13296,512,12784,0.03850782190132371,3.240575583277264
ZCTA5 62655,220,16,204,0.07272727272727272,3.239431670493765
ZCTA5 79855,659,37,622,0.05614567526555387,3.239422856333526
ZCTA5 76637,239,17,222,0.07112970711297072,3.23907225094084
ZCTA5 32110,2916,129,2787,0.044238683127572016,3.238577207286888
ZCTA5 72063,795,43,752,0.05408805031446541,3.235384857719604
ZCTA5 49064,1410,69,1341,0.04893617021276596,3.2329392715154053
ZCTA5 42274,934,49,885,0.05246252676659529,3.2305714227807387
ZCTA5 26521,82,8,74,0.0975609756097561,3.2282984142841156
ZCTA5 33178,14891,569,14322,0.038210999932845345,3.2280143675381887
ZCTA5 35746,259,18,241,0.0694980694980695,3.225847579939353
ZCTA5 92325,3388,147,3241,0.04338842975206612,3.2156360621404074
ZCTA5 78369,131,11,120,0.08396946564885496,3.2152963834417996
ZCTA5 38548,299,20,279,0.06688963210702341,3.2151781417175056
ZCTA5 93555,12980,500,12480,0.03852080123266564,3.2100588004795467
ZCTA5 12887,1758,83,1675,0.047212741751990896,3.2080670079118754
ZCTA5 85213,12594,486,12108,0.03858980466888995,3.2050322461238823
ZCTA5 62215,685,38,647,0.05547445255474453,3.205012704512599
ZCTA5 62204,3339,145,3194,0.0434261755016472,3.2044272066347292
ZCTA5 98673,203,15,188,0.07389162561576355,3.2040120101134404
ZCTA5 33898,6314,257,6057,0.040703199239784604,3.20324777815315
ZCTA5 92007,4469,188,4281,0.04206757663906914,3.2021323224102347
ZCTA5 81147,5375,222,5153,0.04130232558139535,3.1997466597583983
ZCTA5 32448,3890,166,3724,0.042673521850899745,3.1976770489078703
ZCTA5 77064,16364,621,15743,0.03794915668540699,3.1976330611545967
ZCTA5 62443,619,35,584,0.05654281098546042,3.1945180765727286
ZCTA5 20876,9068,358,8710,0.039479488310542564,3.190752943869963
ZCTA5 21130,115,10,105,0.08695652173913043,3.190687680975646
ZCTA5 67038,261,18,243,0.06896551724137931,3.1904326384898667
ZCTA5 16362,425,26,399,0.0611764705882353,3.17823230274355
ZCTA5 43720,533,31,502,0.058161350844277676,3.172112278973196
ZCTA5 98664,9105,359,8746,0.03942888522789676,3.1704036897439667
ZCTA5 76671,734,40,694,0.05449591280653951,3.170233474470488
ZCTA5 28472,7466,299,7167,0.04004821859094562,3.1685025205789623
ZCTA5 49757,447,27,420,0.06040268456375839,3.1684762882841793
ZCTA5 87421,512,30,482,0.05859375,3.163404839797915
ZCTA5 03777,512,30,482,0.05859375,3.163404839797915
ZCTA5 29727,600,34,566,0.056666666666666664,3.1619801719091627
ZCTA5 51103,5899,241,5658,0.04085438209866079,3.160762439127327
ZCTA5 54180,1229,61,1168,0.04963384865744508,3.154327997163566
ZCTA5 54303,11791,456,11335,0.03867356458315664,3.1517516928985105
ZCTA5 13124,41,5,36,0.12195121951219512,3.1512544924472294
ZCTA5 55766,9,2,7,0.2222222222222222,3.1492904345481323
ZCTA5 47464,84,8,76,0.09523809523809523,3.149036749034244
ZCTA5 95249,1571,75,1496,0.047740292807129214,3.148931451429618
ZCTA5 02142,1522,73,1449,0.047963206307490146,3.147796627841286
ZCTA5 99669,5877,240,5637,0.0408371618172537,3.1475215479590495
ZCTA5 25193,244,17,227,0.06967213114754098,3.1461621898151497
ZCTA5 97721,100,9,91,0.09,3.1445834256017204
ZCTA5 92562,19745,740,19005,0.037477842491770066,3.144168232281336
ZCTA5 71351,4224,178,4046,0.04214015151515151,3.1393521560371025
ZCTA5 63829,493,29,464,0.058823529411764705,3.1325264718229353
ZCTA5 82301,3542,152,3390,0.04291360813099943,3.1307552941667214
ZCTA5 59077,29,4,25,0.13793103448275862,3.1288298527258984
ZCTA5 74578,2353,106,2247,0.04504887377815554,3.127741095908002
ZCTA5 48127,12694,488,12206,0.038443359067275876,3.1259746293785144
ZCTA5 60426,10311,402,9909,0.038987489089322085,3.1245899241715818
ZCTA5 38006,1799,84,1715,0.04669260700389105,3.1225747167716396
ZCTA5 70085,1650,78,1572,0.04727272727272727,3.121514296776162
ZCTA5 52549,285,19,266,0.06666666666666667,3.118071455510492
ZCTA5 45658,949,49,900,0.051633298208640675,3.1143499429958754
ZCTA5 52585,409,25,384,0.061124694376528114,3.1120097234697455
ZCTA5 77539,15579,591,14988,0.037935682649720776,3.1106408623174238
ZCTA5 52072,85,8,77,0.09411764705882353,3.1102789511652977
ZCTA5 78151,495,29,466,0.05858585858585859,3.109467665839833
ZCTA5 77873,517,30,487,0.058027079303675046,3.107159833590407
ZCTA5 84319,2256,102,2154,0.04521276595744681,3.1058840023250833
ZCTA5 27555,266,18,248,0.06766917293233082,3.1032698351153254
ZCTA5 05679,1407,68,1339,0.048329779673063254,3.103006272992794
ZCTA5 85352,208,15,193,0.07211538461538461,3.10076902825905
ZCTA5 62361,171,13,158,0.07602339181286549,3.095680304295926
ZCTA5 27203,8893,350,8543,0.03935679748116496,3.0954716473111654
ZCTA5 01092,540,31,509,0.05740740740740741,3.0954429726351615
ZCTA5 05836,453,27,426,0.059602649006622516,3.0949765474512834
ZCTA5 78611,4743,197,4546,0.04153489352730339,3.0948221253338386
ZCTA5 39455,3395,146,3249,0.04300441826215022,3.094525668837726
ZCTA5 11239,6764,272,6492,0.04021289178001183,3.0911808702379213
ZCTA5 46120,2057,94,1963,0.045697617890131256,3.0880279005879543
ZCTA5 74849,1167,58,1109,0.049700085689802914,3.086317839313047
ZCTA5 74343,1167,58,1109,0.049700085689802914,3.086317839313047
ZCTA5 59925,454,27,427,0.05947136563876652,3.0828346511430116
ZCTA5 95436,2852,125,2727,0.0438288920056101,3.0811373217988542
ZCTA5 50254,102,9,93,0.08823529411764706,3.076759455119381
ZCTA5 32950,1683,79,1604,0.046939988116458706,3.0766631358047167
ZCTA5 85120,13812,527,13285,0.03815522733854619,3.072413393828011
ZCTA5 47881,154,12,142,0.07792207792207792,3.0688059705606516
ZCTA5 28610,3849,163,3686,0.04234866199012731,3.068699599575967
ZCTA5 10016,28916,1061,27855,0.036692488587633146,3.0622538262849495
ZCTA5 06401,7402,295,7107,0.03985409348824642,3.06201338562973
ZCTA5 30531,3772,160,3612,0.042417815482502653,3.0614686481850897
ZCTA5 88231,1075,54,1021,0.05023255813953489,3.0592541814538117
ZCTA5 23043,839,44,795,0.052443384982121574,3.058787622835999
ZCTA5 73093,1004,51,953,0.05079681274900399,3.0559292438332073
ZCTA5 33004,6561,264,6297,0.040237768632830365,3.0556473412672482
ZCTA5 04256,1196,59,1137,0.04933110367892977,3.053466764019324
ZCTA5 70363,8063,319,7744,0.03956343792633015,3.050668432325231
ZCTA5 74733,1221,60,1161,0.04914004914004914,3.0480890213910334
ZCTA5 54437,1101,55,1046,0.049954586739327886,3.044735923088398
ZCTA5 12132,103,9,94,0.08737864077669903,3.0434558927525925
ZCTA5 30284,30,4,26,0.13333333333333333,3.042273996139144
ZCTA5 99649,30,4,26,0.13333333333333333,3.042273996139144
ZCTA5 04921,657,36,621,0.0547945205479452,3.041905837523565
ZCTA5 47807,4814,199,4615,0.0413377648525135,3.0418382463492692
ZCTA5 43022,1102,55,1047,0.0499092558983666,3.037749821196072
ZCTA5 98530,250,17,233,0.068,3.0375804260963815
ZCTA5 84633,415,25,390,0.060240963855421686,3.034636272695632
ZCTA5 60440,16415,619,15796,0.03770941212305818,3.031794554187875
ZCTA5 62062,3465,148,3317,0.042712842712842716,3.0308174358566973
ZCTA5 81520,5301,217,5084,0.04093567251461988,3.02918829040324
ZCTA5 73054,1518,72,1446,0.04743083003952569,3.0283074791715823
ZCTA5 84001,231,16,215,0.06926406926406926,3.0267132237132817
ZCTA5 71631,174,13,161,0.07471264367816093,3.026565615187091
ZCTA5 78155,17460,656,16804,0.03757159221076747,3.025535827311685
ZCTA5 31643,3572,152,3420,0.0425531914893617,3.02419489309802
ZCTA5 92253,15243,577,14666,0.037853440923702686,3.0204471895874767
ZCTA5 39046,10060,391,9669,0.038866799204771374,3.019006493903114
ZCTA5 46550,4342,181,4161,0.04168585905112851,3.0164270528273307
ZCTA5 84336,57,6,51,0.10526315789473684,3.014941576902905
ZCTA5 49881,121,10,111,0.08264462809917356,3.0090956920475667
ZCTA5 99689,232,16,216,0.06896551724137931,3.0079687381267646
ZCTA5 63118,11202,432,10770,0.0385645420460632,3.0078536869450474
ZCTA5 74740,916,47,869,0.05131004366812227,3.005315413252243
ZCTA5 66104,9404,367,9037,0.03902594640578477,3.004740372726045
ZCTA5 67360,175,13,162,0.07428571428571429,3.0038423315033813
ZCTA5 56379,6882,275,6607,0.03995931415286254,3.0010422431568182
ZCTA5 33857,893,46,847,0.051511758118701005,3.000866747355277
ZCTA5 32343,1277,62,1215,0.0485512920908379,3.0002018910203407
ZCTA5 22937,754,40,714,0.05305039787798409,2.9923992877836247
ZCTA5 88001,14113,536,13577,0.03797916814284702,2.9893970898998687
ZCTA5 87410,6452,259,6193,0.04014259144451333,2.987643711042657
ZCTA5 10025,41910,1512,40398,0.0360773085182534,2.986276829272072
ZCTA5 57278,273,18,255,0.06593406593406594,2.984406923785056
ZCTA5 91207,4166,174,3992,0.041766682669227076,2.983671146805081
ZCTA5 36767,686,37,649,0.05393586005830904,2.983247685877268
ZCTA5 30567,1086,54,1032,0.049723756906077346,2.981621200994275
ZCTA5 48737,618,34,584,0.05501618122977346,2.980883852455574
ZCTA5 83870,105,9,96,0.08571428571428572,2.978019275272909
ZCTA5 19933,3744,158,3586,0.042200854700854704,2.976258157435845
ZCTA5 70358,335,21,314,0.0626865671641791,2.975423593984092
ZCTA5 96796,664,36,628,0.05421686746987952,2.9752900037928147
ZCTA5 54652,377,23,354,0.0610079575596817,2.975184325702978
ZCTA5 39667,4810,198,4612,0.041164241164241167,2.973648300772696
ZCTA5 79064,873,45,828,0.05154639175257732,2.9727628599625664
ZCTA5 32207,14740,558,14182,0.0378561736770692,2.972038707329236
ZCTA5 49232,944,48,896,0.05084745762711865,2.9718633894560504
ZCTA5 67134,158,12,146,0.0759493670886076,2.970508008714239
ZCTA5 77514,1778,82,1696,0.04611923509561305,2.9698446400833363
ZCTA5 49103,3588,152,3436,0.042363433667781496,2.9677499637207374
ZCTA5 58794,58,6,52,0.10344827586206896,2.964408990573081
ZCTA5 29689,1654,77,1577,0.046553808948004836,2.9626994369327333
ZCTA5 76384,5029,206,4823,0.040962417975740704,2.960997105796287
ZCTA5 79106,11422,439,10983,0.03843459989493959,2.96001653443582
ZCTA5 94305,3459,147,3312,0.042497831743278404,2.957868946349378
ZCTA5 63540,44,5,39,0.11363636363636363,2.9577876367913474
ZCTA5 88252,758,40,718,0.052770448548812667,2.957463718474636
ZCTA5 75173,1456,69,1387,0.04739010989010989,2.9571790876243775
ZCTA5 74766,598,33,565,0.05518394648829431,2.9550675477980115
ZCTA5 83402,9208,359,8849,0.038987836663770634,2.952926039325709
ZCTA5 49096,1187,58,1129,0.04886267902274642,2.952207554468631
ZCTA5 26743,509,29,480,0.05697445972495088,2.9509594404953847
ZCTA5 73040,782,41,741,0.052429667519181586,2.950923012368112
ZCTA5 71225,2393,106,2287,0.0442958629335562,2.949364310477059
ZCTA5 84511,1261,61,1200,0.04837430610626487,2.9463963357751366
ZCTA5 77363,1310,63,1247,0.048091603053435114,2.94619414785016
ZCTA5 57658,106,9,97,0.08490566037735849,2.945868587549047
ZCTA5 13117,106,9,97,0.08490566037735849,2.945868587549047
ZCTA5 74754,141,11,130,0.07801418439716312,2.942505292955443
ZCTA5 39332,510,29,481,0.056862745098039215,2.939826779999902
ZCTA5 76442,2940,127,2813,0.04319727891156463,2.9378582175123515
ZCTA5 89086,1835,84,1751,0.04577656675749319,2.9354424680167686
ZCTA5 25286,555,31,524,0.055855855855855854,2.934869555805564
ZCTA5 24827,511,29,482,0.05675146771037182,2.9287187497985765
ZCTA5 58801,12136,464,11672,0.03823335530652604,2.92784168903753
ZCTA5 65705,1486,70,1416,0.047106325706594884,2.926653184952271
ZCTA5 23604,785,41,744,0.05222929936305733,2.9253583795370472
ZCTA5 57551,762,40,722,0.05249343832020997,2.9227325571999914
ZCTA5 75652,4559,188,4371,0.041237113402061855,2.9223847152751823
ZCTA5 75153,124,10,114,0.08064516129032258,2.9223508821997255
ZCTA5 71971,217,15,202,0.06912442396313365,2.9221213643397106
ZCTA5 94060,318,20,298,0.06289308176100629,2.9194247699608553
ZCTA5 03864,716,38,678,0.05307262569832402,2.9193268387160387
ZCTA5 56594,198,14,184,0.0707070707070707,2.9151097646828723
ZCTA5 04415,107,9,98,0.08411214953271028,2.9140850310255324
ZCTA5 77859,2427,107,2320,0.044087350638648534,2.9131173935898644
ZCTA5 36509,625,34,591,0.0544,2.912051726746709
ZCTA5 95548,425,25,400,0.058823529411764705,2.908477812668635
ZCTA5 47175,361,22,339,0.060941828254847646,2.904378661048228
ZCTA5 76513,13268,504,12764,0.03798613204703045,2.9029833080442904
ZCTA5 71222,1195,58,1137,0.048535564853556486,2.8992544034367387
ZCTA5 62615,2122,95,2027,0.044769085768143264,2.898572160194982
ZCTA5 12721,1995,90,1905,0.045112781954887216,2.895866179538957
ZCTA5 49896,604,33,571,0.054635761589403975,2.8949334178732733
ZCTA5 99627,125,10,115,0.08,2.8939977718322885
ZCTA5 97448,5133,209,4924,0.040716929670757844,2.89364805196238
ZCTA5 14201,5674,229,5445,0.04035953471977441,2.89260707430716
ZCTA5 40460,470,27,443,0.0574468085106383,2.8926017898295746
ZCTA5 98933,362,22,340,0.06077348066298342,2.89058608623391
ZCTA5 33196,13948,528,13420,0.03785488958990536,2.8902471538421546
ZCTA5 04956,320,20,300,0.0625,2.889486975271627
ZCTA5 20868,239,16,223,0.06694560669456066,2.879352572253652
ZCTA5 56359,1420,67,1353,0.047183098591549295,2.8770105565495343
ZCTA5 37208,7401,292,7109,0.03945412782056479,2.870455397630874
ZCTA5 35961,2489,109,2380,0.04379268782643632,2.868339430851968
ZCTA5 12032,385,23,362,0.05974025974025974,2.868257826178702
ZCTA5 78938,126,10,116,0.07936507936507936,2.8659167070383074
ZCTA5 12955,144,11,133,0.0763888888888889,2.8651820020118706
ZCTA5 80723,2802,121,2681,0.04318344039971449,2.864006137478953
ZCTA5 85938,769,40,729,0.05201560468140442,2.862437428245628
ZCTA5 39464,959,48,911,0.05005213764337852,2.858415039459092
ZCTA5 65644,864,44,820,0.05092592592592592,2.855976306909159
ZCTA5 38334,770,40,730,0.05194805194805195,2.8538735574077743
ZCTA5 74837,92,8,84,0.08695652173913043,2.853837819853083
ZCTA5 59844,281,18,263,0.06405693950177936,2.852830128197145
ZCTA5 79781,109,9,100,0.08256880733944955,2.8515870658220006
ZCTA5 70525,5230,212,5018,0.04053537284894838,2.8478437687642004
ZCTA5 15924,430,25,405,0.05813953488372093,2.8466595491950732
ZCTA5 13667,1326,63,1263,0.04751131221719457,2.8466200005328424
ZCTA5 66550,241,16,225,0.06639004149377593,2.843411933315468
ZCTA5 99611,5910,237,5673,0.04010152284263959,2.8418453159532557
ZCTA5 30423,46,5,41,0.10869565217391304,2.837912148860346
ZCTA5 85757,6184,247,5937,0.039941785252263905,2.8371197167436994
ZCTA5 49657,1328,63,1265,0.04743975903614458,2.8342651916727832
ZCTA5 06239,4588,188,4400,0.04097646033129904,2.833481373653997
ZCTA5 76687,749,39,710,0.0520694259012016,2.833160744132135
ZCTA5 65360,1779,81,1698,0.045531197301854974,2.8327504415023483
ZCTA5 71472,164,12,152,0.07317073170731707,2.8284978168418475
ZCTA5 52769,242,16,226,0.06611570247933884,2.8255717063127124
ZCTA5 94002,10380,399,9981,0.038439306358381505,2.824437396968352
ZCTA5 39216,1730,79,1651,0.04566473988439306,2.824355174075375
ZCTA5 00683,11217,429,10788,0.03824552019256486,2.821968934952827
ZCTA5 61802,8579,334,8245,0.038932276489101296,2.821666360451651
ZCTA5 39365,2682,116,2566,0.04325130499627144,2.821552326485138
ZCTA5 75237,8441,329,8112,0.03897642459424239,2.8214365107522883
ZCTA5 93004,10856,416,10440,0.03831982313927782,2.8192405136865624
ZCTA5 93276,61,6,55,0.09836065573770492,2.819133415898315
ZCTA5 13203,7066,279,6787,0.03948485706198698,2.8191036410717674
ZCTA5 72947,1580,73,1507,0.046202531645569624,2.818015402840808
ZCTA5 64074,304,19,285,0.0625,2.816323530997665
ZCTA5 53170,893,45,848,0.05039193729003359,2.8147705847544935
ZCTA5 62570,203,14,189,0.06896551724137931,2.813697112049275
ZCTA5 27510,7151,282,6869,0.03943504404978325,2.8125835413986158
ZCTA5 65230,263,17,246,0.06463878326996197,2.8124206564218563
ZCTA5 17047,894,45,849,0.050335570469798654,2.8069736632871694
ZCTA5 45214,3528,148,3380,0.04195011337868481,2.8063057661692756
ZCTA5 41555,284,18,266,0.06338028169014084,2.804603413129907
ZCTA5 66944,77,7,70,0.09090909090909091,2.8037232381170094
ZCTA5 60145,847,43,804,0.05076741440377804,2.802085106499425
ZCTA5 97537,3212,136,3076,0.04234122042341221,2.8009456520092053
ZCTA5 54498,871,44,827,0.0505166475315729,2.8003498889521885
ZCTA5 21875,2609,113,2496,0.04331161364507474,2.800019099089241
ZCTA5 55604,1659,76,1583,0.04581072935503315,2.7988595847081252
ZCTA5 37814,13024,493,12531,0.037853194103194106,2.791797079466077
ZCTA5 59255,968,48,920,0.049586776859504134,2.791278948906604
ZCTA5 15310,111,9,102,0.08108108108108109,2.790463387350718
ZCTA5 84647,1485,69,1416,0.046464646464646465,2.7881550848524577
ZCTA5 72940,1017,50,967,0.049164208456243856,2.786112689363518
ZCTA5 45131,94,8,86,0.0851063829787234,2.7849367746048763
ZCTA5 06906,3481,146,3335,0.041941970698075266,2.7848786268790873
ZCTA5 78122,185,13,172,0.07027027027027027,2.784747736303357
ZCTA5 29301,13817,521,13296,0.03770717232394876,2.7800815982363773
ZCTA5 15474,732,38,694,0.05191256830601093,2.7772235163752264
ZCTA5 81410,639,34,605,0.053208137715179966,2.776937923175099
ZCTA5 06108,8824,342,8482,0.038757932910244784,2.7705979035265593
ZCTA5 24076,481,27,454,0.056133056133056136,2.7660236329968533
ZCTA5 71108,6814,269,6545,0.03947754622835339,2.7650212998788017
ZCTA5 40442,526,29,497,0.055133079847908745,2.764979202978149
ZCTA5 57766,78,7,71,0.08974358974358974,2.7646274014537724
ZCTA5 37888,1142,55,1087,0.04816112084063047,2.7638629030254838
ZCTA5 39870,828,42,786,0.050724637681159424,2.7636333101162927
ZCTA5 98643,186,13,173,0.06989247311827956,2.763610397233848
ZCTA5 56556,459,26,433,0.05664488017429194,2.763007427437553
ZCTA5 76022,5722,229,5493,0.0400209716882209,2.7623946693258543
ZCTA5 45770,266,17,249,0.06390977443609022,2.762294999268304
ZCTA5 96087,266,17,249,0.06390977443609022,2.762294999268304
ZCTA5 83656,206,14,192,0.06796116504854369,2.754247096788953
ZCTA5 30125,8862,343,8519,0.038704581358609796,2.7486268667351457
ZCTA5 92386,998,49,949,0.04909819639278557,2.748367188304988
ZCTA5 32059,974,48,926,0.049281314168377825,2.746900995004794
ZCTA5 53926,528,29,499,0.054924242424242424,2.743544525734378
ZCTA5 67566,187,13,174,0.06951871657754011,2.742606313222854
ZCTA5 77624,288,18,270,0.0625,2.7412080333746904
ZCTA5 45672,551,30,521,0.0544464609800363,2.740293892005113
ZCTA5 99693,131,10,121,0.07633587786259542,2.7294180877364247
ZCTA5 27542,3604,150,3454,0.041620421753607105,2.7263027576256587
ZCTA5 51363,79,7,72,0.08860759493670886,2.726142508144163
ZCTA5 81052,3791,157,3634,0.04141387496702717,2.725415242638247
ZCTA5 80423,48,5,43,0.10416666666666667,2.724453813554422
ZCTA5 97859,48,5,43,0.10416666666666667,2.724453813554422
ZCTA5 38841,1050,51,999,0.04857142857142857,2.724134576925893
ZCTA5 47459,1396,65,1331,0.04656160458452722,2.723459530357008
ZCTA5 25630,248,16,232,0.06451612903225806,2.7202994945247174
ZCTA5 75904,12366,468,11898,0.03784570596797671,2.7157285943826492
ZCTA5 85121,508,28,480,0.05511811023622047,2.715381542525871
ZCTA5 85620,228,15,213,0.06578947368421052,2.71522891009571
ZCTA5 75065,4492,183,4309,0.04073909171861086,2.7152084705716404
ZCTA5 39462,464,26,438,0.05603448275862069,2.704895954731198
ZCTA5 31301,1753,79,1674,0.0450656018254421,2.703565613490289
ZCTA5 24604,132,10,122,0.07575757575757576,2.702866721660723
ZCTA5 45146,487,27,460,0.055441478439425054,2.6983490584778456
ZCTA5 93608,270,17,253,0.06296296296296296,2.696468224411264
ZCTA5 79108,4256,174,4082,0.04088345864661654,2.695296518821182
ZCTA5 18352,291,18,273,0.061855670103092786,2.6943233042532917
ZCTA5 25921,909,45,864,0.04950495049504951,2.6911573870697003
ZCTA5 45880,1104,53,1051,0.04800724637681159,2.689057721322603
ZCTA5 32094,910,45,865,0.04945054945054945,2.6835110416587713
ZCTA5 94306,10676,407,10269,0.038122892469089543,2.6826135045651482
ZCTA5 79043,466,26,440,0.055793991416309016,2.681848620695936
ZCTA5 97470,8783,339,8444,0.03859729021974268,2.6804305804329918
ZCTA5 72130,292,18,274,0.06164383561643835,2.678818409479756
ZCTA5 56484,1581,72,1509,0.04554079696394687,2.6725839100291955
ZCTA5 78626,10458,399,10059,0.03815261044176707,2.671984024870423
ZCTA5 33133,13628,512,13116,0.03756970942177869,2.671760975412179
ZCTA5 60195,2223,97,2126,0.04363472784525416,2.669322636822997
ZCTA5 32466,2017,89,1928,0.044124938026772434,2.6650695402534357
ZCTA5 94547,8098,314,7784,0.03877500617436404,2.6627196554274097
ZCTA5 99173,698,36,662,0.05157593123209169,2.662498433115289
ZCTA5 77701,5024,202,4822,0.04020700636942675,2.66176117219057
ZCTA5 70764,5843,232,5611,0.039705630669176796,2.6574009197501622
ZCTA5 63633,211,14,197,0.06635071090047394,2.657379383095187
ZCTA5 39664,938,46,892,0.04904051172707889,2.654645594361734
ZCTA5 70630,770,39,731,0.05064935064935065,2.653464297281621
ZCTA5 67356,1085,52,1033,0.047926267281105994,2.6509840105964697
ZCTA5 41822,842,42,800,0.0498812351543943,2.650800689269116
ZCTA5 27573,4459,181,4278,0.040592061000224264,2.6506169275616736
ZCTA5 23065,723,37,686,0.051175656984785614,2.6499062618194604
ZCTA5 78236,402,23,379,0.05721393034825871,2.6492124005326145
ZCTA5 68018,172,12,160,0.06976744186046512,2.6484501490040167
ZCTA5 30410,583,31,552,0.05317324185248713,2.6477815187829643
ZCTA5 97362,1535,70,1465,0.04560260586319218,2.6468837376027996
ZCTA5 56660,116,9,107,0.07758620689655173,2.6432931689672303
ZCTA5 98617,492,27,465,0.054878048780487805,2.6426654844444193
ZCTA5 48215,4895,197,4698,0.04024514811031665,2.6422064674450074
ZCTA5 74365,1715,77,1638,0.044897959183673466,2.63549409051234
ZCTA5 33513,3819,157,3662,0.041110238282272844,2.6311116244476125
ZCTA5 45148,539,29,510,0.05380333951762523,2.6272568075440015
ZCTA5 95919,539,29,510,0.05380333951762523,2.6272568075440015
ZCTA5 74039,1337,62,1275,0.04637247569184742,2.6268286265518537
ZCTA5 98261,1337,62,1275,0.04637247569184742,2.6268286265518537
ZCTA5 50455,173,12,161,0.06936416184971098,2.626639952047433
ZCTA5 07508,7562,294,7268,0.03887860354403597,2.6231886442480836
ZCTA5 62899,750,38,712,0.050666666666666665,2.621414190115224
ZCTA5 62927,154,11,143,0.07142857142857142,2.620677241598135
ZCTA5 72041,609,32,577,0.052545155993431854,2.6199822405184983
ZCTA5 36540,213,14,199,0.06572769953051644,2.619379021582509
ZCTA5 43777,1847,82,1765,0.04439631835408771,2.615146627823754
ZCTA5 29479,2470,106,2364,0.04291497975708502,2.6147868420171174
ZCTA5 74108,2733,116,2617,0.04244420051225759,2.613607065482475
ZCTA5 71647,895,44,851,0.049162011173184354,2.6132982182274533
ZCTA5 18054,1669,75,1594,0.04493708807669263,2.6087987691949315
ZCTA5 80478,541,29,512,0.053604436229205174,2.606398746484081
ZCTA5 93523,1141,54,1087,0.047326906222611743,2.605947211516156
ZCTA5 26763,681,35,646,0.0513950073421439,2.6036193535538406
ZCTA5 30527,1619,73,1546,0.045089561457689935,2.603542125533711
ZCTA5 84635,255,16,239,0.06274509803921569,2.6011487754641527
ZCTA5 48444,3400,141,3259,0.04147058823529412,2.5994332760434418
ZCTA5 41098,658,34,624,0.05167173252279635,2.5987498131416835
ZCTA5 51239,1068,51,1017,0.047752808988764044,2.5986097568538193
ZCTA5 78050,155,11,144,0.07096774193548387,2.5972663934164406
ZCTA5 54433,753,38,715,0.05046480743691899,2.5958476348764674
ZCTA5 70466,3215,134,3081,0.0416796267496112,2.5936386502343547
ZCTA5 28345,4966,199,4767,0.0400724929520741,2.5936373597667597
ZCTA5 66606,5293,211,5082,0.03986397128282637,2.593303125840941
ZCTA5 92004,1193,56,1137,0.04694048616932104,2.590443657336293
ZCTA5 49838,235,15,220,0.06382978723404255,2.5895306484292258
ZCTA5 15729,589,31,558,0.05263157894736842,2.588266117531126
ZCTA5 73446,3004,126,2878,0.041944074567243674,2.587687695593782
ZCTA5 93426,497,27,470,0.05432595573440644,2.5876128446498012
ZCTA5 79739,363,21,342,0.05785123966942149,2.5849533723520053
ZCTA5 62253,256,16,240,0.0625,2.5844357187230447
ZCTA5 71825,256,16,240,0.0625,2.5844357187230447
ZCTA5 44651,277,17,260,0.061371841155234655,2.583931431172298
ZCTA5 12943,195,13,182,0.06666666666666667,2.5791757641143414
ZCTA5 68503,6202,244,5958,0.039342147694292166,2.5786317835395343
ZCTA5 72830,5599,222,5377,0.03964993748883729,2.578148508402075
ZCTA5 19122,6505,255,6250,0.03920061491160646,2.577389460813861
ZCTA5 56566,156,11,145,0.07051282051282051,2.5740330391672455
ZCTA5 98628,156,11,145,0.07051282051282051,2.5740330391672455
ZCTA5 65243,708,36,672,0.05084745762711865,2.5737091918458668
ZCTA5 36585,299,18,281,0.06020066889632107,2.571961090400232
ZCTA5 30274,12561,472,12089,0.037576626064803755,2.569348005608898
ZCTA5 31775,1097,52,1045,0.04740200546946217,2.56903964360291
ZCTA5 65247,278,17,261,0.06115107913669065,2.5681217396896043
ZCTA5 76240,10822,410,10412,0.03788578820920348,2.5637252092706606
ZCTA5 74726,926,45,881,0.04859611231101512,2.562406055279384
ZCTA5 63837,615,32,583,0.05203252032520325,2.5621585333848826
ZCTA5 72350,454,25,429,0.05506607929515418,2.560841005181715
ZCTA5 52594,119,9,110,0.07563025210084033,2.5585979340444416
ZCTA5 55785,101,8,93,0.07920792079207921,2.557112194677096
ZCTA5 59632,639,33,606,0.051643192488262914,2.556942969864367
ZCTA5 72358,500,27,473,0.054,2.554877975724513
ZCTA5 84513,523,28,495,0.05353728489483748,2.554132060855803
ZCTA5 16023,1989,87,1902,0.043740573152337855,2.5511778178458724
ZCTA5 02453,11139,421,10718,0.03779513421312505,2.5477952052754396
ZCTA5 40508,9515,363,9152,0.03815028901734104,2.54741264474254
ZCTA5 41557,735,37,698,0.050340136054421766,2.545837550009196
ZCTA5 34104,10467,397,10070,0.03792872838444636,2.5457557698250404
ZCTA5 37872,664,34,630,0.05120481927710843,2.5436625073128143
ZCTA5 33438,84,7,77,0.08333333333333333,2.5422675816488804
ZCTA5 15126,3256,135,3121,0.041461916461916465,2.5410391484370134
ZCTA5 61737,197,13,184,0.06598984771573604,2.5395400053432944
ZCTA5 60612,13142,492,12650,0.03743722416679349,2.5392264838337417
ZCTA5 17063,1428,65,1363,0.04551820728291316,2.5352282474343384
ZCTA5 92283,548,29,519,0.05291970802919708,2.5340668539222353
ZCTA5 07030,25132,913,24219,0.03632818717173325,2.533693285219198
ZCTA5 30705,11765,443,11322,0.037654058648533786,2.5333120195073815
ZCTA5 67023,120,9,111,0.075,2.530931438485406
ZCTA5 69211,158,11,147,0.06962025316455696,2.528088159081717
ZCTA5 34769,8159,314,7845,0.03848510846917515,2.5271078077471705
ZCTA5 59929,102,8,94,0.0784313725490196,2.5261254080292055
ZCTA5 14865,1203,56,1147,0.046550290939318374,2.5260154732313334
ZCTA5 41083,480,26,454,0.05416666666666667,2.5235653385473253
ZCTA5 99926,480,26,454,0.05416666666666667,2.5235653385473253
ZCTA5 77380,11686,440,11246,0.03765189115180558,2.5234892804705424
ZCTA5 56518,139,10,129,0.07194244604316546,2.52346979499839
ZCTA5 39038,2125,92,2033,0.04329411764705882,2.522504211691178
ZCTA5 76630,390,22,368,0.05641025641025641,2.521110031241273
ZCTA5 49339,810,40,770,0.04938271604938271,2.5210393739401726
ZCTA5 96770,239,15,224,0.06276150627615062,2.519632893566465
ZCTA5 12434,346,20,326,0.057803468208092484,2.5187567649787703
ZCTA5 24314,667,34,633,0.050974512743628186,2.5163247840791763
ZCTA5 07073,3800,155,3645,0.04078947368421053,2.51459672731455
ZCTA5 63824,52,5,47,0.09615384615384616,2.5143722050794124
ZCTA5 56180,481,26,455,0.05405405405405406,2.5124578727296676
ZCTA5 96011,68,6,62,0.08823529411764706,2.5121635754420275
ZCTA5 99152,68,6,62,0.08823529411764706,2.5121635754420275
ZCTA5 54876,644,33,611,0.05124223602484472,2.5103419083558136
ZCTA5 68654,219,14,205,0.0639269406392694,2.5078180082652834
ZCTA5 75442,3292,136,3156,0.041312272174969626,2.5073002642863416
ZCTA5 79834,85,7,78,0.08235294117647059,2.5070895741219963
ZCTA5 98576,1869,82,1787,0.043873729266987696,2.5050352405021363
ZCTA5 76245,812,40,772,0.04926108374384237,2.504875039585236
ZCTA5 77047,9816,373,9443,0.03799918500407498,2.5041374370615332
ZCTA5 40337,1973,86,1887,0.04358844399391789,2.503317475967165
ZCTA5 28135,1715,76,1639,0.044314868804664724,2.5012079830680176
ZCTA5 43029,179,12,167,0.0670391061452514,2.4988095874683265
ZCTA5 52534,140,10,130,0.07142857142857142,2.4987177083511547
ZCTA5 62478,140,10,130,0.07142857142857142,2.4987177083511547
ZCTA5 27014,304,18,286,0.05921052631578947,2.4973707776849046
ZCTA5 25534,103,8,95,0.07766990291262135,2.495501345977711
ZCTA5 16936,741,37,704,0.04993252361673414,2.4945026996521236
ZCTA5 29824,2446,104,2342,0.04251839738348324,2.4929775253931847
ZCTA5 76208,8036,309,7727,0.03845196615231458,2.4914647913450993
ZCTA5 10922,599,31,568,0.05175292153589316,2.49055499169314
ZCTA5 38625,483,26,457,0.053830227743271224,2.490320158333988
ZCTA5 25434,985,47,938,0.047715736040609136,2.4891213130380456
ZCTA5 98043,8316,319,7997,0.03835978835978836,2.487752212539812
ZCTA5 39325,2500,106,2394,0.0424,2.487424686802907
ZCTA5 42724,1821,80,1741,0.043931905546403076,2.4864645051763574
ZCTA5 79752,839,41,798,0.04886769964243146,2.4828129037736884
ZCTA5 93516,986,47,939,0.04766734279918864,2.4819339297650598
ZCTA5 55405,7402,286,7116,0.03863820589029992,2.4802704524169727
ZCTA5 79031,507,27,480,0.05325443786982249,2.479342084331076
ZCTA5 25208,349,20,329,0.05730659025787966,2.4780317618410916
ZCTA5 54425,767,38,729,0.04954367666232073,2.478000646295603
ZCTA5 43843,416,23,393,0.055288461538461536,2.4765513604475173
ZCTA5 19936,122,9,113,0.07377049180327869,2.476413203669807
ZCTA5 93463,3247,134,3113,0.041268863566368955,2.4763489054275465
ZCTA5 72117,5035,200,4835,0.039721946375372394,2.4732662976833217
ZCTA5 79733,69,6,63,0.08695652173913043,2.4714960502735686
ZCTA5 30735,2241,96,2145,0.0428380187416332,2.470366571134197
ZCTA5 18831,531,28,503,0.05273069679849341,2.470230083718858
ZCTA5 60073,18806,690,18116,0.036690417951717534,2.467984926788059
ZCTA5 76085,3572,146,3426,0.040873460246360585,2.465906405295671
ZCTA5 93605,53,5,48,0.09433962264150944,2.464983718997223
ZCTA5 28338,1981,86,1895,0.04341241797072186,2.4648180226933207
ZCTA5 74106,7187,278,6909,0.03868095171838041,2.4641363752033865
ZCTA5 80205,14516,539,13977,0.03713144116836594,2.46378559698028
ZCTA5 32767,1063,50,1013,0.047036688617121354,2.4626775498321494
ZCTA5 62841,38,4,34,0.10526315789473684,2.461689489238069
ZCTA5 99691,38,4,34,0.10526315789473684,2.461689489238069
ZCTA5 83271,161,11,150,0.06832298136645963,2.460436947568084
ZCTA5 96084,161,11,150,0.06832298136645963,2.460436947568084
ZCTA5 76653,440,24,416,0.05454545454545454,2.4603159518801974
ZCTA5 43211,8443,323,8120,0.03825654388250622,2.453919627646871
ZCTA5 31028,2508,106,2402,0.04226475279106858,2.4537348911515595
ZCTA5 14754,264,16,248,0.06060606060606061,2.4533748940227795
ZCTA5 47018,1570,70,1500,0.044585987261146494,2.452877988968028
ZCTA5 87123,17081,629,16452,0.036824541888648206,2.4495561124955323
ZCTA5 26405,441,24,417,0.05442176870748299,2.4486656819085235
ZCTA5 73005,3255,134,3121,0.041167434715821814,2.447216613331396
ZCTA5 72927,3148,130,3018,0.041296060991105464,2.446791231599292
ZCTA5 28133,893,43,850,0.048152295632698766,2.442578259552927
ZCTA5 95531,8337,319,8018,0.03826316420774859,2.4418283735542166
ZCTA5 36863,4774,190,4584,0.0397989107666527,2.437882699709466
ZCTA5 37020,2013,87,1926,0.043219076005961254,2.4364055090217884
ZCTA5 74136,13884,516,13368,0.037165082108902334,2.431598302289457
ZCTA5 96019,3744,152,3592,0.0405982905982906,2.4309443708350233
ZCTA5 80017,12839,479,12360,0.03730820157333126,2.4284830302914333
ZCTA5 12824,443,24,419,0.05417607223476298,2.425453582824252
ZCTA5 27253,12615,471,12144,0.03733650416171225,2.4248831263301156
ZCTA5 54476,7621,293,7328,0.03844639811048419,2.423576017872507
ZCTA5 31601,11572,434,11138,0.03750432077428275,2.422869605641586
ZCTA5 62439,3235,133,3102,0.04111282843894899,2.4224146891721374
ZCTA5 38650,1397,63,1334,0.04509663564781675,2.4199330754889963
ZCTA5 46528,8375,320,8055,0.0382089552238806,2.4197985473299215
ZCTA5 57440,163,11,152,0.06748466257668712,2.4161515545395043
ZCTA5 57601,1654,73,1581,0.044135429262394194,2.415739664739404
ZCTA5 07012,4645,185,4460,0.03982777179763186,2.41565843176724
ZCTA5 16638,13,2,11,0.15384615384615385,2.41397133167957
ZCTA5 98828,848,41,807,0.04834905660377359,2.4121036229802364
ZCTA5 15762,354,20,334,0.05649717514124294,2.4110288076710513
ZCTA5 99624,25,3,22,0.12,2.406461404473488
ZCTA5 67041,106,8,98,0.07547169811320754,2.405723768663353
ZCTA5 83427,561,29,532,0.05169340463458111,2.402422013872861
ZCTA5 74472,246,15,231,0.06097560975609756,2.400493854611974
ZCTA5 98541,3889,157,3732,0.04037027513499614,2.3984944759541253
ZCTA5 36539,289,17,272,0.058823529411764705,2.3983922462796397
ZCTA5 57077,538,28,510,0.05204460966542751,2.397960872119926
ZCTA5 28214,14018,520,13498,0.03709516336139249,2.397268049198162
ZCTA5 58562,184,12,172,0.06521739130434782,2.3960480015783
ZCTA5 75943,515,27,488,0.05242718446601942,2.3944252481097066
ZCTA5 13803,1504,67,1437,0.04454787234042553,2.392546944827169
ZCTA5 50231,71,6,65,0.08450704225352113,2.3922789964632503
ZCTA5 59472,268,16,252,0.05970149253731343,2.389539639920691
ZCTA5 98336,356,20,336,0.056179775280898875,2.384526147376885
ZCTA5 27343,634,32,602,0.050473186119873815,2.383088664933574
ZCTA5 74964,1000,47,953,0.047,2.382134199120507
ZCTA5 49310,1100,51,1049,0.046363636363636364,2.38103133373993
ZCTA5 36322,3463,141,3322,0.04071614207334681,2.3765076792485993
ZCTA5 32730,2500,105,2395,0.042,2.376202061246557
ZCTA5 37095,927,44,883,0.04746494066882417,2.3722616013675784
ZCTA5 63870,357,20,337,0.056022408963585436,2.3713376682015537
ZCTA5 65081,1152,53,1099,0.04600694444444445,2.369334436972123
ZCTA5 70762,425,23,402,0.05411764705882353,2.3689688325188056
ZCTA5 28778,3898,157,3741,0.04027706516162134,2.368905366817167
ZCTA5 35614,2743,114,2629,0.041560335399197956,2.360952560116689
ZCTA5 31606,1204,55,1149,0.04568106312292359,2.3593354228290653
ZCTA5 72354,929,44,885,0.04736275565123789,2.3574988841626348
ZCTA5 39159,1306,59,1247,0.0451761102603369,2.3557613896309144
ZCTA5 08103,4720,187,4533,0.03961864406779661,2.355182610996738
ZCTA5 65770,1230,56,1174,0.04552845528455285,2.3549098256846692
ZCTA5 99150,146,10,136,0.0684931506849315,2.3544531621917564
ZCTA5 56637,72,6,66,0.08333333333333333,2.3536824260906895
ZCTA5 92203,11751,439,11312,0.037358522678920945,2.353643999593114
ZCTA5 35580,1383,62,1321,0.04483007953723789,2.3526500818784806
ZCTA5 56384,166,11,155,0.06626506024096386,2.3508999948564075
ZCTA5 75976,249,15,234,0.060240963855421686,2.3506191491894266
ZCTA5 21915,1130,52,1078,0.04601769911504425,2.348612005527357
ZCTA5 53540,108,8,100,0.07407407407407407,2.3475403735312863
ZCTA5 62201,2587,108,2479,0.041747197526091996,2.3456883613037416
ZCTA5 97869,359,20,339,0.055710306406685235,2.3450850475084524
ZCTA5 33781,10179,383,9796,0.03762648590234797,2.340909520324678
ZCTA5 95715,40,4,36,0.1,2.3405260075653347
ZCTA5 99546,40,4,36,0.1,2.3405260075653347
ZCTA5 29385,2775,115,2660,0.04144144144144144,2.3398540576600055
ZCTA5 78569,1233,56,1177,0.0454176804541768,2.3361484606121112
ZCTA5 17084,1721,75,1646,0.04357931435212086,2.3358847020045506
ZCTA5 74936,405,22,383,0.05432098765432099,2.335313706684729
ZCTA5 36541,5112,201,4911,0.03931924882629108,2.3319892680390897
ZCTA5 29832,2009,86,1923,0.0428073668491787,2.3313608856889925
ZCTA5 62891,229,14,215,0.0611353711790393,2.3295099789158606
ZCTA5 12583,933,44,889,0.04715969989281887,2.3280767084692098
ZCTA5 91916,664,33,631,0.04969879518072289,2.3278487590728147
ZCTA5 74337,1905,82,1823,0.04304461942257218,2.3278018192016967
ZCTA5 45326,338,19,319,0.05621301775147929,2.3268599992383434
ZCTA5 85332,737,36,701,0.048846675712347354,2.323827976064313
ZCTA5 28089,26,3,23,0.11538461538461539,2.3232434232394463
ZCTA5 99665,26,3,23,0.11538461538461539,2.3232434232394463
ZCTA5 44310,10301,387,9914,0.037569168041937676,2.3225447950138602
ZCTA5 89048,8869,336,8533,0.037884767166535126,2.320357818846384
ZCTA5 59489,128,9,119,0.0703125,2.319011226951466
ZCTA5 27939,1009,47,962,0.04658077304261645,2.3187741873021883
ZCTA5 04408,73,6,67,0.0821917808219178,2.315730981435947
ZCTA5 93921,1674,73,1601,0.04360812425328554,2.3103228986239026
ZCTA5 95490,5340,209,5131,0.03913857677902622,2.3100046916059296
ZCTA5 25428,4708,186,4522,0.0395072217502124,2.309670715579453
ZCTA5 87072,168,11,157,0.06547619047619048,2.308157514529979
ZCTA5 28580,4135,165,3970,0.03990326481257558,2.306185952253504
ZCTA5 96760,1061,49,1012,0.046182846371347785,2.3056924445032183
ZCTA5 29805,2305,97,2208,0.0420824295010846,2.303657002965656
ZCTA5 63071,385,21,364,0.05454545454545454,2.3014148387875757
ZCTA5 70354,1806,78,1728,0.04318936877076412,2.3007175408808576
ZCTA5 74075,10454,392,10062,0.03749760857088196,2.299041028654541
ZCTA5 33839,1037,48,989,0.04628736740597879,2.298183567045089
ZCTA5 54446,1138,52,1086,0.04569420035149385,2.296222443873197
ZCTA5 18473,231,14,217,0.06060606060606061,2.294922073686517
ZCTA5 64870,5732,223,5509,0.03890439637124913,2.2946922868988957
ZCTA5 59089,129,9,120,0.06976744186046512,2.2936251096941604
ZCTA5 52552,363,20,343,0.05509641873278237,2.293069677784115
ZCTA5 72668,110,8,102,0.07272727272727272,2.290624101396607
ZCTA5 72937,1368,61,1307,0.0445906432748538,2.290608039506715
ZCTA5 35967,6177,239,5938,0.038691921644811396,2.2892344365933934
ZCTA5 60433,5431,212,5219,0.03903516847726017,2.2872244126778996
ZCTA5 61735,169,11,158,0.0650887573964497,2.287007477927486
ZCTA5 22701,12072,449,11623,0.03719350563286945,2.284746352007267
ZCTA5 46166,742,36,706,0.04851752021563342,2.2818357786243957
ZCTA5 26273,275,16,259,0.05818181818181818,2.280399376686306
ZCTA5 22713,526,27,499,0.051330798479087454,2.2800255100053963
ZCTA5 34286,6264,242,6022,0.03863346104725415,2.2795686970133224
ZCTA5 70049,718,35,683,0.04874651810584958,2.2787531990406222
ZCTA5 75101,190,12,178,0.06315789473684211,2.2769301047926183
ZCTA5 97122,190,12,178,0.06315789473684211,2.2769301047926183
ZCTA5 25168,940,44,896,0.04680851063829787,2.2769156564937085
ZCTA5 79034,211,13,198,0.061611374407582936,2.274535317421676
ZCTA5 95589,503,26,477,0.05168986083499006,2.274403267697124
ZCTA5 56630,842,40,802,0.047505938242280284,2.267502209114377
ZCTA5 62618,2847,117,2730,0.0410958904109589,2.267480261377211
ZCTA5 66740,170,11,159,0.06470588235294118,2.266002181266492
ZCTA5 46171,671,33,638,0.04918032786885246,2.265399743840042
ZCTA5 45711,388,21,367,0.05412371134020619,2.2641655724785434
ZCTA5 81325,111,8,103,0.07207207207207207,2.2626241655737367
ZCTA5 43128,992,46,946,0.046370967741935484,2.26240928558543
ZCTA5 58763,1169,53,1116,0.045337895637296836,2.2595404453150065
ZCTA5 70710,1684,73,1611,0.04334916864608076,2.25811703596481
ZCTA5 98520,8310,315,7995,0.03790613718411552,2.2568769070678965
ZCTA5 38620,1246,56,1190,0.0449438202247191,2.255412467901345
ZCTA5 39328,1894,81,1813,0.04276663146779303,2.2537924658932496
ZCTA5 74738,255,15,240,0.058823529411764705,2.2528972262558797
ZCTA5 30236,16186,593,15593,0.03663659953045842,2.25154630024374
ZCTA5 31805,1019,47,972,0.04612365063788027,2.2490873939122413
ZCTA5 13680,482,25,457,0.05186721991701245,2.2480735987797282
ZCTA5 99549,27,3,24,0.1111111111111111,2.2440104001812404
ZCTA5 06418,5061,198,4863,0.03912270302311796,2.242569532029743
ZCTA5 72567,93,7,86,0.07526881720430108,2.242498877599265
ZCTA5 66801,11559,430,11129,0.03720044986590536,2.23982608608444
ZCTA5 27317,6558,252,6306,0.0384263494967978,2.239178527609461
ZCTA5 94519,6949,266,6683,0.038278889048784,2.236604472687834
ZCTA5 31798,278,16,262,0.05755395683453238,2.2345872501442803
ZCTA5 41063,1224,55,1169,0.04493464052287582,2.2336264420885343
ZCTA5 43310,1097,50,1047,0.04557885141294439,2.2332325784442593
ZCTA5 77351,12016,446,11570,0.037117177097203725,2.2329112359411165
ZCTA5 78648,2964,121,2843,0.04082321187584345,2.231046360197075
ZCTA5 27405,18803,684,18119,0.03637717385523587,2.2289191650132882
ZCTA5 38425,773,37,736,0.047865459249676584,2.228195731592986
ZCTA5 97416,391,21,370,0.05370843989769821,2.2272369213980157
ZCTA5 83401,14036,517,13519,0.03683385579937304,2.226644873325604
ZCTA5 94963,172,11,161,0.06395348837209303,2.2244178643544656
ZCTA5 08542,1769,76,1693,0.04296212549462974,2.2238760584826394
ZCTA5 97227,2350,98,2252,0.04170212765957447,2.223511208546765
ZCTA5 77857,301,17,284,0.05647840531561462,2.221417114956564
ZCTA5 87016,1099,50,1049,0.04549590536851683,2.2199756478783157
ZCTA5 90746,8159,309,7850,0.0378722882706214,2.219275154869474
ZCTA5 74945,152,10,142,0.06578947368421052,2.2169751215292637
ZCTA5 01260,152,10,142,0.06578947368421052,2.2169751215292637
ZCTA5 75661,1049,48,1001,0.04575786463298379,2.2160708148770043
ZCTA5 01339,580,29,551,0.05,2.2159686863035803
ZCTA5 71052,3591,144,3447,0.040100250626566414,2.2147834528061154
ZCTA5 94121,17641,643,16998,0.03644918088543733,2.2121350955174512
ZCTA5 61068,5708,221,5487,0.038717589348283114,2.2113961779073787
ZCTA5 46222,11859,440,11419,0.03710262248081626,2.2094614589306083
ZCTA5 47522,113,8,105,0.07079646017699115,2.207508556310072
ZCTA5 29686,347,19,328,0.05475504322766571,2.206600308169966
ZCTA5 23860,10898,406,10492,0.03725454211781978,2.2062443173151447
ZCTA5 28372,4551,179,4372,0.03933201494177104,2.205102731133929
ZCTA5 32320,1512,66,1446,0.04365079365079365,2.204916021985768
ZCTA5 13637,1721,74,1647,0.04299825682742592,2.201832882800514
ZCTA5 97114,1487,65,1422,0.04371217215870881,2.199773967135841
ZCTA5 72645,851,40,811,0.04700352526439483,2.198082628488608
ZCTA5 86329,440,23,417,0.05227272727272727,2.19519942051607
ZCTA5 50591,153,10,143,0.06535947712418301,2.194677504392706
ZCTA5 26505,14882,546,14336,0.036688617121354655,2.194235302664881
ZCTA5 64856,1514,66,1448,0.043593130779392336,2.193896468086895
ZCTA5 39356,237,14,223,0.05907172995780591,2.193177270862356
ZCTA5 39364,977,45,932,0.04605936540429888,2.1910751717055463
ZCTA5 64849,59,5,54,0.0847457627118644,2.190961097124933
ZCTA5 88321,59,5,54,0.0847457627118644,2.190961097124933
ZCTA5 84774,511,26,485,0.050880626223091974,2.1906888581658523
ZCTA5 50449,326,18,308,0.05521472392638037,2.1849439974622693
ZCTA5 68723,216,13,203,0.06018518518518518,2.1847622658592862
ZCTA5 57748,114,8,106,0.07017543859649122,2.1803806073597887
ZCTA5 19358,260,15,245,0.057692307692307696,2.173439960994399
ZCTA5 62094,442,23,419,0.05203619909502263,2.1725289038848485
ZCTA5 58324,633,31,602,0.04897314375987362,2.1713297383901295
ZCTA5 66701,4838,189,4649,0.03906572964034725,2.1705686247272786
ZCTA5 97739,4838,189,4649,0.03906572964034725,2.1705686247272786
ZCTA5 60104,6224,239,5985,0.03839974293059126,2.169739431408534
ZCTA5 97827,1056,48,1008,0.045454545454545456,2.1686380259721174
ZCTA5 38108,6421,246,6175,0.038311789440897054,2.1646160575059037
ZCTA5 64750,175,11,164,0.06285714285714286,2.1630783104012097
ZCTA5 64847,175,11,164,0.06285714285714286,2.1630783104012097
ZCTA5 28667,196,12,184,0.061224489795918366,2.162075338207351
ZCTA5 37886,1729,74,1655,0.042799305957200696,2.1609393618287163
ZCTA5 95446,2418,100,2318,0.0413564929693962,2.1609350312089415
ZCTA5 64053,2125,89,2036,0.04188235294117647,2.1605905854651968
ZCTA5 46543,881,41,840,0.046538024971623154,2.159654055005198
ZCTA5 88020,261,15,246,0.05747126436781609,2.157756485208562
ZCTA5 96058,261,15,246,0.05747126436781609,2.157756485208562
ZCTA5 65608,3499,140,3359,0.04001143183766791,2.157011143651451
ZCTA5 43771,659,32,627,0.048558421851289835,2.156268266585193
ZCTA5 27371,3255,131,3124,0.040245775729646695,2.154795379275795
ZCTA5 17847,4816,188,4628,0.03903654485049834,2.1543646215546692
ZCTA5 62426,351,19,332,0.05413105413105413,2.154269996630299
ZCTA5 37374,907,42,865,0.04630650496141125,2.1525147949429146
ZCTA5 79344,15,2,13,0.13333333333333333,2.151212572897485
ZCTA5 11978,1263,56,1207,0.04433887569279493,2.151187904439656
ZCTA5 52754,611,30,581,0.049099836333878884,2.1506790955905033
ZCTA5 81030,60,5,55,0.08333333333333333,2.148608263288928
ZCTA5 92536,1059,48,1011,0.0453257790368272,2.1484131907261546
ZCTA5 35579,1367,60,1307,0.043891733723482075,2.1460668336412168
ZCTA5 38951,492,25,467,0.0508130081300813,2.1412351636836835
ZCTA5 73481,375,20,355,0.05333333333333334,2.140795334463256
ZCTA5 74948,4298,169,4129,0.03932061423918101,2.138776607673556
ZCTA5 02743,4051,160,3891,0.03949642063687978,2.138638109750343
ZCTA5 75785,3314,133,3181,0.040132770066385035,2.1380589570079356
ZCTA5 04924,909,42,867,0.0462046204620462,2.1378041429628563
ZCTA5 80249,9492,355,9137,0.037399915718499786,2.1377768608856744
ZCTA5 74881,1839,78,1761,0.04241435562805873,2.136816225783667
ZCTA5 17747,1061,48,1013,0.04524033930254477,2.1349641683226803
ZCTA5 93251,78,6,72,0.07692307692307693,2.1349532784801757
ZCTA5 62423,219,13,206,0.0593607305936073,2.132031581204504
ZCTA5 79351,493,25,468,0.05070993914807302,2.1306834466381463
ZCTA5 13788,399,21,378,0.05263157894736842,2.1302850891928014
ZCTA5 88130,6463,247,6216,0.03821754603125484,2.1295500787861554
ZCTA5 13501,14238,522,13716,0.03666245259165613,2.1288718273319165
ZCTA5 92590,1552,67,1485,0.043170103092783504,2.128579985344014
ZCTA5 25979,353,19,334,0.053824362606232294,2.128354390272324
ZCTA5 40118,3562,142,3420,0.03986524424480629,2.127823180648378
ZCTA5 75164,263,15,248,0.057034220532319393,2.1265925666968712
ZCTA5 56139,177,11,166,0.062146892655367235,2.1228550431577005
ZCTA5 46403,5798,223,5575,0.038461538461538464,2.1203371381068608
ZCTA5 46404,6802,259,6543,0.03807703616583358,2.120241481251786
ZCTA5 84080,97,7,90,0.07216494845360824,2.1202156166681836
ZCTA5 12770,97,7,90,0.07216494845360824,2.1202156166681836
ZCTA5 37032,1606,69,1537,0.04296388542963885,2.1193359990608065
ZCTA5 41219,762,36,726,0.047244094488188976,2.1168984354400893
ZCTA5 91316,12252,452,11800,0.036891936010447275,2.116084129937904
ZCTA5 71462,664,32,632,0.04819277108433735,2.112035010832815
ZCTA5 12842,264,15,249,0.056818181818181816,2.111110923763599
ZCTA5 42123,242,14,228,0.05785123966942149,2.1106055903830074
ZCTA5 12953,4859,189,4670,0.03889689236468409,2.1098250596895545
ZCTA5 25984,567,28,539,0.04938271604938271,2.109252869494234
ZCTA5 86337,567,28,539,0.04938271604938271,2.109252869494234
ZCTA5 85145,1014,46,968,0.045364891518737675,2.1091977631377725
ZCTA5 08832,1014,46,968,0.045364891518737675,2.1091977631377725
ZCTA5 94025,14964,547,14417,0.03655439721999466,2.108965163800035
ZCTA5 65706,5858,225,5633,0.03840901331512461,2.1089233786875186
ZCTA5 39176,763,36,727,0.047182175622542594,2.1087755342241223
ZCTA5 01542,788,37,751,0.046954314720812185,2.107473524636644
ZCTA5 76116,21506,775,20731,0.03603645494280666,2.105880801124009
ZCTA5 54112,1040,47,993,0.04519230769230769,2.1051162352943114
ZCTA5 83549,332,18,314,0.05421686746987952,2.103847737678448
ZCTA5 85925,1714,73,1641,0.042590431738623105,2.1034554433952177
ZCTA5 38916,2058,86,1972,0.04178814382896016,2.102489471550948
ZCTA5 95366,5944,228,5716,0.03835800807537012,2.102478877870701
ZCTA5 30566,2647,108,2539,0.04080090668681526,2.1019864000443595
ZCTA5 76371,544,27,517,0.04963235294117647,2.0984093324079534
ZCTA5 31003,29,3,26,0.10344827586206896,2.096153699444594
ZCTA5 58262,29,3,26,0.10344827586206896,2.096153699444594
ZCTA5 30337,5585,215,5370,0.03849597135183527,2.095335789826845
ZCTA5 75477,402,21,381,0.05223880597014925,2.0944843636382995
ZCTA5 38023,1901,80,1821,0.04208311415044713,2.092222508725737
ZCTA5 18463,98,7,91,0.07142857142857142,2.090577224170241
ZCTA5 47031,2114,88,2026,0.041627246925260174,2.0897628710887366
ZCTA5 88135,497,25,472,0.05030181086519115,2.0887111850931177
ZCTA5 05069,200,12,188,0.06,2.087724345931573
ZCTA5 79018,158,10,148,0.06329113924050633,2.085668309449196
ZCTA5 27028,9803,365,9438,0.037233499948995205,2.0808862430294988
ZCTA5 46235,11817,436,11381,0.036895997292036894,2.0806346477398225
ZCTA5 52651,266,15,251,0.05639097744360902,2.08034532757426
ZCTA5 13303,427,22,405,0.05152224824355972,2.076285830091085
ZCTA5 98851,1746,74,1672,0.042382588774341354,2.0747031158496254
ZCTA5 67336,693,33,660,0.047619047619047616,2.0736724524729513
ZCTA5 94130,595,29,566,0.04873949579831933,2.073452427310928
ZCTA5 43150,818,38,780,0.04645476772616137,2.067761612898474
ZCTA5 28016,4846,188,4658,0.03879488237721832,2.067509859343633
ZCTA5 46111,80,6,74,0.075,2.0664968660858256
ZCTA5 59916,80,6,74,0.075,2.0664968660858256
ZCTA5 99630,80,6,74,0.075,2.0664968660858256
ZCTA5 48852,62,5,57,0.08064516129032258,2.0664141258099153
ZCTA5 10931,312,17,295,0.05448717948717949,2.0660471265527627
ZCTA5 48437,267,15,252,0.056179775280898875,2.065060219616619
ZCTA5 66735,159,10,149,0.06289308176100629,2.064345052003297
ZCTA5 99568,159,10,149,0.06289308176100629,2.064345052003297
ZCTA5 31090,335,18,317,0.05373134328358209,2.0639124167213696
ZCTA5 78119,1854,78,1776,0.042071197411003236,2.0633432774625464
ZCTA5 47859,290,16,274,0.05517241379310345,2.05676779443882
ZCTA5 75407,5516,212,5304,0.03843364757070341,2.056610911770551
ZCTA5 00728,13284,487,12797,0.03666064438422162,2.0551551223333413
ZCTA5 23513,11547,426,11121,0.03689269940244219,2.054756912331684
ZCTA5 07605,3338,133,3205,0.03984421809466747,2.0530760995041932
ZCTA5 56636,1989,83,1906,0.04172951231774761,2.052401589255233
ZCTA5 84631,1048,47,1001,0.04484732824427481,2.0510908316701326
ZCTA5 49886,246,14,232,0.056910569105691054,2.045929074509512
ZCTA5 64659,383,20,363,0.05221932114882506,2.042268151369515
ZCTA5 15848,383,20,363,0.05221932114882506,2.042268151369515
ZCTA5 07024,17013,617,16396,0.03626638452947746,2.0398103520439004
ZCTA5 82325,454,23,431,0.05066079295154185,2.0388473592204184
ZCTA5 81141,478,24,454,0.0502092050209205,2.037137665527325
ZCTA5 57380,1127,50,1077,0.044365572315882874,2.0370538788211636
ZCTA5 89415,1412,61,1351,0.04320113314447592,2.036790139854558
ZCTA5 72013,797,37,760,0.04642409033877039,2.0362305997329013
ZCTA5 35776,1334,58,1276,0.043478260869565216,2.0360227158372206
ZCTA5 72327,723,34,689,0.04702627939142462,2.0294441690383938
ZCTA5 05081,225,13,212,0.057777777777777775,2.02899502079078
ZCTA5 19111,23930,857,23073,0.03581278729628082,2.0289781227218997
ZCTA5 77316,7993,300,7693,0.03753284123608157,2.0278148753093843
ZCTA5 36017,649,31,618,0.04776579352850539,2.02755195305726
ZCTA5 95374,527,26,501,0.04933586337760911,2.027510406517056
ZCTA5 72107,63,5,58,0.07936507936507936,2.0265091378626074
ZCTA5 64479,361,19,342,0.05263157894736842,2.02630530139283
ZCTA5 55912,11365,419,10946,0.036867575890893095,2.023604818426586
ZCTA5 95554,120,8,112,0.06666666666666667,2.0232719308007088
ZCTA5 43986,849,39,810,0.045936395759717315,2.0225825905334167
ZCTA5 37324,2236,92,2144,0.04114490161001789,2.0223774847141986
ZCTA5 59728,161,10,151,0.062111801242236024,2.02215840451711
ZCTA5 38858,2559,104,2455,0.04064087534193044,2.0217308305233765
ZCTA5 95624,19612,707,18905,0.03604935753620232,2.021061629882673
ZCTA5 30730,774,36,738,0.046511627906976744,2.0201779329731218
ZCTA5 95451,4724,183,4541,0.03873835732430144,2.0197135307168144
ZCTA5 33843,3457,137,3320,0.03962973676598207,2.019222040423887
ZCTA5 24442,46,4,42,0.08695652173913043,2.017968074824748
ZCTA5 71202,8703,325,8378,0.03734344478915316,2.017703775719748
ZCTA5 47038,601,29,572,0.048252911813643926,2.017543224276843
ZCTA5 83314,362,19,343,0.052486187845303865,2.0137263738201328
ZCTA5 60930,339,18,321,0.05309734513274336,2.011281832374006
ZCTA5 62999,602,29,573,0.04817275747508306,2.008284261595268
ZCTA5 38769,701,33,668,0.047075606276747506,2.005591726216251
ZCTA5 78385,183,11,172,0.060109289617486336,2.005247737857637
ZCTA5 89010,183,11,172,0.060109289617486336,2.005247737857637
ZCTA5 84002,101,7,94,0.06930693069306931,2.003758950570253
ZCTA5 25044,101,7,94,0.06930693069306931,2.003758950570253
ZCTA5 29906,8569,320,8249,0.037343914108997546,2.0023518376391083
ZCTA5 62906,2564,104,2460,0.0405616224648986,2.0013879137446082
ZCTA5 72083,82,6,76,0.07317073170731707,2.0000499868602155
ZCTA5 74363,1030,46,984,0.04466019417475728,2.0000011223221925
ZCTA5 86413,5231,201,5030,0.038424775377556876,1.9992074405671125
ZCTA5 80735,121,8,113,0.06611570247933884,1.9979809142625629
ZCTA5 51232,317,17,300,0.05362776025236593,1.9974424057395328
ZCTA5 65638,205,12,193,0.05853658536585366,1.997137927380198
ZCTA5 13074,1577,67,1510,0.0424857324032974,1.9945184830788563
ZCTA5 92315,2216,91,2125,0.041064981949458484,1.992390620999389
ZCTA5 00773,6519,247,6272,0.03788924681699647,1.9913473194782236
ZCTA5 89445,6016,229,5787,0.038065159574468085,1.9888577749813783
ZCTA5 18814,64,5,59,0.078125,1.9873592690887123
ZCTA5 32648,184,11,173,0.059782608695652176,1.9860759645605015
ZCTA5 98552,184,11,173,0.059782608695652176,1.9860759645605015
ZCTA5 13635,435,22,413,0.05057471264367816,1.9857441353911305
ZCTA5 62897,142,9,133,0.06338028169014084,1.9831540919630937
ZCTA5 78339,163,10,153,0.06134969325153374,1.980570135828959
ZCTA5 95469,779,36,743,0.04621309370988447,1.9803557594545995
ZCTA5 67124,3113,124,2989,0.03983295856087375,1.9791809938756517
ZCTA5 10465,15994,580,15414,0.03626359884956859,1.9758203960993783
ZCTA5 45384,102,7,95,0.06862745098039216,1.9754913609390308
ZCTA5 56516,102,7,95,0.06862745098039216,1.9754913609390308
ZCTA5 25523,1163,51,1112,0.043852106620808254,1.9719543468314966
ZCTA5 66869,296,16,280,0.05405405405405406,1.9709341107889835
ZCTA5 26218,1060,47,1013,0.04433962264150943,1.970876479921046
ZCTA5 47964,47,4,43,0.0851063829787234,1.9692476784988997
ZCTA5 10552,8359,312,8047,0.03732503888024884,1.9680669464363394
ZCTA5 67544,1112,49,1063,0.044064748201438846,1.9676658286986257
ZCTA5 40865,185,11,174,0.05945945945945946,1.9670227301364245
ZCTA5 94567,251,14,237,0.055776892430278883,1.9667339890979223
ZCTA5 27291,656,31,625,0.04725609756097561,1.9658587676277954
ZCTA5 28032,1164,51,1113,0.04381443298969072,1.9656540746471465
ZCTA5 39338,1294,56,1238,0.04327666151468315,1.9649361347021375
ZCTA5 59758,781,36,745,0.046094750320102434,1.9645041495428357
ZCTA5 37723,366,19,347,0.05191256830601093,1.9637935812996714
ZCTA5 57751,366,19,347,0.05191256830601093,1.9637935812996714
ZCTA5 22639,229,13,216,0.056768558951965066,1.9620200801204213
ZCTA5 62316,207,12,195,0.057971014492753624,1.9616046700024419
ZCTA5 67849,143,9,134,0.06293706293706294,1.960650084877649
ZCTA5 99625,31,3,28,0.0967741935483871,1.9605797724813425
ZCTA5 20785,13999,510,13489,0.03643117365526109,1.9587519678098064
ZCTA5 48607,682,32,650,0.0469208211143695,1.9557457015269413
ZCTA5 74130,732,34,698,0.04644808743169399,1.9550422101485276
ZCTA5 27501,7293,274,7019,0.03757027286439051,1.9547629597420904
ZCTA5 31779,3120,124,2996,0.03974358974358974,1.9536445249421726
ZCTA5 69360,559,27,532,0.04830053667262969,1.9520319083608524
ZCTA5 71969,123,8,115,0.06504065040650407,1.9481206431731293
ZCTA5 17271,103,7,96,0.06796116504854369,1.9475467992028301
ZCTA5 49274,1297,56,1241,0.04317656129529684,1.947164696093701
ZCTA5 77048,5753,219,5534,0.0380670954284721,1.945715315807854
ZCTA5 76458,2012,83,1929,0.04125248508946322,1.945241360402759
ZCTA5 69167,165,10,155,0.06060606060606061,1.9395631548465502
ZCTA5 87728,165,10,155,0.06060606060606061,1.9395631548465502
ZCTA5 42411,684,32,652,0.04678362573099415,1.9386572310883816
ZCTA5 07643,4308,167,4141,0.038765088207985146,1.9384924716184235
ZCTA5 78244,9422,349,9073,0.03704096794735725,1.9361187985578592
ZCTA5 61778,253,14,239,0.05533596837944664,1.9355520071944377
ZCTA5 98356,886,40,846,0.045146726862302484,1.9354704786840582
ZCTA5 84111,6571,248,6323,0.03774159184294628,1.932711626061135
ZCTA5 05262,912,41,871,0.044956140350877194,1.9316561184974266
ZCTA5 47916,17,2,15,0.11764705882352941,1.9304680129083
ZCTA5 70632,187,11,176,0.058823529411764705,1.929265923139089
ZCTA5 77879,2096,86,2010,0.04103053435114504,1.928923880396263
ZCTA5 73015,1067,47,1020,0.044048734770384255,1.9245323895851725
ZCTA5 36048,513,25,488,0.04873294346978557,1.9244563553314635
ZCTA5 32439,3953,154,3799,0.03895775360485707,1.924269343421848
ZCTA5 76566,124,8,116,0.06451612903225806,1.923542219436765
ZCTA5 75855,1093,48,1045,0.04391582799634035,1.9234037236031902
ZCTA5 12501,990,44,946,0.044444444444444446,1.923030385392783
ZCTA5 04958,736,34,702,0.04619565217391304,1.9222917440320078
ZCTA5 47837,489,24,465,0.049079754601226995,1.9215498071301542
ZCTA5 24147,489,24,465,0.049079754601226995,1.9215498071301542
ZCTA5 70356,812,37,775,0.04556650246305419,1.919402692488989
ZCTA5 73944,166,10,156,0.060240963855421686,1.9192724983764071
ZCTA5 65723,1328,57,1271,0.04292168674698795,1.9186450025500412
ZCTA5 25270,323,17,306,0.05263157894736842,1.9166929299364035
ZCTA5 37049,1355,58,1297,0.042804428044280446,1.9140474756557226
ZCTA5 20910,20180,724,19456,0.03587710604558969,1.9140419666515656
ZCTA5 48050,563,27,536,0.047957371225577264,1.9137219634312495
ZCTA5 22603,5683,216,5467,0.03800809431638219,1.9091067640106378
ZCTA5 29201,8049,300,7749,0.03727171077152441,1.904621873723122
ZCTA5 14218,7823,292,7531,0.037325834078997824,1.9043140885630472
ZCTA5 05055,1252,54,1198,0.04313099041533546,1.9041205135776107
ZCTA5 50431,85,6,79,0.07058823529411765,1.903900197078695
ZCTA5 79082,85,6,79,0.07058823529411765,1.903900197078695
ZCTA5 26755,324,17,307,0.05246913580246913,1.9033970361797061
ZCTA5 77563,4015,156,3859,0.038854296388542965,1.9028452254599248
ZCTA5 73026,3988,155,3833,0.038866599799398195,1.9007571436830693
ZCTA5 98385,125,8,117,0.064,1.8991923663122687
ZCTA5 64779,968,43,925,0.04442148760330578,1.897571303994472
ZCTA5 74458,32,3,29,0.09375,1.8968144205282416
ZCTA5 33043,2023,83,1940,0.04102817597627286,1.894445788912361
ZCTA5 27809,1889,78,1811,0.04129168872419269,1.8943198956137142
ZCTA5 62975,146,9,137,0.06164383561643835,1.8942106629104971
ZCTA5 83869,1916,79,1837,0.04123173277661795,1.8932152492452323
ZCTA5 47465,189,11,178,0.0582010582010582,1.891965675753002
ZCTA5 56252,492,24,468,0.04878048780487805,1.8905200033033163
ZCTA5 23128,372,19,353,0.051075268817204304,1.890016728780467
ZCTA5 85363,2456,99,2357,0.04030944625407166,1.8892840674480058
ZCTA5 60958,715,33,682,0.046153846153846156,1.8884526542432143
ZCTA5 50641,566,27,539,0.04770318021201413,1.8851835525182117
ZCTA5 92285,1022,45,977,0.04403131115459882,1.880414698276743
ZCTA5 99652,1230,53,1177,0.043089430894308944,1.8792112552428475
ZCTA5 38560,469,23,446,0.04904051172707889,1.8771179014201747
ZCTA5 93255,326,17,309,0.05214723926380368,1.8769414225331855
ZCTA5 71101,2786,111,2675,0.03984206748025843,1.8750214740847675
ZCTA5 98166,8516,316,8200,0.0371066228276186,1.8743735793181449
ZCTA5 59225,190,11,179,0.05789473684210526,1.8734832382125628
ZCTA5 06901,4052,157,3895,0.03874629812438302,1.8733619877868926
ZCTA5 97867,280,15,265,0.05357142857142857,1.8720146708140644
ZCTA5 93254,280,15,265,0.05357142857142857,1.8720146708140644
ZCTA5 49102,543,26,517,0.04788213627992634,1.869673584439591
ZCTA5 85029,17042,614,16428,0.03602863513672104,1.8689473047888727
ZCTA5 47901,1975,81,1894,0.0410126582278481,1.8680008903893268
ZCTA5 33597,2843,113,2730,0.03974674639465353,1.8658408507522861
ZCTA5 76676,106,7,99,0.0660377358490566,1.865578949777659
ZCTA5 38737,1102,48,1054,0.043557168784029036,1.8650944691240752
ZCTA5 56435,1102,48,1054,0.043557168784029036,1.8650944691240752
ZCTA5 28625,14831,537,14294,0.036207942822466456,1.8649361165826295
ZCTA5 51355,446,22,424,0.04932735426008968,1.8641998266498938
ZCTA5 63953,643,30,613,0.04665629860031104,1.86170121535628
ZCTA5 78801,7193,269,6924,0.037397469762268876,1.8598127923622374
ZCTA5 89013,169,10,159,0.05917159763313609,1.8592281488645999
ZCTA5 91739,11598,424,11174,0.03655802724607691,1.8588542350928488
ZCTA5 56122,258,14,244,0.05426356589147287,1.8587920946516356
ZCTA5 66043,3064,121,2943,0.03949086161879896,1.858235744217029
ZCTA5 75569,1339,57,1282,0.04256908140403286,1.8548214373765133
ZCTA5 97456,1078,47,1031,0.04359925788497217,1.8523580813570304
ZCTA5 72455,5257,200,5057,0.038044512079132585,1.8508434198891752
ZCTA5 41146,148,9,139,0.060810810810810814,1.8507830501834421
ZCTA5 57016,305,16,289,0.05245901639344262,1.8457616463791267
ZCTA5 83450,282,15,267,0.05319148936170213,1.8432070537456806
ZCTA5 97352,2062,84,1978,0.040737148399612025,1.8391272013081785
ZCTA5 72734,2987,118,2869,0.03950451958486776,1.8388890694482793
ZCTA5 21075,11695,427,11268,0.03651132962804617,1.8385273866980452
ZCTA5 36612,1660,69,1591,0.04156626506024096,1.8380019775286252
ZCTA5 38587,571,27,544,0.047285464098073555,1.837983150609057
ZCTA5 14709,571,27,544,0.047285464098073555,1.837983150609057
ZCTA5 81303,3207,126,3081,0.03928905519176801,1.8375494546997362
ZCTA5 07057,4676,179,4497,0.038280581693755346,1.8353446186233253
ZCTA5 81630,353,18,335,0.05099150141643059,1.832365238180312
ZCTA5 64654,18,2,16,0.1111111111111111,1.832226819314241
ZCTA5 49918,50,4,46,0.08,1.8303249004884625
ZCTA5 74464,10700,392,10308,0.03663551401869159,1.8300157949275124
ZCTA5 55343,11757,429,11328,0.03648890022965042,1.8298695960069526
ZCTA5 92321,425,21,404,0.04941176470588235,1.8294598523689762
ZCTA5 66532,283,15,268,0.053003533568904596,1.8288884857597376
ZCTA5 57744,875,39,836,0.044571428571428574,1.8287813359596572
ZCTA5 40215,7914,294,7620,0.037149355572403335,1.8280501153060447
ZCTA5 55090,128,8,120,0.0625,1.8274720222497938
ZCTA5 12475,128,8,120,0.0625,1.8274720222497938
ZCTA5 95955,523,25,498,0.04780114722753346,1.824618183843511
ZCTA5 67865,474,23,451,0.04852320675105485,1.8244649447411048
ZCTA5 13687,215,12,203,0.05581395348837209,1.8232592683390894
ZCTA5 97351,3625,141,3484,0.03889655172413793,1.822215851016166
ZCTA5 39577,3432,134,3298,0.03904428904428905,1.8211749941822128
ZCTA5 68061,1031,45,986,0.04364694471387003,1.8200424784793465
ZCTA5 34761,15349,554,14795,0.03609355658349078,1.8184155566456452
ZCTA5 56175,1241,53,1188,0.0427074939564867,1.8127715669552296
ZCTA5 36852,826,37,789,0.044794188861985475,1.8124411290743314
ZCTA5 06226,6536,245,6291,0.037484700122399024,1.8120609024178698
ZCTA5 97848,88,6,82,0.06818181818181818,1.8116690462132163
ZCTA5 32211,13258,481,12777,0.03627998189772213,1.8093942607027667
ZCTA5 03273,150,9,141,0.06,1.8080223196759935
ZCTA5 75763,2340,94,2246,0.040170940170940174,1.8068680289076113
ZCTA5 61049,216,12,204,0.05555555555555555,1.8063752096569328
ZCTA5 04024,216,12,204,0.05555555555555555,1.8063752096569328
ZCTA5 20621,403,20,383,0.04962779156327544,1.805596967671313
ZCTA5 39079,476,23,453,0.04831932773109244,1.803573423390152
ZCTA5 40962,6568,246,6322,0.037454323995127894,1.8028011023265895
ZCTA5 49863,69,5,64,0.07246376811594203,1.8020145172715527
ZCTA5 44048,853,38,815,0.044548651817116064,1.801945200469464
ZCTA5 67335,1322,56,1266,0.04236006051437216,1.8007455783946076
ZCTA5 38826,1775,73,1702,0.04112676056338028,1.7976281393604046
ZCTA5 75206,20324,726,19598,0.03572131470183035,1.7973463734298505
ZCTA5 25670,2234,90,2144,0.04028648164726947,1.7958388213097003
ZCTA5 98649,356,18,338,0.05056179775280899,1.795047410884522
ZCTA5 74736,404,20,384,0.04950495049504951,1.7941049247131333
ZCTA5 83535,477,23,454,0.04821802935010482,1.7931635478911414
ZCTA5 65655,1403,59,1344,0.042052744119743406,1.7910776483485311
ZCTA5 73106,4468,171,4297,0.038272157564906,1.7909285156669308
ZCTA5 27980,829,37,792,0.04463208685162847,1.789774038969675
ZCTA5 73853,217,12,205,0.055299539170506916,1.7895787947649509
ZCTA5 56591,51,4,47,0.0784313725490196,1.7862404061450854
ZCTA5 74034,51,4,47,0.0784313725490196,1.7862404061450854
ZCTA5 99345,51,4,47,0.0784313725490196,1.7862404061450854
ZCTA5 17002,240,13,227,0.05416666666666667,1.7844301636541395
ZCTA5 38059,3002,118,2884,0.03930712858094604,1.7833560279052727
ZCTA5 79313,552,26,526,0.04710144927536232,1.7831022167830355
ZCTA5 45317,357,18,339,0.05042016806722689,1.7826851111432154
ZCTA5 31001,933,41,892,0.04394426580921758,1.7818869152207921
ZCTA5 54646,1671,69,1602,0.04129263913824058,1.781879077611074
ZCTA5 50671,89,6,83,0.06741573033707865,1.7817418101808056
ZCTA5 75157,89,6,83,0.06741573033707865,1.7817418101808056
ZCTA5 84112,173,10,163,0.057803468208092484,1.7810299886759797
ZCTA5 37771,6042,227,5815,0.03757034094670639,1.7792564067672025
ZCTA5 65536,11385,415,10970,0.03645147123407993,1.7784782547980693
ZCTA5 97015,8675,320,8355,0.03688760806916427,1.7783493068088712
ZCTA5 19120,23206,825,22381,0.03555115056450918,1.7764020357902612
ZCTA5 52348,34,3,31,0.08823529411764706,1.7763678996449006
ZCTA5 94709,5004,190,4814,0.03796962430055955,1.7762971420217633
ZCTA5 33470,7881,292,7589,0.03705113564268494,1.775744669637902
ZCTA5 29570,1353,57,1296,0.04212860310421286,1.7743903827876182
ZCTA5 82520,5145,195,4950,0.037900874635568516,1.7737253376842532
ZCTA5 77632,8649,319,8330,0.03688287663313678,1.7732353167825983
ZCTA5 59638,218,12,206,0.05504587155963303,1.7728690844693555
ZCTA5 56639,218,12,206,0.05504587155963303,1.7728690844693555
ZCTA5 62916,358,18,340,0.05027932960893855,1.770360883310072
ZCTA5 83344,382,19,363,0.049738219895287955,1.7699261133895543
ZCTA5 46124,3226,126,3100,0.03905765654060756,1.7698950385034613
ZCTA5 84052,455,22,433,0.04835164835164835,1.7671739271839388
ZCTA5 22729,70,5,65,0.07142857142857142,1.7668602358460115
ZCTA5 97032,1674,69,1605,0.04121863799283154,1.7666403265259356
ZCTA5 22438,152,9,143,0.05921052631578947,1.765907812038118
ZCTA5 30633,3393,132,3261,0.038903625110521665,1.7652321663307522
ZCTA5 26636,196,11,185,0.05612244897959184,1.7648516755060997
ZCTA5 29564,311,16,295,0.05144694533762058,1.764572813209596
ZCTA5 60649,21043,750,20293,0.03564130589744808,1.7643184947664534
ZCTA5 40823,1648,68,1580,0.0412621359223301,1.7626871822876304
ZCTA5 60827,10851,396,10455,0.03649433231960188,1.7610977626286566
ZCTA5 58357,110,7,103,0.06363636363636363,1.7603910386683526
ZCTA5 72630,110,7,103,0.06363636363636363,1.7603910386683526
ZCTA5 39169,962,42,920,0.04365904365904366,1.7601713128888565
ZCTA5 49827,407,20,387,0.04914004914004914,1.759815017014056
ZCTA5 98538,131,8,123,0.061068702290076333,1.7576614963256747
ZCTA5 39117,3978,153,3825,0.038461538461538464,1.756297988984796
ZCTA5 34758,10311,377,9934,0.03656289399670255,1.7554344645711746
ZCTA5 94158,3812,147,3665,0.03856243441762854,1.753905606560194
ZCTA5 71226,757,34,723,0.04491413474240423,1.7534418240404828
ZCTA5 03220,2928,115,2813,0.03927595628415301,1.7518584914519706
ZCTA5 97641,681,31,650,0.04552129221732746,1.7512072991670478
ZCTA5 71371,732,33,699,0.045081967213114756,1.7494968835918527
ZCTA5 72442,1758,72,1686,0.040955631399317405,1.7490968894806278
ZCTA5 79526,408,20,388,0.049019607843137254,1.7484465335173605
ZCTA5 51465,336,17,319,0.050595238095238096,1.7473047426782604
ZCTA5 56550,197,11,186,0.05583756345177665,1.747111609063309
ZCTA5 74865,631,29,602,0.04595879556259905,1.7468103752352382
ZCTA5 41774,964,42,922,0.043568464730290454,1.746360347450753
ZCTA5 58040,531,25,506,0.047080979284369114,1.746232458838397
ZCTA5 28627,457,22,435,0.04814004376367615,1.7458972926389829
ZCTA5 85940,457,22,435,0.04814004376367615,1.7458972926389829
ZCTA5 62956,289,15,274,0.05190311418685121,1.7441415077128724
ZCTA5 79084,784,35,749,0.044642857142857144,1.7421968688565683
ZCTA5 56589,759,34,725,0.04479578392621871,1.7376241996693258
ZCTA5 32628,1333,56,1277,0.042010502625656414,1.737248133212845
ZCTA5 59033,111,7,104,0.06306306306306306,1.7347849437967553
ZCTA5 24269,111,7,104,0.06306306306306306,1.7347849437967553
ZCTA5 99922,111,7,104,0.06306306306306306,1.7347849437967553
ZCTA5 60435,18318,655,17663,0.03575717873130255,1.7333361515608636
ZCTA5 95519,7333,272,7061,0.037092595117959905,1.7326384953909078
ZCTA5 97720,1951,79,1872,0.040492055356227574,1.7287375819195678
ZCTA5 64671,786,35,751,0.044529262086514,1.7267070197968837
ZCTA5 07114,3460,134,3326,0.03872832369942197,1.725231759476408
ZCTA5 67340,176,10,166,0.056818181818181816,1.7237148512121516
ZCTA5 83321,176,10,166,0.056818181818181816,1.7237148512121516
ZCTA5 40212,6601,246,6355,0.037267080745341616,1.7227236448662708
ZCTA5 48875,3822,147,3675,0.038461538461538464,1.7215163669156983
ZCTA5 72176,3434,133,3301,0.03873034362259756,1.719395712565052
ZCTA5 80755,35,3,32,0.08571428571428572,1.7193602302307083
ZCTA5 72745,4800,182,4618,0.03791666666666667,1.7193090455822153
ZCTA5 32922,5925,222,5703,0.03746835443037975,1.7182884135882641
ZCTA5 71846,1073,46,1027,0.04287045666356011,1.7152957828280722
ZCTA5 27801,7909,292,7617,0.03691996459729422,1.714023657549766
ZCTA5 45679,995,43,952,0.04321608040201005,1.7124029788792727
ZCTA5 71935,199,11,188,0.05527638190954774,1.711933439072358
ZCTA5 15346,199,11,188,0.05527638190954774,1.711933439072358
ZCTA5 76070,268,14,254,0.05223880597014925,1.7101393217172551
ZCTA5 37729,610,28,582,0.04590163934426229,1.7096466576586018
ZCTA5 97534,363,18,345,0.049586776859504134,1.7093022886483344
ZCTA5 14767,686,31,655,0.04518950437317784,1.709297812950806
ZCTA5 97112,814,36,778,0.044226044226044224,1.7090840626583261
ZCTA5 22973,2336,93,2243,0.03981164383561644,1.708750785805937
ZCTA5 16839,245,13,232,0.053061224489795916,1.706698424696586
ZCTA5 65337,712,32,680,0.0449438202247191,1.7049315696975453
ZCTA5 00720,6665,248,6417,0.037209302325581395,1.7048229861496134
ZCTA5 25653,155,9,146,0.05806451612903226,1.703904766834984
ZCTA5 81041,292,15,277,0.05136986301369863,1.7024966327836872
ZCTA5 03293,53,4,49,0.07547169811320754,1.7011035904835143
ZCTA5 99640,53,4,49,0.07547169811320754,1.7011035904835143
ZCTA5 58770,486,23,463,0.047325102880658436,1.7005306646124572
ZCTA5 75167,3523,136,3387,0.0386034629577065,1.6996534378969415
ZCTA5 90742,388,19,369,0.04896907216494845,1.6995182408048792
ZCTA5 61822,10226,373,9853,0.03647565030314884,1.6991213742883706
ZCTA5 28513,4080,156,3924,0.03823529411764706,1.6983063716497928
ZCTA5 84073,72,5,67,0.06944444444444445,1.6982968198217934
ZCTA5 14533,790,35,755,0.04430379746835443,1.6958535433248096
ZCTA5 70515,1155,49,1106,0.04242424242424243,1.6952987705633888
ZCTA5 58776,92,6,86,0.06521739130434782,1.6942617899644914
ZCTA5 88351,92,6,86,0.06521739130434782,1.6942617899644914
ZCTA5 79756,3303,128,3175,0.03875264910687254,1.6934101406908926
ZCTA5 79079,1156,49,1107,0.04238754325259515,1.6890934843671357
ZCTA5 57579,438,21,417,0.04794520547945205,1.686542323284459
ZCTA5 13786,178,10,168,0.056179775280898875,1.6861146087268284
ZCTA5 46910,1183,50,1133,0.042265426880811495,1.6853475389568164
ZCTA5 92372,2178,87,2091,0.03994490358126722,1.6845370176059378
ZCTA5 99613,156,9,147,0.057692307692307696,1.683539354582601
ZCTA5 32835,16879,604,16275,0.03578411043308253,1.6833194085061773
ZCTA5 71068,1583,65,1518,0.0410612760581175,1.68313342911871
ZCTA5 04987,414,20,394,0.04830917874396135,1.6808691629510557
ZCTA5 13120,844,37,807,0.04383886255924171,1.6777401422920224
ZCTA5 13654,896,39,857,0.04352678571428571,1.6767024388377316
ZCTA5 84027,224,12,212,0.05357142857142857,1.6743808235268558
ZCTA5 38627,366,18,348,0.04918032786885246,1.673108592800815
ZCTA5 60471,5070,191,4879,0.03767258382642998,1.6703525302583746
ZCTA5 70556,135,8,127,0.05925925925925926,1.667377979790139
ZCTA5 49271,768,34,734,0.044270833333333336,1.6669934135081579
ZCTA5 56572,2046,82,1964,0.04007820136852395,1.6662230566931704
ZCTA5 78536,93,6,87,0.06451612903225806,1.6658364272841397
ZCTA5 13403,1775,72,1703,0.04056338028169014,1.6656311673739654
ZCTA5 31006,2019,81,1938,0.04011887072808321,1.6653548590903693
ZCTA5 46076,615,28,587,0.04552845528455285,1.6651727068244602
ZCTA5 49902,73,5,68,0.0684931506849315,1.664849796971901
ZCTA5 86437,36,3,33,0.08333333333333333,1.6643048042483317
ZCTA5 12747,666,30,636,0.04504504504504504,1.6634644066021045
ZCTA5 97402,20918,743,20175,0.03551964814991873,1.661219983170259
ZCTA5 97910,248,13,235,0.05241935483870968,1.6609029267033828
ZCTA5 27910,4540,172,4368,0.03788546255506608,1.6604038049735956
ZCTA5 29493,54,4,50,0.07407407407407407,1.6599617172331733
ZCTA5 62843,54,4,50,0.07407407407407407,1.6599617172331733
ZCTA5 46785,490,23,467,0.04693877551020408,1.6599571502964523
ZCTA5 41746,202,11,191,0.054455445544554455,1.6599035897243606
ZCTA5 54082,515,24,491,0.04660194174757282,1.6592670790084734
ZCTA5 95922,225,12,213,0.05333333333333334,1.6582529356029456
ZCTA5 36756,1723,70,1653,0.04062681369704005,1.655694625534323
ZCTA5 35677,744,33,711,0.04435483870967742,1.653482468269679
ZCTA5 93591,1886,76,1810,0.04029692470837752,1.6525702392000534
ZCTA5 46743,770,34,736,0.04415584415584416,1.651417996650855
ZCTA5 75219,14592,524,14068,0.035910087719298246,1.6497583605211887
ZCTA5 57262,1914,77,1837,0.040229885057471264,1.648481820157694
ZCTA5 68037,900,39,861,0.043333333333333335,1.648166487860635
ZCTA5 96048,320,16,304,0.05,1.645980218371603
ZCTA5 78631,1084,46,1038,0.042435424354243544,1.6444131736420802
ZCTA5 38726,203,11,192,0.054187192118226604,1.6427524178567825
ZCTA5 39573,2931,114,2817,0.038894575230296824,1.637932391378071
ZCTA5 84331,94,6,88,0.06382978723404255,1.6377629839698156
ZCTA5 39054,115,7,108,0.06086956521739131,1.6349531842295153
ZCTA5 43731,2081,83,1998,0.03988467083133109,1.631317995213362
ZCTA5 89408,7264,268,6996,0.036894273127753306,1.630468862365465
ZCTA5 37861,3238,125,3113,0.03860407659048796,1.6296495818723524
ZCTA5 80951,1459,60,1399,0.0411240575736806,1.6292033638979653
ZCTA5 92399,18769,668,18101,0.03559060152378923,1.6276332795024844
ZCTA5 10954,8319,305,8014,0.03666306046399807,1.6275819410262966
ZCTA5 76487,1034,44,990,0.0425531914893617,1.6271002804945074
ZCTA5 30084,14261,512,13749,0.03590211065142697,1.6256421212798369
ZCTA5 30046,12648,456,12192,0.036053130929791274,1.625401164255434
ZCTA5 99022,3156,122,3034,0.038656527249683145,1.625268777836933
ZCTA5 45229,6132,228,5904,0.03718199608610567,1.6233442193786
ZCTA5 74957,444,21,423,0.0472972972972973,1.622132611374078
ZCTA5 23839,298,15,283,0.050335570469798654,1.6206070001070372
ZCTA5 33813,12766,460,12306,0.03603321322262259,1.6204507102194337
ZCTA5 57543,322,16,306,0.049689440993788817,1.6201249215752225
ZCTA5 16640,322,16,306,0.049689440993788817,1.6201249215752225
ZCTA5 35051,3102,120,2982,0.03868471953578337,1.6200364081406768
ZCTA5 54861,55,4,51,0.07272727272727272,1.6197158352468826
ZCTA5 32776,3966,151,3815,0.038073625819465454,1.617792657049841
ZCTA5 52255,595,27,568,0.0453781512605042,1.617484117273057
ZCTA5 43340,646,29,617,0.04489164086687306,1.6166142180117655
ZCTA5 27017,3492,134,3358,0.03837342497136312,1.6165628437603763
ZCTA5 39437,4527,171,4356,0.03777335984095427,1.616079453108393
ZCTA5 53209,18691,665,18026,0.035578620726552886,1.6151388251138896
ZCTA5 62510,672,30,642,0.044642857142857144,1.6129608789482148
ZCTA5 18822,1462,60,1402,0.04103967168262654,1.612934010109081
ZCTA5 99558,37,3,34,0.08108108108108109,1.6110747878507319
ZCTA5 97101,1382,57,1325,0.04124457308248915,1.610544296587875
ZCTA5 92230,984,42,942,0.042682926829268296,1.6099046883017938
ZCTA5 85123,4530,171,4359,0.03774834437086093,1.607251717632996
ZCTA5 37618,5319,199,5120,0.03741304756533183,1.605615337712562
ZCTA5 64850,8815,322,8493,0.036528644356211004,1.6052178167824778
ZCTA5 95450,160,9,151,0.05625,1.603529804237124
ZCTA5 72335,6056,225,5831,0.03715323645970938,1.600806718215908
ZCTA5 57761,471,22,449,0.04670912951167728,1.599740008632742
ZCTA5 84042,2803,109,2694,0.03888690688547984,1.5995102403341066
ZCTA5 33851,348,17,331,0.04885057471264368,1.5972387925376452
ZCTA5 11580,13302,478,12824,0.03593444594797775,1.5907712239257912
ZCTA5 97375,447,21,426,0.04697986577181208,1.5902813864684773
ZCTA5 67543,778,34,744,0.043701799485861184,1.5895456229481588
ZCTA5 73544,117,7,110,0.05982905982905983,1.5865195414660416
ZCTA5 02145,10773,390,10383,0.03620161514898357,1.5857983607032946
ZCTA5 15714,1982,79,1903,0.03985872855701312,1.5856188213871174
ZCTA5 05674,701,31,670,0.0442225392296719,1.5855096671914406
ZCTA5 19604,8196,300,7896,0.036603221083455345,1.585378207853913
ZCTA5 98498,11262,407,10855,0.036139229266560116,1.5845719001558323
ZCTA5 96032,1067,45,1022,0.04217432052483599,1.5840372372148264
ZCTA5 76941,548,25,523,0.04562043795620438,1.5838278353679165
ZCTA5 93205,727,32,695,0.044016506189821183,1.5837516362428128
ZCTA5 41049,883,38,845,0.04303510758776897,1.583244227394512
ZCTA5 79370,599,27,572,0.045075125208681135,1.5816683354116834
ZCTA5 95565,301,15,286,0.04983388704318937,1.5803405589306985
ZCTA5 99832,56,4,52,0.07142857142857142,1.5803278376371968
ZCTA5 41044,374,18,356,0.0481283422459893,1.5781570234452644
ZCTA5 57356,574,26,548,0.04529616724738676,1.5777607181646411
ZCTA5 29520,5386,201,5185,0.03731897512068325,1.5773025476891063
ZCTA5 33521,184,10,174,0.05434782608695652,1.5761039275427022
ZCTA5 99683,207,11,196,0.05314009661835749,1.5750793267062446
ZCTA5 87566,806,35,771,0.043424317617866005,1.5740872464424573
ZCTA5 63748,399,19,380,0.047619047619047616,1.5734755138898295
ZCTA5 28621,4009,152,3857,0.037914691943127965,1.570576625129886
ZCTA5 04854,703,31,672,0.044096728307254626,1.569219187868754
ZCTA5 75936,326,16,310,0.049079754601226995,1.5689388476041024
ZCTA5 80623,326,16,310,0.049079754601226995,1.5689388476041024
ZCTA5 47584,76,5,71,0.06578947368421052,1.5676381421552126
ZCTA5 07026,11329,409,10920,0.036102039014917466,1.5672649388383524
ZCTA5 72015,10496,380,10116,0.036204268292682924,1.5667898284158217
ZCTA5 64843,1256,52,1204,0.041401273885350316,1.5662551815797152
ZCTA5 30139,1444,59,1385,0.04085872576177285,1.5647360837620332
ZCTA5 63851,1552,63,1489,0.04059278350515464,1.5639326536703504
ZCTA5 85022,21806,771,21035,0.03535724112629551,1.5627447996475572
ZCTA5 34475,4068,154,3914,0.037856440511307765,1.561429990998212
ZCTA5 34714,7266,267,6999,0.03674649050371594,1.5606390993177226
ZCTA5 56525,38,3,35,0.07894736842105263,1.5595548702557775
ZCTA5 07108,8323,304,8019,0.036525291361287994,1.558076767958467
ZCTA5 00766,7809,286,7523,0.03662440773466513,1.5579080418395128
ZCTA5 59735,97,6,91,0.061855670103092786,1.55556828499452
ZCTA5 24822,303,15,288,0.04950495049504951,1.5537404418563414
ZCTA5 70715,526,24,502,0.045627376425855515,1.552594970546267
ZCTA5 36522,2567,100,2467,0.038955979742890535,1.5501559296770475
ZCTA5 62858,1152,48,1104,0.041666666666666664,1.5501024291360017
ZCTA5 99639,426,20,406,0.046948356807511735,1.5488598109227367
ZCTA5 76086,8157,298,7859,0.03653303910751502,1.5463521814558931
ZCTA5 78146,163,9,154,0.05521472392638037,1.5449887171184136
ZCTA5 46382,706,31,675,0.043909348441926344,1.5448760880460133
ZCTA5 01375,1610,65,1545,0.040372670807453416,1.5437717882518553
ZCTA5 27606,18192,646,17546,0.03551011433597186,1.542048242494802
ZCTA5 30148,256,13,243,0.05078125,1.5417236041322595
ZCTA5 81415,578,26,552,0.04498269896193772,1.541338307231667
ZCTA5 04221,304,15,289,0.049342105263157895,1.540512517746624
ZCTA5 23023,186,10,176,0.053763440860215055,1.5403246100134216
ZCTA5 13029,2902,112,2790,0.03859407305306685,1.5397849628325233
ZCTA5 79843,837,36,801,0.043010752688172046,1.5375345799616689
ZCTA5 67841,141,8,133,0.05673758865248227,1.5375100762803042
ZCTA5 49627,77,5,72,0.06493506493506493,1.5362237857413936
ZCTA5 31019,785,34,751,0.04331210191082802,1.5359613727367585
ZCTA5 92129,17879,635,17244,0.03551652777000951,1.5334939131282244
ZCTA5 68840,1155,48,1107,0.04155844155844156,1.5316652948841292
ZCTA5 74134,6112,226,5886,0.03697643979057592,1.5313259915251103
ZCTA5 31550,329,16,313,0.0486322188449848,1.530998523505248
ZCTA5 44115,3966,150,3816,0.037821482602118005,1.5294873525654529
ZCTA5 63630,1397,57,1340,0.0408017179670723,1.5272111637239694
ZCTA5 53816,257,13,244,0.05058365758754864,1.527116145450756
ZCTA5 23605,5830,216,5614,0.03704974271012007,1.526707768918274
ZCTA5 96148,210,11,199,0.05238095238095238,1.5252736320370583
ZCTA5 20745,10576,382,10194,0.03611951588502269,1.5242791688284216
ZCTA5 62053,187,10,177,0.053475935828877004,1.5225957280972064
ZCTA5 98276,187,10,177,0.053475935828877004,1.5225957280972064
ZCTA5 84045,6316,233,6083,0.03689043698543382,1.5186618335545317
ZCTA5 54805,555,25,530,0.04504504504504504,1.5185282985048636
ZCTA5 99672,1318,54,1264,0.0409711684370258,1.517611915750746
ZCTA5 77650,866,37,829,0.042725173210161664,1.5172079426053358
ZCTA5 61454,234,12,222,0.05128205128205128,1.5165924037101244
ZCTA5 26030,234,12,222,0.05128205128205128,1.5165924037101244
ZCTA5 54772,429,20,409,0.046620046620046623,1.516487925632457
ZCTA5 38878,1051,44,1007,0.04186489058039962,1.5163296007968496
ZCTA5 27926,581,26,555,0.04475043029259897,1.5141986468407642
ZCTA5 25917,814,35,779,0.042997542997543,1.5141665122406287
ZCTA5 75791,4365,164,4201,0.03757159221076747,1.5127679136558425
ZCTA5 76511,736,32,704,0.043478260869565216,1.5123197070142091
ZCTA5 89413,282,14,268,0.04964539007092199,1.5120465053304628
ZCTA5 56470,4507,169,4338,0.03749722653649878,1.5094134546999405
ZCTA5 54943,841,36,805,0.04280618311533888,1.508212609535426
ZCTA5 30755,3245,124,3121,0.03821263482280431,1.5074055804161497
ZCTA5 31091,1320,54,1266,0.04090909090909091,1.506220417834112
ZCTA5 39470,4621,173,4448,0.03743778402943086,1.505912484543059
ZCTA5 52209,430,20,410,0.046511627906976744,1.505751728257638
ZCTA5 95568,78,5,73,0.0641025641025641,1.5052791555065785
ZCTA5 97454,531,24,507,0.04519774011299435,1.5048999172115771
ZCTA5 28360,4904,183,4721,0.03731647634584013,1.5040981358909862
ZCTA5 27299,2055,81,1974,0.03941605839416058,1.5029589599644644
ZCTA5 13734,842,36,806,0.04275534441805225,1.500905248804899
ZCTA5 74370,1375,56,1319,0.04072727272727273,1.4997866371799091
ZCTA5 91978,3331,127,3204,0.038126688682077456,1.4996645816359608
ZCTA5 39813,816,35,781,0.0428921568627451,1.499284129160337
ZCTA5 91384,6980,256,6724,0.03667621776504298,1.4969666916083533
ZCTA5 73755,381,18,363,0.047244094488188976,1.4968732387828798
ZCTA5 84067,12465,447,12018,0.0358604091456077,1.4939420598561421
ZCTA5 41647,661,29,632,0.04387291981845688,1.4896223472423766
ZCTA5 94525,1404,57,1347,0.0405982905982906,1.488643325409224
ZCTA5 17220,189,10,179,0.05291005291005291,1.4874528974960928
ZCTA5 07077,923,39,884,0.04225352112676056,1.48665682641741
ZCTA5 60099,10309,372,9937,0.036084974294305946,1.4854117659723804
ZCTA5 11024,2059,81,1978,0.03933948518698397,1.4850982672144817
ZCTA5 22046,6586,242,6344,0.036744609778317644,1.4849693292653066
ZCTA5 98243,284,14,270,0.04929577464788732,1.4846336932655113
ZCTA5 72845,432,20,412,0.046296296296296294,1.48436010681578
ZCTA5 07074,977,41,936,0.04196519959058342,1.4794097633461123
ZCTA5 05675,483,22,461,0.045548654244306416,1.478159219091921
ZCTA5 54405,1137,47,1090,0.04133685136323659,1.4781311843686356
ZCTA5 34203,14093,503,13590,0.03569147803874264,1.4769821707541724
ZCTA5 54536,100,6,94,0.06,1.4762440422564647
ZCTA5 56207,100,6,94,0.06,1.4762440422564647
ZCTA5 56641,144,8,136,0.05555555555555555,1.47489918255749
ZCTA5 92354,7762,283,7479,0.03645967534140685,1.4725023760483307
ZCTA5 71023,1380,56,1324,0.04057971014492753,1.4720265572389046
ZCTA5 17317,237,12,225,0.05063291139240506,1.470708681743331
ZCTA5 67364,122,7,115,0.05737704918032787,1.4694508655146203
ZCTA5 84085,122,7,115,0.05737704918032787,1.4694508655146203
ZCTA5 38359,167,9,158,0.05389221556886228,1.4687878110775852
ZCTA5 14303,2560,99,2461,0.038671875,1.4681013780124401
ZCTA5 75780,59,4,55,0.06779661016949153,1.4669634722444729
ZCTA5 15962,59,4,55,0.06779661016949153,1.4669634722444729
ZCTA5 58545,1544,62,1482,0.04015544041450777,1.4643294470123986
ZCTA5 83434,510,23,487,0.045098039215686274,1.4623205879765604
ZCTA5 85606,510,23,487,0.045098039215686274,1.4623205879765604
ZCTA5 55721,1409,57,1352,0.04045422285308729,1.4612180889161246
ZCTA5 56350,214,11,203,0.0514018691588785,1.4600808168878123
ZCTA5 84629,874,37,837,0.04233409610983982,1.4599041218223001
ZCTA5 87321,769,33,736,0.04291287386215865,1.458660767928689
ZCTA5 75181,8084,294,7790,0.0363681345868382,1.4569637372375241
ZCTA5 76306,5744,212,5532,0.03690807799442897,1.455697545617875
ZCTA5 74367,191,10,181,0.05235602094240838,1.452721425443212
ZCTA5 41255,410,19,391,0.046341463414634146,1.45115605434224
ZCTA5 83349,385,18,367,0.046753246753246755,1.4511503577008862
ZCTA5 83236,770,33,737,0.04285714285714286,1.451008736524702
ZCTA5 38746,168,9,159,0.05357142857142857,1.4500563287837662
ZCTA5 77990,311,15,296,0.04823151125401929,1.4492299890489957
ZCTA5 38356,1062,44,1018,0.04143126177024482,1.4456583661135236
ZCTA5 39096,461,21,440,0.0455531453362256,1.4446390599201173
ZCTA5 64723,336,16,320,0.047619047619047616,1.4439201589855781
ZCTA5 84314,336,16,320,0.047619047619047616,1.4439201589855781
ZCTA5 57248,361,17,344,0.04709141274238227,1.4409230616225652
ZCTA5 62366,641,28,613,0.0436817472698908,1.439996915523495
ZCTA5 99656,8,1,7,0.125,1.439946414965793
ZCTA5 12837,386,18,368,0.046632124352331605,1.4398000468157006
ZCTA5 29801,10910,392,10518,0.03593033913840513,1.438274933145599
ZCTA5 37878,192,10,182,0.052083333333333336,1.4355068268003526
ZCTA5 98107,13310,475,12835,0.035687453042824946,1.4327833039963804
ZCTA5 73644,5043,187,4856,0.037081102518342256,1.4323119156768938
ZCTA5 02140,9445,341,9104,0.03610375860243515,1.431955654289131
ZCTA5 69216,60,4,56,0.06666666666666667,1.4306693024535804
ZCTA5 76877,1469,59,1410,0.04016337644656229,1.4300132590628225
ZCTA5 93461,539,24,515,0.04452690166975881,1.4295824011524174
ZCTA5 47529,412,19,393,0.04611650485436893,1.429298137918696
ZCTA5 65463,412,19,393,0.04611650485436893,1.429298137918696
ZCTA5 73641,216,11,205,0.05092592592592592,1.4279881534545795
ZCTA5 12456,216,11,205,0.05092592592592592,1.4279881534545795
ZCTA5 19142,9678,349,9329,0.03606116966315354,1.4262107712387342
ZCTA5 62808,591,26,565,0.043993231810490696,1.4248054557209298
ZCTA5 54525,124,7,117,0.056451612903225805,1.424137888055285
ZCTA5 40107,853,36,817,0.04220398593200469,1.4211261837267675
ZCTA5 95669,853,36,817,0.04220398593200469,1.4211261837267675
ZCTA5 76051,20081,708,19373,0.03525720830635924,1.4208284850560657
ZCTA5 71323,338,16,322,0.047337278106508875,1.419403005942948
ZCTA5 47110,193,10,183,0.05181347150259067,1.4183913652315168
ZCTA5 11950,4425,165,4260,0.03728813559322034,1.418270296206064
ZCTA5 01608,1717,68,1649,0.039603960396039604,1.4171081802858272
ZCTA5 29163,722,31,691,0.04293628808864266,1.4168813090912085
ZCTA5 60407,618,27,591,0.043689320388349516,1.4149733036463523
ZCTA5 62218,618,27,591,0.043689320388349516,1.4149733036463523
ZCTA5 59640,41,3,38,0.07317073170731707,1.4142489084209238
ZCTA5 17505,515,23,492,0.04466019417475728,1.4142143559747284
ZCTA5 85553,854,36,818,0.04215456674473068,1.4139276223540336
ZCTA5 98122,18923,668,18255,0.035300956507953285,1.4127202623904245
ZCTA5 45062,241,12,229,0.04979253112033195,1.4105161081590376
ZCTA5 77872,697,30,667,0.043041606886657105,1.40759741269303
ZCTA5 36611,2049,80,1969,0.03904343582235237,1.4069631588546807
ZCTA5 30413,645,28,617,0.043410852713178294,1.4062230463186987
ZCTA5 95830,290,14,276,0.04827586206896552,1.4036460484968023
ZCTA5 39059,3979,149,3830,0.037446594621764265,1.4004841893120252
ZCTA5 22842,2023,79,1944,0.03905091448344043,1.399878717675789
ZCTA5 46929,1123,46,1077,0.04096170970614425,1.3990913543595551
ZCTA5 47235,491,22,469,0.04480651731160896,1.3988995390231809
ZCTA5 81425,2051,80,1971,0.03900536323744515,1.398060980509154
ZCTA5 48834,777,33,744,0.04247104247104247,1.3977379667847818
ZCTA5 74824,466,21,445,0.045064377682403435,1.393776461709731
ZCTA5 63541,148,8,140,0.05405405405405406,1.3936608750107684
ZCTA5 25239,725,31,694,0.04275862068965517,1.3932183483474856
ZCTA5 74883,804,34,770,0.04228855721393035,1.3930403668265798
ZCTA5 28901,2080,81,1999,0.03894230769230769,1.391917625645581
ZCTA5 74856,291,14,277,0.048109965635738834,1.390326148497316
ZCTA5 54023,1531,61,1470,0.039843239712606136,1.3902182186101606
ZCTA5 79546,778,33,745,0.042416452442159386,1.3901694071251895
ZCTA5 56244,518,23,495,0.0444015444015444,1.3855903513973618
ZCTA5 77865,726,31,695,0.04269972451790634,1.3853537800681541
ZCTA5 95236,1532,61,1471,0.03981723237597911,1.3850112292908843
ZCTA5 76301,6485,237,6248,0.03654587509637625,1.3845385508430454
ZCTA5 67524,267,13,254,0.04868913857677903,1.3843888052257665
ZCTA5 55605,366,17,349,0.04644808743169399,1.3824236043019593
ZCTA5 22718,243,12,231,0.04938271604938271,1.3808301334657342
ZCTA5 53580,219,11,208,0.0502283105022831,1.3804587270829451
ZCTA5 51448,219,11,208,0.0502283105022831,1.3804587270829451
ZCTA5 48647,1945,76,1869,0.0390745501285347,1.3784229907551016
ZCTA5 66056,806,34,772,0.04218362282878412,1.378204751758848
ZCTA5 79331,4156,155,4001,0.037295476419634266,1.3771171832532771
ZCTA5 71043,172,9,163,0.05232558139534884,1.376353295055363
ZCTA5 56552,172,9,163,0.05232558139534884,1.376353295055363
ZCTA5 78418,12273,438,11835,0.035688095820092886,1.376232581665376
ZCTA5 50122,519,23,496,0.04431599229287091,1.3760884402538351
ZCTA5 96056,701,30,671,0.042796005706134094,1.3754686376790355
ZCTA5 03746,104,6,98,0.057692307692307696,1.3746041268739644
ZCTA5 13320,833,35,798,0.04201680672268908,1.3743240369869438
ZCTA5 25260,675,29,646,0.04296296296296296,1.3738420374827058
ZCTA5 76377,317,15,302,0.0473186119873817,1.3727539045471198
ZCTA5 11694,8468,306,8162,0.03613604156825697,1.372393643924255
ZCTA5 74438,42,3,39,0.07142857142857142,1.3686040537015423
ZCTA5 51350,244,12,232,0.04918032786885246,1.3660874455426646
ZCTA5 04982,244,12,232,0.04918032786885246,1.3660874455426646
ZCTA5 79411,3230,122,3108,0.03777089783281734,1.3643038119032687
ZCTA5 02215,7553,274,7279,0.03627697603601218,1.3642429511529106
ZCTA5 74103,293,14,279,0.04778156996587031,1.3638353313723999
ZCTA5 49656,572,25,547,0.043706293706293704,1.3635517910338133
ZCTA5 74552,469,21,448,0.04477611940298507,1.3635395349560484
ZCTA5 83851,624,27,597,0.04326923076923077,1.363467918849751
ZCTA5 83623,598,26,572,0.043478260869565216,1.3631865621336021
ZCTA5 47666,729,31,698,0.04252400548696845,1.361828822263003
ZCTA5 37086,10750,385,10365,0.035813953488372095,1.3605826649759893
ZCTA5 97711,24,2,22,0.08333333333333333,1.358899182290351
ZCTA5 99648,24,2,22,0.08333333333333333,1.358899182290351
ZCTA5 58381,127,7,120,0.05511811023622047,1.3576907712629356
ZCTA5 79061,150,8,142,0.05333333333333334,1.3539578522331697
ZCTA5 54921,470,21,449,0.04468085106382979,1.3535066431099105
ZCTA5 54611,470,21,449,0.04468085106382979,1.3535066431099105
ZCTA5 48768,3853,144,3709,0.03737347521411887,1.3528914251153323
ZCTA5 24102,704,30,674,0.04261363636363636,1.351499491239032
ZCTA5 77444,245,12,233,0.04897959183673469,1.3514107798680075
ZCTA5 33050,3910,146,3764,0.037340153452685425,1.351274572719579
ZCTA5 38050,197,10,187,0.050761421319796954,1.3508974109233163
ZCTA5 41571,197,10,187,0.050761421319796954,1.3508974109233163
ZCTA5 23511,197,10,187,0.050761421319796954,1.3508974109233163
ZCTA5 64861,496,22,474,0.04435483870967742,1.3500627819661302
ZCTA5 85132,7703,279,7424,0.03621965467999481,1.3497455104222373
ZCTA5 67330,548,24,524,0.043795620437956206,1.3462680807293372
ZCTA5 97633,548,24,524,0.043795620437956206,1.3462680807293372
ZCTA5 18854,600,26,574,0.043333333333333335,1.3457223021378668
ZCTA5 51334,2927,111,2816,0.037922787837376154,1.344435622833984
ZCTA5 84747,420,19,401,0.04523809523809524,1.3429963938021041
ZCTA5 29081,497,22,475,0.04426559356136821,1.3403586957580917
ZCTA5 40923,174,9,165,0.05172413793103448,1.340212518467527
ZCTA5 74845,174,9,165,0.05172413793103448,1.340212518467527
ZCTA5 70668,2509,96,2413,0.038262255878836186,1.339302028321257
ZCTA5 35010,8312,300,8012,0.03609239653512993,1.337565122958482
ZCTA5 76372,446,20,426,0.04484304932735426,1.3375454306583456
ZCTA5 17035,370,17,353,0.04594594594594595,1.3362429799389606
ZCTA5 67862,128,7,121,0.0546875,1.3359328175481213
ZCTA5 99129,320,15,305,0.046875,1.3351035291465965
ZCTA5 38760,345,16,329,0.0463768115942029,1.3348157656087631
ZCTA5 39166,198,10,188,0.050505050505050504,1.3342602017784906
ZCTA5 26411,222,11,211,0.04954954954954955,1.3336403160338195
ZCTA5 72562,892,37,855,0.04147982062780269,1.3329735462062018
ZCTA5 85338,15228,539,14689,0.0353953244024166,1.3320695749774878
ZCTA5 20723,11604,414,11190,0.035677352637021716,1.3317620894679454
ZCTA5 83352,1161,47,1114,0.040482342807924204,1.3317318454989104
ZCTA5 68825,498,22,476,0.04417670682730924,1.3306754704986157
ZCTA5 54741,628,27,601,0.042993630573248405,1.3294229567450255
ZCTA5 03740,271,13,258,0.04797047970479705,1.3289285876896457
ZCTA5 57233,63,4,59,0.06349206349206349,1.325872453610798
ZCTA5 87734,63,4,59,0.06349206349206349,1.325872453610798
ZCTA5 76459,106,6,100,0.05660377358490566,1.3254341308919646
ZCTA5 71465,1081,44,1037,0.04070305272895467,1.3253858021940514
ZCTA5 59918,296,14,282,0.0472972972972973,1.3244657309982983
ZCTA5 74350,321,15,306,0.04672897196261682,1.3226383724417954
ZCTA5 38761,787,33,754,0.04193138500635324,1.3225120764553304
ZCTA5 83631,422,19,403,0.045023696682464455,1.3216972491709555
ZCTA5 72658,629,27,602,0.04292527821939587,1.3209477223514492
ZCTA5 67420,1930,75,1855,0.038860103626943004,1.3207059552471831
ZCTA5 38069,921,38,883,0.04125950054288816,1.317285303704016
ZCTA5 79095,948,39,909,0.04113924050632911,1.3158630379688563
ZCTA5 74941,975,40,935,0.041025641025641026,1.3147439115564068
ZCTA5 31720,129,7,122,0.05426356589147287,1.3143644949441184
ZCTA5 75756,1546,61,1485,0.03945666235446313,1.312483240114577
ZCTA5 42372,709,30,679,0.04231311706629055,1.311790500308112
ZCTA5 48845,347,16,331,0.04610951008645533,1.3109888016498725
ZCTA5 56440,526,23,503,0.043726235741444866,1.31011812405989
ZCTA5 81063,578,25,553,0.04325259515570934,1.3100257403132325
ZCTA5 79521,1301,52,1249,0.03996925441967717,1.3068223502092942
ZCTA5 47991,398,18,380,0.04522613065326633,1.3060221954553093
ZCTA5 49420,2350,90,2260,0.03829787234042553,1.305772176038716
ZCTA5 46805,9163,329,8834,0.03590527119938885,1.304755610717148
ZCTA5 28634,1796,70,1726,0.03897550111358575,1.3012293915025428
ZCTA5 54104,553,24,529,0.0433996383363472,1.3006111920965455
ZCTA5 71367,424,19,405,0.04481132075471698,1.3005062145696928
ZCTA5 96062,424,19,405,0.04481132075471698,1.3005062145696928
ZCTA5 77358,1824,71,1753,0.03892543859649123,1.299443201554589
ZCTA5 40437,2074,80,1994,0.03857280617164899,1.2963284487580167
ZCTA5 57540,25,2,23,0.08,1.2942351489099844
ZCTA5 99564,25,2,23,0.08,1.2942351489099844
ZCTA5 24375,685,29,656,0.042335766423357665,1.292693568188472
ZCTA5 94568,18310,644,17666,0.03517203713817586,1.2926377359185466
ZCTA5 67561,502,22,480,0.043824701195219126,1.2921492653903848
ZCTA5 32087,1468,58,1410,0.039509536784741145,1.290211588106016
ZCTA5 76689,1277,51,1226,0.039937353171495694,1.2883728738541451
ZCTA5 64652,177,9,168,0.05084745762711865,1.2868545959229334
ZCTA5 79379,177,9,168,0.05084745762711865,1.2868545959229334
ZCTA5 28677,13456,477,12979,0.03544887039239001,1.2867125372457164
ZCTA5 42232,299,14,285,0.046822742474916385,1.2855269877656839
ZCTA5 74557,201,10,191,0.04975124378109453,1.2848981183166968
ZCTA5 76561,400,18,382,0.045,1.2841487011676735
ZCTA5 61239,503,22,481,0.0437375745526839,1.2825689153194142
ZCTA5 01731,555,24,531,0.043243243243243246,1.2824714222880806
ZCTA5 12952,154,8,146,0.05194805194805195,1.2762910547105863
ZCTA5 49425,1334,53,1281,0.03973013493253373,1.2747237552656707
ZCTA5 57062,478,21,457,0.043933054393305436,1.2740569931494565
ZCTA5 83302,86,5,81,0.05813953488372093,1.2730648521598182
ZCTA5 29843,504,22,482,0.04365079365079365,1.273008858834002
ZCTA5 50565,178,9,169,0.05056179775280899,1.2692901967878005
ZCTA5 52046,955,39,916,0.040837696335078534,1.2688900558961471
ZCTA5 48614,557,24,533,0.04308797127468582,1.2644010597271358
ZCTA5 75420,351,16,335,0.045584045584045586,1.2637763120456547
ZCTA5 82431,1336,53,1283,0.03967065868263473,1.2635894174721722
ZCTA5 68956,531,23,508,0.04331450094161959,1.2635673755847572
ZCTA5 49503,15593,550,15043,0.03527223754248701,1.2624641217511214
ZCTA5 57236,65,4,61,0.06153846153846154,1.2591633410121599
ZCTA5 14708,65,4,61,0.06153846153846154,1.2591633410121599
ZCTA5 95370,11877,422,11455,0.0355308579607645,1.2585520336746299
ZCTA5 58344,428,19,409,0.04439252336448598,1.2584438144076313
ZCTA5 87004,4110,152,3958,0.036982968369829686,1.258059369065624
ZCTA5 28433,2083,80,2003,0.03840614498319731,1.256837890199767
ZCTA5 99572,203,10,193,0.04926108374384237,1.252437519792618
ZCTA5 31792,9247,331,8916,0.03579539310046501,1.2519634691491475
ZCTA5 87038,179,9,170,0.05027932960893855,1.251834185735958
ZCTA5 81610,132,7,125,0.05303030303030303,1.2507636757041405
ZCTA5 70507,6198,225,5973,0.03630203291384317,1.2467974695530402
ZCTA5 17724,1891,73,1818,0.03860391327340032,1.245339601298623
ZCTA5 59920,638,27,611,0.04231974921630094,1.2453078168128227
ZCTA5 83626,481,21,460,0.04365904365904366,1.2446290713937387
ZCTA5 96747,228,11,217,0.04824561403508772,1.2420492462245547
ZCTA5 98240,1176,47,1129,0.039965986394557826,1.241834333323877
ZCTA5 37142,718,30,688,0.04178272980501393,1.2410553189764368
ZCTA5 17880,45,3,42,0.06666666666666667,1.2389959603393632
ZCTA5 61432,253,12,241,0.04743083003952569,1.2363013513707288
ZCTA5 92347,253,12,241,0.04743083003952569,1.2363013513707288
ZCTA5 65617,456,20,436,0.043859649122807015,1.2356752240313387
ZCTA5 86403,7525,271,7254,0.03601328903654485,1.2345066119844916
ZCTA5 76538,303,14,289,0.0462046204620462,1.2342617974143024
ZCTA5 62078,26,2,24,0.07692307692307693,1.2326158500378035
ZCTA5 73719,26,2,24,0.07692307692307693,1.2326158500378035
ZCTA5 83856,2536,96,2440,0.03785488958990536,1.2324055272878232
ZCTA5 20904,20543,719,19824,0.03499975660809035,1.2318735458358607
ZCTA5 62953,110,6,104,0.05454545454545454,1.2301579759400987
ZCTA5 68943,110,6,104,0.05454545454545454,1.2301579759400987
ZCTA5 39842,2902,109,2793,0.037560303239145415,1.230088890191294
ZCTA5 02122,8536,306,8230,0.03584817244611059,1.2299870671164832
ZCTA5 36750,988,40,948,0.04048582995951417,1.2291208316845947
ZCTA5 94516,66,4,62,0.06060606060606061,1.2266874470113898
ZCTA5 75691,1398,55,1343,0.03934191702432046,1.2242215537126757
ZCTA5 54119,254,12,242,0.047244094488188976,1.2221918815484332
ZCTA5 74833,304,14,290,0.046052631578947366,1.2215597644338634
ZCTA5 45769,2623,99,2524,0.03774304231795654,1.2215109784426201
ZCTA5 32068,19383,679,18704,0.03503069700252799,1.2205433222231994
ZCTA5 73030,1592,62,1530,0.038944723618090454,1.2182727759595764
ZCTA5 85135,181,9,172,0.049723756906077346,1.217241758116723
ZCTA5 22030,19357,678,18679,0.035026088753422537,1.216158959386596
ZCTA5 32421,1814,70,1744,0.03858875413450937,1.2161309785822583
ZCTA5 71858,882,36,846,0.04081632653061224,1.215899852722095
ZCTA5 38868,2009,77,1932,0.03832752613240418,1.2147144388149371
ZCTA5 60173,5695,207,5488,0.036347673397717294,1.2142891037004233
ZCTA5 97623,1072,43,1029,0.04011194029850746,1.2122276092733433
ZCTA5 74038,802,33,769,0.04114713216957606,1.2115447179975998
ZCTA5 81435,2317,88,2229,0.03798014674147605,1.2115207804559913
ZCTA5 60641,24773,863,23910,0.0348363137286562,1.2097084710063188
ZCTA5 39665,537,23,514,0.04283054003724395,1.2083183005289277
ZCTA5 10003,26124,909,25215,0.034795590261828206,1.205652512396917
ZCTA5 30434,1872,72,1800,0.038461538461538464,1.2048104807981042
ZCTA5 31738,803,33,770,0.0410958904109589,1.20422476491648
ZCTA5 84523,643,27,616,0.041990668740279936,1.2037723880212956
ZCTA5 39114,3503,130,3373,0.03711104767342278,1.2036056699810782
ZCTA5 73763,804,33,771,0.041044776119402986,1.196914388525444
ZCTA5 04238,486,21,465,0.043209876543209874,1.1960145896759855
ZCTA5 59747,67,4,63,0.05970149253731343,1.1947698199603456
ZCTA5 75942,67,4,63,0.05970149253731343,1.1947698199603456
ZCTA5 16733,89,5,84,0.056179775280898875,1.1922630736884425
ZCTA5 78067,207,10,197,0.04830917874396135,1.1885539834100474
ZCTA5 72004,409,18,391,0.044009779951100246,1.1871480141724104
ZCTA5 35179,3310,123,3187,0.03716012084592145,1.1856800149930766
ZCTA5 28602,11338,402,10936,0.03545598871053096,1.1853289790197186
ZCTA5 75474,5334,194,5140,0.03637045369328834,1.1844251080805923
ZCTA5 21658,1433,56,1377,0.039078855547801813,1.1840726872792415
ZCTA5 87017,112,6,106,0.05357142857142857,1.1839660346045557
ZCTA5 80451,307,14,293,0.04560260586319218,1.1837223931637155
ZCTA5 95459,232,11,221,0.047413793103448273,1.1824379612396414
ZCTA5 15677,159,8,151,0.050314465408805034,1.1822922563513067
ZCTA5 93224,159,8,151,0.050314465408805034,1.1822922563513067
ZCTA5 39345,2521,95,2426,0.03768345894486315,1.1808881887812626
ZCTA5 78721,4278,157,4121,0.036699392239364186,1.1803678216024454
ZCTA5 17004,1711,66,1645,0.0385739333722969,1.1776908745047971
ZCTA5 67661,1407,55,1352,0.03909026297085998,1.1756613201605894
ZCTA5 99591,27,2,25,0.07407407407407407,1.1737701867656432
ZCTA5 29434,208,10,198,0.04807692307692308,1.1727936463592774
ZCTA5 13309,2327,88,2239,0.03781693167168027,1.1703477615763085
ZCTA5 62816,515,22,493,0.04271844660194175,1.1691616329409842
ZCTA5 04735,258,12,246,0.046511627906976744,1.1663502734129736
ZCTA5 80861,90,5,85,0.05555555555555555,1.1660101840005386
ZCTA5 83278,90,5,85,0.05555555555555555,1.1660101840005386
ZCTA5 97420,11465,406,11059,0.035412123855211516,1.1658294658167783
ZCTA5 79906,1189,47,1142,0.03952901597981497,1.1648866633329007
ZCTA5 28628,160,8,152,0.05,1.1638837741094747
ZCTA5 50067,113,6,107,0.05309734513274336,1.161214107337336
ZCTA5 42409,917,37,880,0.04034896401308615,1.161085262636238
ZCTA5 98433,4199,154,4045,0.03667539890450107,1.1607721336095531
ZCTA5 10004,1659,64,1595,0.038577456298975285,1.160454827395573
ZCTA5 79934,8917,318,8599,0.035662218234832344,1.1594859201434382
ZCTA5 62879,47,3,44,0.06382978723404255,1.1580733119413715
ZCTA5 58781,284,13,271,0.045774647887323945,1.1546412632994127
ZCTA5 56763,1939,74,1865,0.038164002062919034,1.1533208852968373
ZCTA5 40214,17650,618,17032,0.03501416430594901,1.1524880309298409
ZCTA5 70392,3178,118,3060,0.037130270610446825,1.152439427554578
ZCTA5 72569,137,7,130,0.051094890510948905,1.1482535496418278
ZCTA5 95653,137,7,130,0.051094890510948905,1.1482535496418278
ZCTA5 97324,491,21,470,0.04276985743380855,1.1479291977519444
ZCTA5 72370,3151,117,3034,0.037131069501745474,1.1477828624314845
ZCTA5 77386,17158,601,16557,0.03502739246998485,1.1459474801063643
ZCTA5 44127,1829,70,1759,0.03827227993439038,1.1458810898367346
ZCTA5 99139,544,23,521,0.042279411764705885,1.144683186470497
ZCTA5 11516,2165,82,2083,0.03787528868360277,1.1439748489573214
ZCTA5 27546,6846,246,6600,0.03593339176161262,1.140730541957583
ZCTA5 59078,91,5,86,0.054945054945054944,1.1400831814630756
ZCTA5 95327,2447,92,2355,0.03759705762157744,1.1396591102253928
ZCTA5 38573,812,33,779,0.04064039408866995,1.1387728963606603
ZCTA5 44874,114,6,108,0.05263157894736842,1.1386852771303757
ZCTA5 58723,114,6,108,0.05263157894736842,1.1386852771303757
ZCTA5 96757,235,11,224,0.04680851063829787,1.1384578282468543
ZCTA5 68748,1002,40,962,0.03992015968063872,1.1382212397310187
ZCTA5 34114,7251,260,6991,0.035857123155426836,1.1378710880689695
ZCTA5 63660,1084,43,1041,0.03966789667896679,1.1376911727734738
ZCTA5 35460,362,16,346,0.04419889502762431,1.1368666614063552
ZCTA5 79312,362,16,346,0.04419889502762431,1.1368666614063552
ZCTA5 14855,311,14,297,0.04501607717041801,1.1338871648883961
ZCTA5 28642,2336,88,2248,0.03767123287671233,1.1334476617043627
ZCTA5 95007,286,13,273,0.045454545454545456,1.1285950109538772
ZCTA5 47441,3953,145,3808,0.036681001770806985,1.128215855499474
ZCTA5 75470,162,8,154,0.04938271604938271,1.1274430828167477
ZCTA5 78545,162,8,154,0.04938271604938271,1.1274430828167477
ZCTA5 15088,162,8,154,0.04938271604938271,1.1274430828167477
ZCTA5 16133,599,25,574,0.041736227045075125,1.1272250072709553
ZCTA5 95811,3299,122,3177,0.036980903304031525,1.1264635731972745
ZCTA5 65082,363,16,347,0.0440771349862259,1.1255348995125538
ZCTA5 77622,441,19,422,0.04308390022675737,1.124586806237686
ZCTA5 62087,787,32,755,0.04066073697585769,1.1242791551439615
ZCTA5 17853,1141,45,1096,0.03943908851884312,1.1242384991362702
ZCTA5 67127,236,11,225,0.046610169491525424,1.123932882287795
ZCTA5 22102,10589,375,10214,0.03541410898101804,1.1215421206778144
ZCTA5 70754,4355,159,4196,0.0365097588978186,1.1213491854416782
ZCTA5 63673,680,28,652,0.041176470588235294,1.1198499717569212
ZCTA5 46050,734,30,704,0.04087193460490463,1.117582464147525
ZCTA5 57661,28,2,26,0.07142857142857142,1.1174605304911351
ZCTA5 58768,115,6,109,0.05217391304347826,1.1163750186474712
ZCTA5 05730,115,6,109,0.05217391304347826,1.1163750186474712
ZCTA5 64752,287,13,274,0.04529616724738676,1.115645302903975
ZCTA5 66527,92,5,87,0.05434782608695652,1.1144737750201958
ZCTA5 24244,2172,82,2090,0.037753222836095765,1.1141863260357474
ZCTA5 13122,416,18,398,0.04326923076923077,1.113266893945464
ZCTA5 47273,681,28,653,0.041116005873715125,1.111898258376953
ZCTA5 14613,4874,177,4697,0.03631514156750103,1.1107271964973016
ZCTA5 97857,212,10,202,0.04716981132075472,1.1105667954259046
ZCTA5 39478,843,34,809,0.04033214709371293,1.1105360196764693
ZCTA5 65793,2398,90,2308,0.03753127606338615,1.1102768729656614
ZCTA5 40119,735,30,705,0.04081632653061224,1.1099596283385011
ZCTA5 63736,1447,56,1391,0.038700760193503804,1.1098594584582584
ZCTA5 45416,2370,89,2281,0.03755274261603375,1.1095874755987096
ZCTA5 52555,163,8,155,0.049079754601226995,1.109407298407868
ZCTA5 99140,163,8,155,0.049079754601226995,1.109407298407868
ZCTA5 95553,469,20,449,0.042643923240938165,1.1067503517239856
ZCTA5 74826,417,18,399,0.04316546762589928,1.10282065227985
ZCTA5 75853,288,13,275,0.04513888888888889,1.1027440177024492
ZCTA5 58426,70,4,66,0.05714285714285714,1.1021779154948281
ZCTA5 49112,3877,142,3735,0.03662625741552747,1.0983615734420538
ZCTA5 98840,1813,69,1744,0.038058466629895205,1.0902293253926771
ZCTA5 36925,1257,49,1208,0.03898170246618934,1.0898227100388795
ZCTA5 63937,1037,41,996,0.03953712632594021,1.0893352530472384
ZCTA5 28137,1120,44,1076,0.039285714285714285,1.0853000602233958
ZCTA5 04780,264,12,252,0.045454545454545456,1.0843190129860587
ZCTA5 17212,264,12,252,0.045454545454545456,1.0843190129860587
ZCTA5 97497,658,27,631,0.041033434650455926,1.0811815328458596
ZCTA5 17867,49,3,46,0.061224489795918366,1.0810376691036756
ZCTA5 38914,239,11,228,0.04602510460251046,1.0807541788177175
ZCTA5 30428,929,37,892,0.03982777179763186,1.080315292770417
ZCTA5 36922,214,10,204,0.04672897196261682,1.0799297089025384
ZCTA5 92782,8059,287,7772,0.03561235885345576,1.0774005728442289
ZCTA5 34760,290,13,277,0.04482758620689655,1.0770851755257935
ZCTA5 81019,525,22,503,0.0419047619047619,1.0767771978695362
ZCTA5 15410,525,22,503,0.0419047619047619,1.0767771978695362
ZCTA5 48915,3827,140,3687,0.036582179252678336,1.076091968765641
ZCTA5 77545,7192,257,6935,0.035734149054505004,1.0752358319421187
ZCTA5 37166,5289,191,5098,0.03611268670826243,1.075168078804444
ZCTA5 40175,5289,191,5098,0.03611268670826243,1.075168078804444
ZCTA5 75972,2407,90,2317,0.03739094308267553,1.0740705804139004
ZCTA5 91607,13673,480,13193,0.035105682732392306,1.073880887651919
ZCTA5 14820,316,14,302,0.04430379746835443,1.0725519549946867
ZCTA5 74935,71,4,67,0.056338028169014086,1.0723092765988547
ZCTA5 95709,1929,73,1856,0.03784344219803007,1.072047241949488
ZCTA5 12120,265,12,253,0.045283018867924525,1.0708426346614195
ZCTA5 37380,2634,98,2536,0.03720577069096431,1.0707262593215956
ZCTA5 39082,394,17,377,0.04314720812182741,1.0699602009809162
ZCTA5 76934,368,16,352,0.043478260869565216,1.0693715201518
ZCTA5 47224,240,11,229,0.04583333333333333,1.0664912028187916
ZCTA5 14433,1539,59,1480,0.03833658219623132,1.0651477163810688
ZCTA5 25174,215,10,205,0.046511627906976744,1.0647272578343394
ZCTA5 75773,4862,176,4686,0.03619909502262444,1.0643600269702096
ZCTA5 35070,94,5,89,0.05319148936170213,1.0641760886522857
ZCTA5 13113,94,5,89,0.05319148936170213,1.0641760886522857
ZCTA5 56352,2297,86,2211,0.03744013931214628,1.062353247376801
ZCTA5 33617,18006,628,17378,0.03487726313451072,1.0618932907346672
ZCTA5 37863,2750,102,2648,0.03709090909090909,1.0605524775092545
ZCTA5 44633,823,33,790,0.040097205346294046,1.0598012818009408
ZCTA5 16402,343,15,328,0.043731778425655975,1.0585196422651761
ZCTA5 45868,266,12,254,0.045112781954887216,1.0574208200331947
ZCTA5 56121,266,12,254,0.045112781954887216,1.0574208200331947
ZCTA5 91963,266,12,254,0.045112781954887216,1.0574208200331947
ZCTA5 79322,742,30,712,0.04043126684636118,1.0569024677116194
ZCTA5 05739,554,23,531,0.04151624548736462,1.0552627674709454
ZCTA5 13832,241,11,230,0.04564315352697095,1.0522921518699302
ZCTA5 27954,3065,113,2952,0.03686786296900489,1.0509758800814122
ZCTA5 82516,191,9,182,0.04712041884816754,1.050332088510597
ZCTA5 79311,1264,49,1215,0.038765822784810125,1.0501706446659633
ZCTA5 72068,142,7,135,0.04929577464788732,1.0497945520860719
ZCTA5 49967,216,10,206,0.046296296296296294,1.049601097252226
ZCTA5 29742,1016,40,976,0.03937007874015748,1.048638121736071
ZCTA5 73945,1016,40,976,0.03937007874015748,1.048638121736071
ZCTA5 47952,1237,48,1189,0.038803556992724336,1.0462743349152697
ZCTA5 27974,449,19,430,0.042316258351893093,1.044283712807508
ZCTA5 67859,267,12,255,0.0449438202247191,1.04405309803034
ZCTA5 03238,50,3,47,0.06,1.0438621729657864
ZCTA5 51009,72,4,68,0.05555555555555555,1.0429112135528968
ZCTA5 72921,5273,190,5083,0.03603261900246539,1.0412073222452871
ZCTA5 98626,9238,327,8911,0.035397272136826155,1.0385562407513538
ZCTA5 49959,167,8,159,0.04790419161676647,1.0384545528828406
ZCTA5 73542,1712,65,1647,0.037967289719626166,1.0384467839894458
ZCTA5 32622,371,16,355,0.0431266846361186,1.0360624521875874
ZCTA5 70341,1517,58,1459,0.03823335530652604,1.035148356279556
ZCTA5 05775,217,10,207,0.04608294930875576,1.0345504150484441
ZCTA5 36562,450,19,431,0.042222222222222223,1.0343525788368912
ZCTA5 77564,637,26,611,0.04081632653061224,1.0333161792674261
ZCTA5 10036,16183,565,15618,0.03491318049805351,1.0321135044290708
ZCTA5 08091,2107,79,2028,0.03749406739439962,1.0312339911799193
ZCTA5 37915,2616,97,2519,0.03707951070336391,1.0311487942433373
ZCTA5 52542,143,7,136,0.04895104895104895,1.0305597653425635
ZCTA5 91915,8255,293,7962,0.03549364021804967,1.0304386882946572
ZCTA5 96003,18058,629,17429,0.034832207331930445,1.029755087012681
ZCTA5 18244,119,6,113,0.05042016806722689,1.0292337287988733
ZCTA5 05765,692,28,664,0.04046242774566474,1.025230087237599
ZCTA5 88046,372,16,356,0.043010752688172046,1.025023053307779
ZCTA5 95573,665,27,638,0.0406015037593985,1.0249748546467803
ZCTA5 63620,531,22,509,0.04143126177024482,1.0222348339579372
ZCTA5 84528,883,35,848,0.039637599093997736,1.0218033232998953
ZCTA5 17566,4045,147,3898,0.03634116192830655,1.0210712376542934
ZCTA5 55795,585,24,561,0.041025641025641026,1.0183962547971122
ZCTA5 75449,585,24,561,0.041025641025641026,1.0183962547971122
ZCTA5 67137,193,9,184,0.046632124352331605,1.0180923766560905
ZCTA5 05680,911,36,875,0.03951701427003293,1.0176374118236635
ZCTA5 54566,612,25,587,0.04084967320261438,1.0174238828489783
ZCTA5 34207,15023,525,14498,0.0349464154962391,1.0170883110255093
ZCTA5 59088,639,26,613,0.0406885758998435,1.0169782966892378
ZCTA5 28736,295,13,282,0.04406779661016949,1.0137589777542237
ZCTA5 76864,295,13,282,0.04406779661016949,1.0137589777542237
ZCTA5 61109,10881,383,10498,0.03519897068284165,1.01210046262256
ZCTA5 61323,30,2,28,0.06666666666666667,1.0116359654003544
ZCTA5 69157,30,2,28,0.06666666666666667,1.0116359654003544
ZCTA5 68442,144,7,137,0.04861111111111111,1.0114715760726969
ZCTA5 64778,244,11,233,0.045081967213114756,1.0100724966881678
ZCTA5 32603,1718,65,1653,0.03783469150174622,1.0097007440942949
ZCTA5 74366,613,25,588,0.040783034257748776,1.0090794463855426
ZCTA5 28573,885,35,850,0.03954802259887006,1.0081405244045376
ZCTA5 61333,120,6,114,0.05,1.007952915431314
ZCTA5 08882,5574,200,5374,0.03588087549336204,1.0075103155449234
ZCTA5 17547,2708,100,2608,0.03692762186115214,1.0051684301474526
ZCTA5 85627,453,19,434,0.04194260485651214,1.0046986263543334
ZCTA5 37656,1663,63,1600,0.03788334335538184,1.0044403942677427
ZCTA5 50609,194,9,185,0.04639175257731959,1.0021078942206934
ZCTA5 74546,296,13,283,0.04391891891891892,1.0012315411029558
ZCTA5 68376,668,27,641,0.040419161676646706,1.0010759602788184
ZCTA5 59741,1748,66,1682,0.03775743707093822,1.0005162653430653
ZCTA5 49404,3023,111,2912,0.03671849156467086,0.998078263987913
ZCTA5 79381,507,21,486,0.04142011834319527,0.9974710196017869
ZCTA5 82321,245,11,234,0.044897959183673466,0.9961231350394291
ZCTA5 74429,5291,190,5101,0.03591003591003591,0.9933965469827687
ZCTA5 49805,145,7,138,0.04827586206896552,0.9925276392777905
ZCTA5 71355,1219,47,1172,0.03855619360131255,0.9906054403517424
ZCTA5 90807,12644,443,12201,0.03503638089212274,0.9893454924854402
ZCTA5 51649,121,6,115,0.049586776859504134,0.9868661364775593
ZCTA5 81044,121,6,115,0.049586776859504134,0.9868661364775593
ZCTA5 17355,121,6,115,0.049586776859504134,0.9868661364775593
ZCTA5 98208,20435,709,19726,0.03469537558111084,0.9866575019629785
ZCTA5 96065,170,8,162,0.047058823529411764,0.9864442847254683
ZCTA5 37023,535,22,513,0.041121495327102804,0.9862327827452657
ZCTA5 97412,195,9,186,0.046153846153846156,0.9862122343019241
ZCTA5 74521,74,4,70,0.05405405405405406,0.9854670553944918
ZCTA5 96764,246,11,235,0.044715447154471545,0.9822347342021275
ZCTA5 49322,482,20,462,0.04149377593360996,0.9815606554022214
ZCTA5 15716,272,12,260,0.04411764705882353,0.9780097997603354
ZCTA5 51342,536,22,514,0.041044776119402986,0.977276505894225
ZCTA5 47804,4722,170,4552,0.03600169419737399,0.9734887312915419
ZCTA5 75641,52,3,49,0.057692307692307696,0.9719918995595934
ZCTA5 64037,2376,88,2288,0.037037037037037035,0.9711972372303073
ZCTA5 98847,699,28,671,0.04005722460658083,0.970826013685007
ZCTA5 52042,618,25,593,0.040453074433656956,0.9675702897008597
ZCTA5 12182,6110,218,5892,0.03567921440261866,0.9671791955632336
ZCTA5 37348,351,15,336,0.042735042735042736,0.966945083850773
ZCTA5 56748,273,12,261,0.04395604395604396,0.9649570665125747
ZCTA5 79561,273,12,261,0.04395604395604396,0.9649570665125747
ZCTA5 17372,1615,61,1554,0.03777089783281734,0.9647084769954574
ZCTA5 46919,1057,41,1016,0.03878902554399243,0.9645324545264801
ZCTA5 14590,2151,80,2071,0.037192003719200374,0.9640379047676347
ZCTA5 31552,299,13,286,0.043478260869565216,0.963918462107047
ZCTA5 72125,299,13,286,0.043478260869565216,0.963918462107047
ZCTA5 49424,17783,618,17165,0.03475229151436766,0.9626190699317289
ZCTA5 89832,484,20,464,0.04132231404958678,0.9626174951701147
ZCTA5 43467,31,2,29,0.06451612903225806,0.9617711097183825
ZCTA5 99638,12,1,11,0.08333333333333333,0.9608868267463616
ZCTA5 01367,222,10,212,0.04504504504504504,0.960401622939086
ZCTA5 77991,75,4,71,0.05333333333333334,0.9573927787548477
ZCTA5 54726,701,28,673,0.039942938659058486,0.9553865786542253
ZCTA5 64120,147,7,140,0.047619047619047616,0.9550634134271714
ZCTA5 29590,838,33,805,0.03937947494033413,0.9538718806678049
ZCTA5 63454,326,14,312,0.04294478527607362,0.9529336977459352
ZCTA5 56262,274,12,262,0.043795620437956206,0.9519552891787126
ZCTA5 37207,14421,503,13918,0.034879689341931905,0.9519404349465318
ZCTA5 35654,2865,105,2760,0.03664921465968586,0.951024285525867
ZCTA5 54454,539,22,517,0.04081632653061224,0.9505126385957836
ZCTA5 87031,15242,531,14711,0.03483794777588243,0.9500043029948653
ZCTA5 26571,839,33,806,0.03933253873659118,0.9468803196075283
ZCTA5 97906,123,6,117,0.04878048780487805,0.9452600016516581
ZCTA5 07660,4761,171,4590,0.035916824196597356,0.9449344377354518
ZCTA5 79046,249,11,238,0.04417670682730924,0.9409296487481706
ZCTA5 99157,301,13,288,0.04318936877076412,0.939264002904833
ZCTA5 57268,198,9,189,0.045454545454545456,0.9390478110523953
ZCTA5 43014,1284,49,1235,0.0381619937694704,0.9381203054013445
ZCTA5 17021,380,16,364,0.042105263157894736,0.9378253131155424
ZCTA5 07657,3900,141,3759,0.036153846153846154,0.9375498224019893
ZCTA5 57341,53,3,50,0.05660377358490566,0.9372234619698063
ZCTA5 79380,53,3,50,0.05660377358490566,0.9372234619698063
ZCTA5 91741,8941,315,8626,0.03523095850575998,0.9342702821867553
ZCTA5 93720,17979,624,17355,0.03470715835140998,0.9342550250313832
ZCTA5 47842,4275,154,4121,0.0360233918128655,0.9341559704177629
ZCTA5 04572,2300,85,2215,0.036956521739130437,0.9340647555466136
ZCTA5 38201,4160,150,4010,0.036057692307692304,0.9338086208043733
ZCTA5 92561,595,24,571,0.040336134453781515,0.933531652216251
ZCTA5 62685,979,38,941,0.03881511746680286,0.9328023173435852
ZCTA5 75452,1453,55,1398,0.03785271851342051,0.9323897829196558
ZCTA5 65772,704,28,676,0.03977272727272727,0.932313449001978
ZCTA5 65756,224,10,214,0.044642857142857144,0.9312433976530872
ZCTA5 73569,224,10,214,0.044642857142857144,0.9312433976530872
ZCTA5 16875,1482,56,1426,0.037786774628879895,0.9275308308411123
ZCTA5 04568,250,11,239,0.044,0.9272794814836637
ZCTA5 31625,381,16,365,0.04199475065616798,0.9270624667749472
ZCTA5 73449,1091,42,1049,0.0384967919340055,0.9262433372087499
ZCTA5 95526,124,6,118,0.04838709677419355,0.9247335566738049
ZCTA5 70592,8277,292,7985,0.03527848254198381,0.9229538336091624
ZCTA5 69127,408,17,391,0.041666666666666664,0.9224954628820977
ZCTA5 96069,355,15,340,0.04225352112676056,0.921985424449592
ZCTA5 75144,1259,48,1211,0.03812549642573471,0.9217408841526877
ZCTA5 68936,100,5,95,0.05,0.9201309144747131
ZCTA5 76261,100,5,95,0.05,0.9201309144747131
ZCTA5 79378,100,5,95,0.05,0.9201309144747131
ZCTA5 76665,981,38,943,0.03873598369011213,0.9199711415079428
ZCTA5 68855,174,8,166,0.04597701149425287,0.9186242442876362
ZCTA5 99137,174,8,166,0.04597701149425287,0.9186242442876362
ZCTA5 47860,149,7,142,0.04697986577181208,0.9181493865648267
ZCTA5 32193,329,14,315,0.0425531914893617,0.9178083395562282
ZCTA5 56237,225,10,215,0.044444444444444446,0.9167687652272762
ZCTA5 74860,597,24,573,0.04020100502512563,0.9167381308864887
ZCTA5 49013,1964,73,1891,0.037169042769857434,0.9155215185120865
ZCTA5 19007,8019,283,7736,0.03529118343933159,0.9147803506936564
ZCTA5 74854,679,27,652,0.039764359351988215,0.914397362193205
ZCTA5 36744,2619,96,2523,0.03665521191294387,0.9109855561020093
ZCTA5 34736,6104,217,5887,0.03555045871559633,0.9107623447629325
ZCTA5 33184,6104,217,5887,0.03555045871559633,0.9107623447629325
ZCTA5 53936,625,25,600,0.04,0.9100444667324024
ZCTA5 03574,1066,41,1025,0.038461538461538464,0.9091685768409458
ZCTA5 96034,125,6,119,0.048,0.9043869607922493
ZCTA5 59743,54,3,51,0.05555555555555555,0.9031876048284664
ZCTA5 68441,77,4,73,0.05194805194805195,0.9024740595535865
ZCTA5 84063,77,4,73,0.05194805194805195,0.9024740595535865
ZCTA5 97884,77,4,73,0.05194805194805195,0.9024740595535865
ZCTA5 62921,175,8,167,0.045714285714285714,0.9019322787479518
ZCTA5 66858,175,8,167,0.045714285714285714,0.9019322787479518
ZCTA5 72430,150,7,143,0.04666666666666667,0.8998933847903455
ZCTA5 40311,2708,99,2609,0.03655834564254062,0.8983026114368574
ZCTA5 40142,846,33,813,0.03900709219858156,0.8981806846867357
ZCTA5 67052,2623,96,2527,0.036599313762866945,0.8957603541385419
ZCTA5 81076,201,9,192,0.04477611940298507,0.8926461617144251
ZCTA5 81222,201,9,192,0.04477611940298507,0.8926461617144251
ZCTA5 70353,600,24,576,0.04,0.8916578346950427
ZCTA5 37325,682,27,655,0.039589442815249266,0.891012089510679
ZCTA5 98106,10860,380,10480,0.034990791896869246,0.8904768837616128
ZCTA5 70658,305,13,292,0.04262295081967213,0.8904732944054067
ZCTA5 40771,519,21,498,0.04046242774566474,0.8878753002718969
ZCTA5 46761,3830,138,3692,0.03603133159268929,0.8869329970920603
ZCTA5 92305,253,11,242,0.043478260869565216,0.8866760234588748
ZCTA5 59856,126,6,120,0.047619047619047616,0.8842169047082573
ZCTA5 16637,959,37,922,0.03858185610010428,0.8830537951153057
ZCTA5 85648,6174,219,5955,0.03547133138969873,0.8813938624308804
ZCTA5 78827,412,17,395,0.0412621359223301,0.8813435911438152
ZCTA5 76078,3143,114,3029,0.03627107858733694,0.8782049030420629
ZCTA5 14207,9465,332,9133,0.03507659799260433,0.8777435481109772
ZCTA5 59420,78,4,74,0.05128205128205128,0.875605032532982
ZCTA5 62984,684,27,657,0.039473684210526314,0.8754813867125141
ZCTA5 04563,602,24,578,0.03986710963455149,0.8750103115312498
ZCTA5 98565,228,10,218,0.043859649122807015,0.8737543302567657
ZCTA5 37013,35376,1213,34163,0.03428878335594753,0.8728940786406605
ZCTA5 33143,12274,428,11846,0.034870457878442236,0.8725361148828868
ZCTA5 02131,12684,442,12242,0.034847051403342794,0.8723297057959875
ZCTA5 65334,333,14,319,0.042042042042042045,0.8714988453890222
ZCTA5 97132,10403,364,10039,0.034989906757666056,0.8710373646122124
ZCTA5 79062,55,3,52,0.05454545454545454,0.8698530467179615
ZCTA5 83465,55,3,52,0.05454545454545454,0.8698530467179615
ZCTA5 86333,2630,96,2534,0.03650190114068441,0.869173279441806
ZCTA5 29845,467,19,448,0.04068522483940043,0.8689973997128877
ZCTA5 82430,33,2,31,0.06060606060606061,0.8673990121781673
ZCTA5 70615,4847,173,4674,0.03569218073034867,0.8664558193808791
ZCTA5 13478,1073,41,1032,0.03821062441752097,0.86644121375888
ZCTA5 94508,1073,41,1032,0.03821062441752097,0.86644121375888
ZCTA5 78123,1101,42,1059,0.03814713896457766,0.8659586317918934
ZCTA5 26704,2004,74,1930,0.036926147704590816,0.86432884682877
ZCTA5 83203,127,6,121,0.047244094488188976,0.8642201673540428
ZCTA5 04766,152,7,145,0.046052631578947366,0.8637731930558263
ZCTA5 84107,13774,479,13295,0.03477566429504864,0.8624469695458271
ZCTA5 27258,2775,101,2674,0.0363963963963964,0.8619042366844593
ZCTA5 76621,334,14,320,0.041916167664670656,0.8600133825157898
ZCTA5 83846,334,14,320,0.041916167664670656,0.8600133825157898
ZCTA5 95220,2547,93,2454,0.03651354534746761,0.8586162786800821
ZCTA5 40055,714,28,686,0.0392156862745098,0.8561366021843154
ZCTA5 29565,2606,95,2511,0.036454336147352266,0.8516951468249891
ZCTA5 51510,1356,51,1305,0.03761061946902655,0.8511521604764053
ZCTA5 50064,79,4,75,0.05063291139240506,0.8491140533040319
ZCTA5 74543,153,7,146,0.0457516339869281,0.8459050540181323
ZCTA5 65646,688,27,661,0.03924418604651163,0.8445613091877446
ZCTA5 28396,1021,39,982,0.03819784524975514,0.8429148464139539
ZCTA5 47142,416,17,399,0.040865384615384616,0.8406100006450534
ZCTA5 23665,1358,51,1307,0.03755522827687776,0.8404281096948938
ZCTA5 96055,1556,58,1498,0.037275064267352186,0.8381542358267325
ZCTA5 30056,827,32,795,0.03869407496977025,0.8379782296217071
ZCTA5 72044,283,12,271,0.04240282685512368,0.8371636617742096
ZCTA5 83543,283,12,271,0.04240282685512368,0.8371636617742096
ZCTA5 43976,634,25,609,0.03943217665615142,0.837063501305119
ZCTA5 88256,689,27,662,0.03918722786647315,0.8368605056253675
ZCTA5 28366,2239,82,2157,0.03662349263063868,0.8339610589396866
ZCTA5 12965,205,9,196,0.04390243902439024,0.8319191584263347
ZCTA5 17923,205,9,196,0.04390243902439024,0.8319191584263347
ZCTA5 43347,580,23,557,0.039655172413793106,0.8304882398155863
ZCTA5 99612,284,12,272,0.04225352112676056,0.8246488333333137
ZCTA5 73939,499,20,479,0.04008016032064128,0.8231121572129129
ZCTA5 67519,80,4,76,0.05,0.8229901091858015
ZCTA5 84653,2356,86,2270,0.0365025466893039,0.8228262101455119
ZCTA5 75633,5182,184,4998,0.03550752605171748,0.8219763660617124
ZCTA5 91311,14122,490,13632,0.0346976348959071,0.8217071479912283
ZCTA5 10578,258,11,247,0.04263565891472868,0.8201293627936427
ZCTA5 74026,311,13,298,0.04180064308681672,0.818544340727796
ZCTA5 23407,232,10,222,0.04310344827586207,0.8173318058622173
ZCTA5 22851,2358,86,2272,0.0364715860899067,0.8148146491513643
ZCTA5 16926,365,15,350,0.0410958904109589,0.8118881708815208
ZCTA5 28526,1223,46,1177,0.03761242845461979,0.8086853347153928
ZCTA5 12116,748,29,719,0.03877005347593583,0.8085053834640594
ZCTA5 33182,3769,135,3634,0.03581851950119395,0.8071854317973832
ZCTA5 55613,105,5,100,0.047619047619047616,0.8071759073935142
ZCTA5 49718,312,13,299,0.041666666666666664,0.8066988806055689
ZCTA5 31083,130,6,124,0.046153846153846156,0.8052389173766143
ZCTA5 59418,57,3,54,0.05263157894736842,0.8051720810961718
ZCTA5 49004,6380,225,6155,0.03526645768025078,0.8049735468392791
ZCTA5 20606,181,8,173,0.04419889502762431,0.8038861255853443
ZCTA5 72046,1648,61,1587,0.037014563106796114,0.8037667254315877
ZCTA5 97733,233,10,223,0.04291845493562232,0.8033878758777946
ZCTA5 66080,339,14,325,0.04129793510324484,0.803125068841965
ZCTA5 76707,5015,178,4837,0.035493519441674976,0.8031069153626834
ZCTA5 38849,2161,79,2082,0.036557149467838966,0.8021550582810513
ZCTA5 93202,1112,42,1070,0.03776978417266187,0.8002951152899909
ZCTA5 40152,393,16,377,0.04071246819338423,0.8001832955924484
ZCTA5 62990,286,12,274,0.04195804195804196,0.7997584249242665
ZCTA5 63472,286,12,274,0.04195804195804196,0.7997584249242665
ZCTA5 50213,2821,102,2719,0.03615739099610067,0.798423835819176
ZCTA5 23047,722,28,694,0.038781163434903045,0.7959896820996222
ZCTA5 55402,313,13,300,0.04153354632587859,0.7948933945208833
ZCTA5 95017,260,11,249,0.04230769230769231,0.7938930768747152
ZCTA5 62917,945,36,909,0.0380952380952381,0.7933951962709973
ZCTA5 80743,475,19,456,0.04,0.793358372922981
ZCTA5 88311,475,19,456,0.04,0.793358372922981
ZCTA5 87062,394,16,378,0.04060913705583756,0.7897944546737369
ZCTA5 57454,234,10,224,0.042735042735042736,0.7895073549090296
ZCTA5 76705,10477,365,10112,0.03483821704686456,0.78778475504287
ZCTA5 52229,287,12,275,0.041811846689895474,0.7873821028136813
ZCTA5 74347,974,37,937,0.037987679671457907,0.7868094559008421
ZCTA5 73742,1538,57,1481,0.03706111833550065,0.7866321320443616
ZCTA5 93505,4008,143,3865,0.03567864271457086,0.7831385350661726
ZCTA5 83217,314,13,301,0.041401273885350316,0.7831275907898576
ZCTA5 06704,8987,314,8673,0.03493935684878157,0.7829398688100667
ZCTA5 63876,835,32,803,0.03832335329341317,0.7824479025063124
ZCTA5 17864,724,28,696,0.03867403314917127,0.7810609861079315
ZCTA5 38545,641,25,616,0.0390015600624025,0.7810424775467086
ZCTA5 63936,341,14,327,0.04105571847507331,0.7806167620549852
ZCTA5 41216,422,17,405,0.04028436018957346,0.7802739792214209
ZCTA5 78880,586,23,563,0.03924914675767918,0.7801133443578594
ZCTA5 48225,5489,194,5295,0.03534341410092913,0.7783583630823592
ZCTA5 65652,1285,48,1237,0.03735408560311284,0.7774296199597979
ZCTA5 76363,157,7,150,0.044585987261146494,0.7756681267632335
ZCTA5 04421,288,12,276,0.041666666666666664,0.7750512145680009
ZCTA5 64676,58,3,55,0.05172413793103448,0.7737720583085331
ZCTA5 77867,58,3,55,0.05172413793103448,0.7737720583085331
ZCTA5 87533,58,3,55,0.05172413793103448,0.7737720583085331
ZCTA5 99553,58,3,55,0.05172413793103448,0.7737720583085331
ZCTA5 99748,58,3,55,0.05172413793103448,0.7737720583085331
ZCTA5 77968,1117,42,1075,0.03760071620411817,0.7706690742892386
ZCTA5 47640,423,17,406,0.04018912529550828,0.7703053806323553
ZCTA5 53527,3723,133,3590,0.035723878592532905,0.7701309613314369
ZCTA5 57104,11513,400,11113,0.03474333362286111,0.7691989967450025
ZCTA5 53937,396,16,380,0.04040404040404041,0.7690994271243263
ZCTA5 25827,949,36,913,0.037934668071654375,0.7675644581760225
ZCTA5 27505,2313,84,2229,0.03631647211413749,0.7655162162157815
ZCTA5 43321,107,5,102,0.04672897196261682,0.763625620369799
ZCTA5 95329,1062,40,1022,0.03766478342749529,0.7630668592922857
ZCTA5 39301,10403,362,10041,0.034797654522733826,0.7619903340950797
ZCTA5 49908,894,34,860,0.03803131991051454,0.761061081922649
ZCTA5 84084,11929,414,11515,0.03470533992790678,0.7598955819491379
ZCTA5 48445,506,20,486,0.039525691699604744,0.7595043773245006
ZCTA5 31005,6079,214,5865,0.035203158414212864,0.7583094135131685
ZCTA5 55979,343,14,329,0.04081632653061224,0.758246777585829
ZCTA5 72628,343,14,329,0.04081632653061224,0.758246777585829
ZCTA5 54420,479,19,460,0.03966597077244259,0.7560366943559744
ZCTA5 48748,895,34,861,0.03798882681564246,0.7544170418649968
ZCTA5 27344,6897,242,6655,0.03508771929824561,0.7544047407665339
ZCTA5 60955,617,24,593,0.03889789303079417,0.751961177861505
ZCTA5 73059,1092,41,1051,0.037545787545787544,0.751901716282868
ZCTA5 97426,3758,134,3624,0.03565726450239489,0.7510329983901826
ZCTA5 05845,507,20,487,0.03944773175542406,0.7504925088135717
ZCTA5 61024,1036,39,997,0.037644787644787646,0.7500890725596517
ZCTA5 52325,371,15,356,0.04043126684636118,0.7473429019716823
ZCTA5 28343,535,21,514,0.03925233644859813,0.7458041114912477
ZCTA5 35064,4514,160,4354,0.03544528134692069,0.7439130268229175
ZCTA5 16639,618,24,594,0.038834951456310676,0.7438687827281134
ZCTA5 29032,1689,62,1627,0.036708111308466546,0.7436645790715057
ZCTA5 22435,981,37,944,0.03771661569826707,0.7424178843926389
ZCTA5 83272,108,5,103,0.046296296296296294,0.74218005340789
ZCTA5 42528,563,22,541,0.03907637655417407,0.7418532646016245
ZCTA5 92591,12968,449,12519,0.03462368908081431,0.7405894009676921
ZCTA5 78025,1804,66,1738,0.036585365853658534,0.7395723073526904
ZCTA5 00667,8014,280,7734,0.03493885700024956,0.7390937165621412
ZCTA5 68068,36,2,34,0.05555555555555555,0.737449591278745
ZCTA5 84710,36,2,34,0.05555555555555555,0.737449591278745
ZCTA5 95545,36,2,34,0.05555555555555555,0.737449591278745
ZCTA5 59270,3502,125,3377,0.0356938892061679,0.7370541662561071
ZCTA5 63703,3560,127,3433,0.035674157303370785,0.7365854115648952
ZCTA5 53537,318,13,305,0.040880503144654086,0.7364554738655936
ZCTA5 22209,7548,264,7284,0.034976152623211444,0.7353026713390411
ZCTA5 29142,2034,74,1960,0.03638151425762045,0.7341767849896534
ZCTA5 70543,1691,62,1629,0.03666469544648137,0.7341762535180385
ZCTA5 73768,592,23,569,0.03885135135135135,0.7302719617445036
ZCTA5 80737,703,27,676,0.03840682788051209,0.7302510335827818
ZCTA5 45780,1322,49,1273,0.037065052950075644,0.7301006607809895
ZCTA5 28458,2552,92,2460,0.03605015673981191,0.7292772684822028
ZCTA5 45032,134,6,128,0.04477611940298507,0.7288425390180862
ZCTA5 36269,482,19,463,0.03941908713692946,0.7282580667267201
ZCTA5 78024,482,19,463,0.03941908713692946,0.7282580667267201
ZCTA5 65588,1068,40,1028,0.03745318352059925,0.7267633672789753
ZCTA5 38036,186,8,178,0.043010752688172046,0.7248007518664706
ZCTA5 26437,160,7,153,0.04375,0.7242377439818248
ZCTA5 32821,7232,253,6979,0.03498340707964602,0.723177057734412
ZCTA5 80024,109,5,104,0.045871559633027525,0.7209479804383564
ZCTA5 17949,109,5,104,0.045871559633027525,0.7209479804383564
ZCTA5 50311,5745,202,5543,0.035161009573542214,0.7194169674517714
ZCTA5 00913,3392,121,3271,0.03567216981132076,0.7183515551992911
ZCTA5 62688,266,11,255,0.041353383458646614,0.7164459841861729
ZCTA5 80817,10252,356,9896,0.034724931720639875,0.7154914529864351
ZCTA5 75560,374,15,359,0.040106951871657755,0.7154792655835516
ZCTA5 95369,374,15,359,0.040106951871657755,0.7154792655835516
ZCTA5 64492,705,27,678,0.03829787234042553,0.7152008757790116
ZCTA5 62957,320,13,307,0.040625,0.7133501506965846
ZCTA5 49111,1354,50,1304,0.03692762186115214,0.7107614131919003
ZCTA5 47351,135,6,129,0.044444444444444446,0.7101260320096755
ZCTA5 66422,135,6,129,0.044444444444444446,0.7101260320096755
ZCTA5 43437,187,8,179,0.0427807486631016,0.7092553380134412
ZCTA5 74446,187,8,179,0.0427807486631016,0.7092553380134412
ZCTA5 78251,20144,692,19452,0.03435266084193805,0.7091062309659811
ZCTA5 75980,1043,39,1004,0.037392138063279005,0.7072431339799319
ZCTA5 46501,1270,47,1223,0.03700787401574803,0.70426574199251
ZCTA5 75496,1270,47,1223,0.03700787401574803,0.70426574199251
ZCTA5 32025,7533,263,7270,0.03491304924996681,0.7041137988602669
ZCTA5 10307,5314,187,5127,0.035190063981934513,0.7036833365367247
ZCTA5 76890,348,14,334,0.040229885057471264,0.7029150099136419
ZCTA5 82327,348,14,334,0.040229885057471264,0.7029150099136419
ZCTA5 74651,294,12,282,0.04081632653061224,0.7020001072767279
ZCTA5 05142,294,12,282,0.04081632653061224,0.7020001072767279
ZCTA5 15639,875,33,842,0.037714285714285714,0.7007780334273425
ZCTA5 66943,214,9,205,0.04205607476635514,0.6997786009172643
ZCTA5 15377,214,9,205,0.04205607476635514,0.6997786009172643
ZCTA5 36080,791,30,761,0.03792667509481669,0.6995109668036952
ZCTA5 71241,3282,117,3165,0.0356489945155393,0.6992243380198451
ZCTA5 75021,3369,120,3249,0.03561887800534283,0.6987101558922283
ZCTA5 54845,37,2,35,0.05405405405405406,0.6968304375053842
ZCTA5 99653,37,2,35,0.05405405405405406,0.6968304375053842
ZCTA5 30474,6455,226,6229,0.03501161890007746,0.6958296800453728
ZCTA5 50313,6543,229,6314,0.03499923582454532,0.6949863724356684
ZCTA5 62846,241,10,231,0.04149377593360996,0.6940681955808228
ZCTA5 43903,820,31,789,0.03780487804878049,0.6928226760577838
ZCTA5 04430,820,31,789,0.03780487804878049,0.6928226760577838
ZCTA5 52561,349,14,335,0.04011461318051576,0.6919485671809525
ZCTA5 15018,349,14,335,0.04011461318051576,0.6919485671809525
ZCTA5 74058,1443,53,1390,0.036729036729036726,0.6917981887559078
ZCTA5 78661,136,6,130,0.04411764705882353,0.6915573614774306
ZCTA5 24072,431,17,414,0.03944315545243619,0.6914316993208872
ZCTA5 56375,322,13,309,0.040372670807453416,0.6903957320555121
ZCTA5 97434,322,13,309,0.040372670807453416,0.6903957320555121
ZCTA5 66510,295,12,283,0.04067796610169491,0.6899773967980032
ZCTA5 93240,2707,97,2610,0.03583302548947174,0.6882731829553388
ZCTA5 81133,514,20,494,0.038910505836575876,0.6879224521815855
ZCTA5 99009,1444,53,1391,0.036703601108033244,0.6866627241066364
ZCTA5 35461,849,32,817,0.03769140164899882,0.6865798709898988
ZCTA5 63944,653,25,628,0.03828483920367534,0.6864673762927528
ZCTA5 56128,821,31,790,0.037758830694275276,0.6859076472466766
ZCTA5 12041,215,9,206,0.04186046511627907,0.6854612525819646
ZCTA5 39146,793,30,763,0.03783102143757881,0.6854151079375084
ZCTA5 38824,3026,108,2918,0.0356906807666887,0.6841529333155962
ZCTA5 21206,19309,663,18646,0.03433631985084676,0.6816262954750548
ZCTA5 20601,8980,312,8668,0.03474387527839644,0.6796183106947548
ZCTA5 80136,1674,61,1613,0.03643966547192354,0.679275182330001
ZCTA5 62031,323,13,310,0.04024767801857585,0.6789744438280895
ZCTA5 13756,189,8,181,0.042328042328042326,0.6784273409822744
ZCTA5 74852,543,21,522,0.03867403314917127,0.6764186558743931
ZCTA5 93455,15245,525,14720,0.0344375204985241,0.6751498215437636
ZCTA5 59544,86,4,82,0.046511627906976744,0.673392644324374
ZCTA5 67458,86,4,82,0.046511627906976744,0.673392644324374
ZCTA5 64726,137,6,131,0.043795620437956206,0.6731340403646686
ZCTA5 67751,137,6,131,0.043795620437956206,0.6731340403646686
ZCTA5 27209,1504,55,1449,0.036569148936170214,0.6717862588745784
ZCTA5 79720,10540,365,10175,0.03462998102466793,0.6712613942724003
ZCTA5 29006,3987,141,3846,0.035364936042136946,0.6709277324703729
ZCTA5 68924,461,18,443,0.039045553145336226,0.6676159433728872
ZCTA5 67441,461,18,443,0.039045553145336226,0.6676159433728872
ZCTA5 71280,1505,55,1450,0.036544850498338874,0.6667674012584803
ZCTA5 01256,297,12,285,0.04040404040404041,0.6660596419257252
ZCTA5 05492,297,12,285,0.04040404040404041,0.6660596419257252
ZCTA5 13672,297,12,285,0.04040404040404041,0.6660596419257252
ZCTA5 50321,3408,121,3287,0.03550469483568075,0.6656733453495387
ZCTA5 61741,600,23,577,0.03833333333333333,0.6646256009736301
ZCTA5 99826,190,8,182,0.042105263157894736,0.6631426384723972
ZCTA5 81654,434,17,417,0.03917050691244239,0.662246696991474
ZCTA5 84725,517,20,497,0.03868471953578337,0.6613770941126483
ZCTA5 84734,112,5,107,0.044642857142857144,0.6584885214156986
ZCTA5 93446,17438,599,16839,0.03435026952632183,0.6580051192439579
ZCTA5 72459,573,22,551,0.038394415357766144,0.6576305821348827
ZCTA5 04925,38,2,36,0.05263157894736842,0.657420251273486
ZCTA5 99756,38,2,36,0.05263157894736842,0.657420251273486
ZCTA5 84311,217,9,208,0.041474654377880185,0.6570362251901909
ZCTA5 94956,657,25,632,0.0380517503805175,0.6553414944887301
ZCTA5 59875,1536,56,1480,0.036458333333333336,0.6547429408592675
ZCTA5 84034,62,3,59,0.04838709677419355,0.6538853687148021
ZCTA5 81077,271,11,260,0.04059040590405904,0.6532992531981713
ZCTA5 06241,2428,87,2341,0.035831960461285006,0.6515482393454998
ZCTA5 08830,6240,218,6022,0.03493589743589744,0.6508793692668777
ZCTA5 77021,10904,377,10527,0.034574468085106384,0.6505173736673997
ZCTA5 74577,87,4,83,0.04597701149425287,0.6495654324981552
ZCTA5 42519,1480,54,1426,0.03648648648648649,0.6487198203553483
ZCTA5 57620,191,8,183,0.041884816753926704,0.6479427515779816
ZCTA5 85701,2747,98,2649,0.03567528212595559,0.6473623598796946
ZCTA5 13787,1366,50,1316,0.036603221083455345,0.6472279430950229
ZCTA5 31642,1567,57,1510,0.036375239310784936,0.6430247802731841
ZCTA5 64873,381,15,366,0.03937007874015748,0.6421570807709808
ZCTA5 47116,245,10,235,0.04081632653061224,0.6408354902108506
ZCTA5 05471,272,11,261,0.04044117647058824,0.640816687166692
ZCTA5 07064,1339,49,1290,0.03659447348767737,0.6390194589023822
ZCTA5 43555,113,5,108,0.04424778761061947,0.6380668828509679
ZCTA5 28479,2345,84,2261,0.03582089552238806,0.6373351978772998
ZCTA5 45378,139,6,133,0.04316546762589928,0.63671380046165
ZCTA5 60638,20199,692,19507,0.03425912173869994,0.636143523848992
ZCTA5 92582,3942,139,3803,0.03526128868594622,0.6309414556443596
ZCTA5 47117,1513,55,1458,0.036351619299405155,0.6267387723169283
ZCTA5 73036,6660,232,6428,0.034834834834834835,0.6265612965371348
ZCTA5 57775,88,4,84,0.045454545454545456,0.6260318740349302
ZCTA5 76472,717,27,690,0.03765690376569038,0.6258156282675476
ZCTA5 72738,858,32,826,0.037296037296037296,0.625806659895716
ZCTA5 99329,63,3,60,0.047619047619047616,0.6252357693589882
ZCTA5 74759,549,21,528,0.03825136612021858,0.6250713728960086
ZCTA5 62473,577,22,555,0.038128249566724434,0.6243667713272373
ZCTA5 70529,4411,155,4256,0.03513942416685559,0.6224101069346014
ZCTA5 37715,301,12,289,0.03986710963455149,0.6187257248919003
ZCTA5 41385,193,8,185,0.04145077720207254,0.6177933880806641
ZCTA5 68766,193,8,185,0.04145077720207254,0.6177933880806641
ZCTA5 47512,1687,61,1626,0.03615886188500297,0.617768478703361
ZCTA5 70807,5552,194,5358,0.03494236311239193,0.6166290895790139
ZCTA5 73461,274,11,263,0.040145985401459854,0.6159950622948082
ZCTA5 30426,247,10,237,0.04048582995951417,0.6145604158422974
ZCTA5 31057,860,32,828,0.037209302325581395,0.6123904946591792
ZCTA5 73038,747,28,719,0.03748326639892905,0.6123821922878339
ZCTA5 54763,467,18,449,0.03854389721627409,0.6116589341778246
ZCTA5 53554,412,16,396,0.038834951456310676,0.6073663177563741
ZCTA5 39051,5966,208,5758,0.03486423064029501,0.6056449791590118
ZCTA5 26431,2354,84,2270,0.0356839422259983,0.6016049798919186
ZCTA5 63933,1432,52,1380,0.036312849162011177,0.6015725581608864
ZCTA5 66711,248,10,238,0.04032258064516129,0.6015063588820474
ZCTA5 45168,636,24,612,0.03773584905660377,0.6004789213986317
ZCTA5 34288,4419,155,4264,0.03507580900656257,0.5994570588484823
ZCTA5 75846,1061,39,1022,0.036757775683317624,0.5984096826978378
ZCTA5 55602,115,5,110,0.043478260869565216,0.5977968530654277
ZCTA5 68055,115,5,110,0.043478260869565216,0.5977968530654277
ZCTA5 92123,11788,406,11382,0.0344418052256532,0.5962726474029205
ZCTA5 39307,6205,216,5989,0.03481063658340049,0.5941795947730067
ZCTA5 32305,7789,270,7519,0.0346642701245346,0.5938774367799925
ZCTA5 33567,3692,130,3562,0.035211267605633804,0.5937043993193626
ZCTA5 80459,948,35,913,0.03691983122362869,0.5933944488498322
ZCTA5 32617,1491,54,1437,0.03621730382293763,0.5933233167545565
ZCTA5 41631,469,18,451,0.03837953091684435,0.59317198525986
ZCTA5 39828,5181,181,5000,0.03493534066782474,0.5928594942027509
ZCTA5 43961,168,7,161,0.041666666666666664,0.5919551430375541
ZCTA5 61337,168,7,161,0.041666666666666664,0.5919551430375541
ZCTA5 81137,2126,76,2050,0.03574788334901223,0.5881239897486659
ZCTA5 28325,195,8,187,0.041025641025641026,0.5879713518488194
ZCTA5 75845,1177,43,1134,0.03653355989804588,0.5874959379688516
ZCTA5 38756,2387,85,2302,0.035609551738583996,0.5855952788884609
ZCTA5 21837,1149,42,1107,0.03655352480417755,0.5842293059981081
ZCTA5 59752,1407,51,1356,0.03624733475479744,0.5826321039045266
ZCTA5 99664,1522,55,1467,0.03613666228646518,0.5819639838545269
ZCTA5 98295,950,35,915,0.03684210526315789,0.5806973994205555
ZCTA5 46350,17345,594,16751,0.03424618045546267,0.5800129633300095
ZCTA5 98834,90,4,86,0.044444444444444446,0.579815477163673
ZCTA5 83431,277,11,266,0.039711191335740074,0.579115461325124
ZCTA5 99138,415,16,399,0.03855421686746988,0.5777694913560357
ZCTA5 13425,837,31,806,0.037037037037037035,0.5764304961031258
ZCTA5 97540,3756,132,3624,0.03514376996805112,0.5758235661083547
ZCTA5 07828,5949,207,5742,0.03479576399394856,0.5754141655056897
ZCTA5 76652,499,19,480,0.03807615230460922,0.5741617308066581
ZCTA5 52776,1668,60,1608,0.03597122302158273,0.5716626825483084
ZCTA5 81645,388,15,373,0.03865979381443299,0.5702235774575511
ZCTA5 10502,1957,70,1887,0.03576903423607562,0.5694678335488018
ZCTA5 59339,65,3,62,0.046153846153846156,0.5693898989523181
ZCTA5 25186,416,16,400,0.038461538461538464,0.5679531073446429
ZCTA5 31544,333,13,320,0.03903903903903904,0.5667507286072394
ZCTA5 63665,143,6,137,0.04195804195804196,0.5655146055750213
ZCTA5 16142,2190,78,2112,0.03561643835616438,0.5627025189147256
ZCTA5 66403,306,12,294,0.0392156862745098,0.5604729692474172
ZCTA5 69356,726,27,699,0.0371900826446281,0.559782021081201
ZCTA5 84028,197,8,189,0.04060913705583756,0.5584690146433307
ZCTA5 40913,117,5,112,0.042735042735042736,0.5582660044528291
ZCTA5 68783,417,16,401,0.03836930455635491,0.5581611116093859
ZCTA5 24055,5370,187,5183,0.03482309124767225,0.5578321997059085
ZCTA5 95618,9571,330,9241,0.03447915578309477,0.557604184147598
ZCTA5 84638,91,4,87,0.04395604395604396,0.5571182221074668
ZCTA5 95312,91,4,87,0.04395604395604396,0.5571182221074668
ZCTA5 02119,11428,393,11035,0.03438921946097305,0.5558351280594899
ZCTA5 76475,334,13,321,0.038922155688622756,0.5557218174761848
ZCTA5 27591,7367,255,7112,0.03461381837925886,0.5534840231528442
ZCTA5 54559,362,14,348,0.03867403314917127,0.5522935197971701
ZCTA5 97883,955,35,920,0.03664921465968586,0.549074127254231
ZCTA5 48310,14944,512,14432,0.034261241970021415,0.5486130564040713
ZCTA5 61524,144,6,138,0.041666666666666664,0.5480439695879034
ZCTA5 77623,144,6,138,0.041666666666666664,0.5480439695879034
ZCTA5 33523,6371,221,6150,0.034688431957306545,0.5478307064210856
ZCTA5 67876,502,19,483,0.037848605577689244,0.5475329576043664
ZCTA5 73950,474,18,456,0.0379746835443038,0.5473088483402554
ZCTA5 68406,225,9,216,0.04,0.5460266800394414
ZCTA5 71701,7459,258,7201,0.03458908700898244,0.5450510612293351
ZCTA5 45764,3096,109,2987,0.03520671834625323,0.5422679869061531
ZCTA5 58560,66,3,63,0.045454545454545456,0.5421595064930294
ZCTA5 63828,66,3,63,0.045454545454545456,0.5421595064930294
ZCTA5 74071,66,3,63,0.045454545454545456,0.5421595064930294
ZCTA5 70733,531,20,511,0.03766478342749529,0.5395697507042964
ZCTA5 57242,118,5,113,0.0423728813559322,0.5387687476062775
ZCTA5 68828,118,5,113,0.0423728813559322,0.5387687476062775
ZCTA5 12502,447,17,430,0.03803131991051454,0.5381514519246757
ZCTA5 46957,253,10,243,0.039525691699604744,0.5370506955470207
ZCTA5 71069,253,10,243,0.039525691699604744,0.5370506955470207
ZCTA5 83858,5554,193,5361,0.034749729924378824,0.5369044329439985
ZCTA5 49061,616,23,593,0.037337662337662336,0.5360028290898479
ZCTA5 89410,4822,168,4654,0.03484031522189963,0.5352548611762953
ZCTA5 52647,92,4,88,0.043478260869565216,0.5346857600759
ZCTA5 77538,336,13,323,0.03869047619047619,0.5337664079075329
ZCTA5 61285,673,25,648,0.03714710252600297,0.5327613615442717
ZCTA5 97850,6907,239,6668,0.03460257709570001,0.530730117178633
ZCTA5 25446,504,19,485,0.037698412698412696,0.5298714329602332
ZCTA5 75152,1562,56,1506,0.03585147247119078,0.5268804928792724
ZCTA5 68450,930,34,896,0.03655913978494624,0.5265636808626983
ZCTA5 31098,1016,37,979,0.03641732283464567,0.5252335062257724
ZCTA5 31532,254,10,244,0.03937007874015748,0.5243190608680355
ZCTA5 42220,2548,90,2458,0.03532182103610675,0.5242520530150349
ZCTA5 23827,646,24,622,0.03715170278637771,0.5226152996028448
ZCTA5 24598,646,24,622,0.03715170278637771,0.5226152996028448
ZCTA5 45651,2258,80,2178,0.0354295837023915,0.5219942658560711
ZCTA5 82242,18,1,17,0.05555555555555555,0.5214556067764484
ZCTA5 92327,282,11,271,0.03900709219858156,0.5185648600848094
ZCTA5 70749,590,22,568,0.03728813559322034,0.51787908924773
ZCTA5 95641,732,27,705,0.036885245901639344,0.5162249242518041
ZCTA5 38967,2929,103,2826,0.03516558552406965,0.5150604030127953
ZCTA5 81025,310,12,298,0.03870967741935484,0.5145790376274233
ZCTA5 75409,4566,159,4407,0.03482260183968462,0.5141964656441381
ZCTA5 85603,3221,113,3108,0.03508227258615337,0.5138295876612523
ZCTA5 74859,2231,79,2152,0.035410129986553115,0.5137540745855577
ZCTA5 80649,146,6,140,0.0410958904109589,0.5134831650667202
ZCTA5 59464,173,7,166,0.04046242774566474,0.5126150436187995
ZCTA5 58496,93,4,89,0.043010752688172046,0.5125115266538895
ZCTA5 71233,93,4,89,0.043010752688172046,0.5125115266538895
ZCTA5 87010,506,19,487,0.037549407114624504,0.5122819370834578
ZCTA5 12121,619,23,596,0.03715670436187399,0.5122692199883235
ZCTA5 74931,450,17,433,0.03777777777777778,0.510044093821774
ZCTA5 83443,394,15,379,0.03807106598984772,0.5096287083665584
ZCTA5 77534,847,31,816,0.03659976387249114,0.5090923216753194
ZCTA5 17810,790,29,761,0.03670886075949367,0.508716513276546
ZCTA5 33621,563,21,542,0.037300177619893425,0.5074795248356986
ZCTA5 85226,14291,489,13802,0.03421733958435379,0.5073064123959306
ZCTA5 64688,228,9,219,0.039473684210526314,0.5054594142889769
ZCTA5 71234,1307,47,1260,0.035960214231063506,0.5038206006065649
ZCTA5 07003,18080,617,17463,0.03412610619469027,0.5023878243831349
ZCTA5 99143,339,13,326,0.038348082595870206,0.5010858779589549
ZCTA5 43036,120,5,115,0.041666666666666664,0.5002934077466165
ZCTA5 84086,120,5,115,0.041666666666666664,0.5002934077466165
ZCTA5 48051,6303,218,6085,0.03458670474377281,0.4999860702892735
ZCTA5 56742,367,14,353,0.03814713896457766,0.49996144917212965
ZCTA5 02860,18379,627,17752,0.034115022580118615,0.4981688011138451
ZCTA5 95310,992,36,956,0.036290322580645164,0.49674833921653866
ZCTA5 41041,2935,103,2832,0.035093696763202724,0.49392918762681126
ZCTA5 16364,480,18,462,0.0375,0.49292730780853566
ZCTA5 44689,229,9,220,0.039301310043668124,0.4920604849386619
ZCTA5 63087,312,12,300,0.038461538461538464,0.49186181911877097
ZCTA5 62665,565,21,544,0.037168141592920353,0.4909267192926699
ZCTA5 13665,340,13,327,0.03823529411764706,0.4902588204192323
ZCTA5 95914,368,14,354,0.03804347826086957,0.48958350520750465
ZCTA5 53559,2237,79,2158,0.03531515422440769,0.48946350126471594
ZCTA5 04479,566,21,545,0.037102473498233215,0.4826728562958073
ZCTA5 60129,121,5,116,0.04132231404958678,0.4813087475850574
ZCTA5 41014,2822,99,2723,0.03508150248051028,0.4807250655922761
ZCTA5 41731,425,16,409,0.03764705882352941,0.48068740199440324
ZCTA5 24017,9376,322,9054,0.03434300341296928,0.47857889777247287
ZCTA5 34234,8698,299,8399,0.034375718555989886,0.4779183157204055
ZCTA5 87733,43,2,41,0.046511627906976744,0.4761605052029057
ZCTA5 67013,1197,43,1154,0.03592314118629908,0.4750204272030096
ZCTA5 38057,1428,51,1377,0.03571428571428571,0.47494429773015484
ZCTA5 13339,2328,82,2246,0.0352233676975945,0.4746915725923791
ZCTA5 99824,967,35,932,0.03619441571871768,0.4738635632988903
ZCTA5 74965,1834,65,1769,0.03544165757906216,0.47331459493509914
ZCTA5 20901,12214,418,11796,0.03422302276076633,0.4724876470147018
ZCTA5 35764,203,8,195,0.03940886699507389,0.47180772366428914
ZCTA5 07850,2096,74,2022,0.035305343511450385,0.4712889932801393
ZCTA5 66526,286,11,275,0.038461538461538464,0.47092183889465594
ZCTA5 49321,6816,235,6581,0.03447769953051643,0.4698883142047205
ZCTA5 31780,853,31,822,0.03634232121922626,0.4690786418700276
ZCTA5 46376,95,4,91,0.042105263157894736,0.4689126565577712
ZCTA5 47043,2388,84,2304,0.035175879396984924,0.46786455193100795
ZCTA5 55445,3996,139,3857,0.034784784784784785,0.4677376526473906
ZCTA5 63041,176,7,169,0.03977272727272727,0.466156724500989
ZCTA5 84779,231,9,222,0.03896103896103896,0.46544419861960523
ZCTA5 61275,1836,65,1771,0.03540305010893246,0.4643729624295833
ZCTA5 65753,1807,64,1743,0.03541781959048146,0.4641823946623752
ZCTA5 32425,4672,162,4510,0.034674657534246575,0.4638949826103017
ZCTA5 47381,69,3,66,0.043478260869565216,0.4630514512675208
ZCTA5 64647,149,6,143,0.040268456375838924,0.46256376086633116
ZCTA5 74340,122,5,117,0.040983606557377046,0.46248852735943285
ZCTA5 61263,259,10,249,0.03861003861003861,0.4614325072998114
ZCTA5 93109,4615,160,4455,0.03466955579631636,0.45912908037292083
ZCTA5 39078,315,12,303,0.0380952380952381,0.4580669301408163
ZCTA5 99341,315,12,303,0.0380952380952381,0.4580669301408163
ZCTA5 49762,343,13,330,0.037900874635568516,0.4579739129064826
ZCTA5 75550,343,13,330,0.037900874635568516,0.4579739129064826
ZCTA5 95372,826,30,796,0.03631961259079903,0.45796559850394875
ZCTA5 74047,2537,89,2448,0.03508080409932992,0.45560876100659153
ZCTA5 96763,1143,41,1102,0.03587051618547681,0.4542878851235927
ZCTA5 16145,1172,42,1130,0.03583617747440273,0.4534773553928442
ZCTA5 63446,232,9,223,0.03879310344827586,0.4522256504847925
ZCTA5 38917,1317,47,1270,0.03568716780561883,0.4506391279380057
ZCTA5 03813,1317,47,1270,0.03568716780561883,0.4506391279380057
ZCTA5 87537,856,31,825,0.036214953271028034,0.4491794318713436
ZCTA5 60479,372,14,358,0.03763440860215054,0.44836060299265373
ZCTA5 47232,1173,42,1131,0.03580562659846547,0.44785194515920035
ZCTA5 17557,5207,180,5027,0.034568849625504126,0.44727650086593584
ZCTA5 59037,713,26,687,0.0364656381486676,0.44717214477589456
ZCTA5 61488,457,17,440,0.037199124726477024,0.44520354808220963
ZCTA5 12451,457,17,440,0.037199124726477024,0.44520354808220963
ZCTA5 78124,2248,79,2169,0.035142348754448396,0.4451017656470712
ZCTA5 04787,205,8,197,0.03902439024390244,0.44351290210838057
ZCTA5 74046,44,2,42,0.045454545454545456,0.4426713833690217
ZCTA5 42215,429,16,413,0.037296037296037296,0.4425121329239642
ZCTA5 15442,800,29,771,0.03625,0.4397507361304362
ZCTA5 45344,6034,208,5826,0.03447132913490222,0.4393603101989797
ZCTA5 77536,10874,372,10502,0.03421004230274048,0.43828907864784195
ZCTA5 47324,70,3,67,0.04285714285714286,0.43749559514364483
ZCTA5 58238,70,3,67,0.04285714285714286,0.43749559514364483
ZCTA5 56654,70,3,67,0.04285714285714286,0.43749559514364483
ZCTA5 95595,70,3,67,0.04285714285714286,0.43749559514364483
ZCTA5 66507,458,17,441,0.03711790393013101,0.43602401185232437
ZCTA5 65629,289,11,278,0.03806228373702422,0.43564003057933876
ZCTA5 38585,1494,53,1441,0.03547523427041499,0.4344117052092224
ZCTA5 80442,715,26,689,0.03636363636363636,0.4326310284567485
ZCTA5 12414,4096,142,3954,0.03466796875,0.43197778627972105
ZCTA5 64021,206,8,198,0.038834951456310676,0.4294728419498355
ZCTA5 13340,3100,108,2992,0.03483870967741935,0.428671399764591
ZCTA5 74523,2369,83,2286,0.03503588011819333,0.42810547519112635
ZCTA5 12996,917,33,884,0.03598691384950927,0.42650632670462424
ZCTA5 61864,630,23,607,0.03650793650793651,0.4262436916293569
ZCTA5 56453,346,13,333,0.03757225433526012,0.4259788772927506
ZCTA5 51357,234,9,225,0.038461538461538464,0.4259648305084821
ZCTA5 64761,516,19,497,0.03682170542635659,0.42539260670064294
ZCTA5 49312,124,5,119,0.04032258064516129,0.42532922529232475
ZCTA5 41097,2399,84,2315,0.035014589412255104,0.42500841618569485
ZCTA5 92268,318,12,306,0.03773584905660377,0.4246027172805563
ZCTA5 26804,262,10,252,0.03816793893129771,0.42430169981695853
ZCTA5 31510,3454,120,3334,0.03474232773595831,0.4209849848635705
ZCTA5 70449,1497,53,1444,0.035404141616566465,0.4195509067167207
ZCTA5 64050,9112,312,8800,0.03424056189640035,0.4174122664014032
ZCTA5 50164,207,8,199,0.03864734299516908,0.41550329681765286
ZCTA5 68628,347,13,334,0.037463976945244955,0.41537729512978
ZCTA5 71480,235,9,226,0.03829787234042553,0.4129214181556684
ZCTA5 80825,152,6,146,0.039473684210526314,0.41270588356468063
ZCTA5 84072,152,6,146,0.039473684210526314,0.41270588356468063
ZCTA5 14891,1702,60,1642,0.03525264394829612,0.4125987560556671
ZCTA5 72039,804,29,775,0.036069651741293535,0.4124104753209019
ZCTA5 96096,291,11,280,0.037800687285223365,0.412328281680334
ZCTA5 74528,71,3,68,0.04225352112676056,0.41232441666665687
ZCTA5 74044,2812,98,2714,0.03485064011379801,0.41179187430809855
ZCTA5 99677,20,1,19,0.05,0.41149505459290076
ZCTA5 26037,2783,97,2686,0.034854473589651457,0.41078761520597834
ZCTA5 74576,45,2,43,0.044444444444444446,0.409991455739347
ZCTA5 97396,1180,42,1138,0.03559322033898305,0.4086100507273456
ZCTA5 52571,661,24,637,0.036308623298033284,0.4081076594030879
ZCTA5 46590,1703,60,1643,0.03523194362889019,0.40796935858525074
ZCTA5 05034,125,5,120,0.04,0.40698425803223953
ZCTA5 99633,180,7,173,0.03888888888888889,0.4054806591786858
ZCTA5 26588,1094,39,1055,0.0356489945155393,0.4036973597796954
ZCTA5 76935,633,23,610,0.036334913112164295,0.40304874339611213
ZCTA5 26520,405,15,390,0.037037037037037035,0.40096986261802436
ZCTA5 74756,292,11,281,0.03767123287671233,0.40073426385559535
ZCTA5 72851,264,10,254,0.03787878787878788,0.3997910724676983
ZCTA5 38317,979,35,944,0.03575076608784474,0.39959873802414414
ZCTA5 74454,1269,45,1224,0.03546099290780142,0.3975445788154966
ZCTA5 51058,377,14,363,0.03713527851458886,0.39746883382283205
ZCTA5 03057,864,31,833,0.03587962962962963,0.39646044159386196
ZCTA5 35453,3785,131,3654,0.034610303830911494,0.39552541064759317
ZCTA5 74028,634,23,611,0.03627760252365931,0.3953420259827041
ZCTA5 43464,491,18,473,0.03665987780040733,0.3950181739382339
ZCTA5 81641,1473,52,1421,0.035302104548540394,0.39439595899098
ZCTA5 65679,951,34,917,0.035751840168243953,0.39402710018710074
ZCTA5 74431,321,12,309,0.037383177570093455,0.3914621327242065
ZCTA5 76905,4404,152,4252,0.03451407811080836,0.3911312381705539
ZCTA5 99660,126,5,121,0.03968253968253968,0.38879195412574474
ZCTA5 55764,265,10,255,0.03773584905660377,0.3876074770542488
ZCTA5 27804,11731,400,11331,0.034097689881510525,0.38756011691832015
ZCTA5 79367,237,9,228,0.0379746835443038,0.38700579806479424
ZCTA5 46405,3935,136,3799,0.034561626429479034,0.38630563692110437
ZCTA5 58488,99,4,95,0.04040404040404041,0.38454971356216316
ZCTA5 63473,99,4,95,0.04040404040404041,0.38454971356216316
ZCTA5 73937,99,4,95,0.04040404040404041,0.38454971356216316
ZCTA5 49454,1679,59,1620,0.03513996426444312,0.3841250451380863
ZCTA5 20622,1621,57,1564,0.0351634793337446,0.38269708753817155
ZCTA5 91355,12030,410,11620,0.03408146300914381,0.3825704904341013
ZCTA5 84525,322,12,310,0.037267080745341616,0.3804860022156086
ZCTA5 56201,8895,304,8591,0.034176503653738054,0.37881420938805616
ZCTA5 43317,46,2,44,0.043478260869565216,0.3780799267535523
ZCTA5 79248,665,24,641,0.03609022556390978,0.3780205909996098
ZCTA5 14892,3115,108,3007,0.03467094703049759,0.3776372726563595
ZCTA5 36042,579,21,558,0.03626943005181347,0.3767113503047542
ZCTA5 97141,5293,182,5111,0.034385036841110904,0.37658639994261134
ZCTA5 85610,436,16,420,0.03669724770642202,0.37657641818489074
ZCTA5 71353,694,25,669,0.03602305475504323,0.37633454775136793
ZCTA5 45820,182,7,175,0.038461538461538464,0.37566566959507425
ZCTA5 80133,1012,36,976,0.03557312252964427,0.37485073527033325
ZCTA5 60931,210,8,202,0.0380952380952381,0.37401008229603605
ZCTA5 14714,210,8,202,0.0380952380952381,0.37401008229603605
ZCTA5 07058,1886,66,1820,0.03499469777306469,0.37203273339596243
ZCTA5 66871,551,20,531,0.036297640653357534,0.3711723164485208
ZCTA5 59871,127,5,122,0.03937007874015748,0.37074956344515003
ZCTA5 17094,1013,36,977,0.035538005923000986,0.36882033033067685
ZCTA5 26133,580,21,559,0.03620689655172414,0.3686614243195882
ZCTA5 28529,724,26,698,0.03591160220994475,0.3677053535765528
ZCTA5 24712,638,23,615,0.03605015673981191,0.3646386342411014
ZCTA5 74743,3354,116,3238,0.0345855694692904,0.36435957478551284
ZCTA5 59854,100,4,96,0.04,0.3640177866929609
ZCTA5 72139,100,4,96,0.04,0.3640177866929609
ZCTA5 84742,100,4,96,0.04,0.3640177866929609
ZCTA5 73760,155,6,149,0.03870967741935484,0.36386232696279863
ZCTA5 60131,6213,213,6000,0.034282955094157415,0.3632571510798133
ZCTA5 46931,73,3,70,0.0410958904109589,0.36308742804380917
ZCTA5 76862,73,3,70,0.0410958904109589,0.36308742804380917
ZCTA5 74723,552,20,532,0.036231884057971016,0.3629174211883631
ZCTA5 78594,552,20,532,0.036231884057971016,0.3629174211883631
ZCTA5 13740,239,9,230,0.03765690376569038,0.36131482144334337
ZCTA5 83221,8963,306,8657,0.034140354791922345,0.36122741951704623
ZCTA5 62856,183,7,176,0.03825136612021858,0.3608851254042395
ZCTA5 72935,183,7,176,0.03825136612021858,0.3608851254042395
ZCTA5 88026,581,21,560,0.03614457831325301,0.3606256393128106
ZCTA5 14510,1889,66,1823,0.03493912122816305,0.35889557863912974
ZCTA5 30054,4062,140,3922,0.034465780403742,0.3585191237554068
ZCTA5 57004,1422,50,1372,0.035161744022503515,0.35807359991396914
ZCTA5 38778,553,20,533,0.03616636528028933,0.35467776442057997
ZCTA5 92071,19611,665,18946,0.0339095405639692,0.354570243354418
ZCTA5 69170,128,5,123,0.0390625,0.3528544081447767
ZCTA5 88336,128,5,123,0.0390625,0.3528544081447767
ZCTA5 82945,128,5,123,0.0390625,0.3528544081447767
ZCTA5 52039,353,13,340,0.036827195467422094,0.35241947772025173
ZCTA5 41763,268,10,258,0.03731343283582089,0.35133868531038304
ZCTA5 58374,240,9,231,0.0375,0.3485522419834442
ZCTA5 25259,240,9,231,0.0375,0.3485522419834442
ZCTA5 12946,1833,64,1769,0.03491543917075832,0.34789726733646675
ZCTA5 62248,156,6,150,0.038461538461538464,0.347798827705634
ZCTA5 62475,156,6,150,0.038461538461538464,0.347798827705634
ZCTA5 83425,156,6,150,0.038461538461538464,0.347798827705634
ZCTA5 78013,1892,66,1826,0.03488372093023256,0.34577949712873807
ZCTA5 59274,101,4,97,0.039603960396039604,0.3436992182497235
ZCTA5 15866,101,4,97,0.039603960396039604,0.3436992182497235
ZCTA5 65061,297,11,286,0.037037037037037035,0.34337007615759513
ZCTA5 74872,1221,43,1178,0.03521703521703522,0.3425472922504491
ZCTA5 56548,354,13,341,0.03672316384180791,0.3420332590696355
ZCTA5 85286,13834,470,13364,0.033974266300419255,0.34013751302210066
ZCTA5 76678,74,3,71,0.04054054054054054,0.3389986756038066
ZCTA5 88132,74,3,71,0.04054054054054054,0.3389986756038066
ZCTA5 65350,757,27,730,0.035667107001321,0.338582544395325
ZCTA5 92694,8620,294,8326,0.03410672853828306,0.3368863721929249
ZCTA5 50107,469,17,452,0.03624733475479744,0.3363828020277964
ZCTA5 87740,3451,119,3332,0.034482758620689655,0.33600352767935293
ZCTA5 66501,129,5,124,0.03875968992248062,0.3351038801940765
ZCTA5 74045,129,5,124,0.03875968992248062,0.3351038801940765
ZCTA5 73086,3363,116,3247,0.03449301219149569,0.3349985954006814
ZCTA5 55104,16954,575,16379,0.0339153002241359,0.33384746683429056
ZCTA5 86401,9984,340,9644,0.034054487179487176,0.3335329890372964
ZCTA5 45650,213,8,205,0.03755868544600939,0.3331244023249175
ZCTA5 74940,932,33,899,0.03540772532188841,0.33164937016815066
ZCTA5 33186,21383,724,20659,0.03385867277744002,0.3288772023081849
ZCTA5 63448,585,21,564,0.035897435897435895,0.32862281273727006
ZCTA5 51022,270,10,260,0.037037037037037035,0.32739052188267687
ZCTA5 49649,2219,77,2142,0.03470031545741325,0.3264246006509791
ZCTA5 47850,991,35,956,0.035317860746720484,0.32625361454568214
ZCTA5 78393,817,29,788,0.03549571603427173,0.3245013232663598
ZCTA5 70038,102,4,98,0.0392156862745098,0.3235892196685052
ZCTA5 56519,102,4,98,0.0392156862745098,0.3235892196685052
ZCTA5 35151,2838,98,2740,0.03453136011275546,0.3191021334590126
ZCTA5 31647,1313,46,1267,0.035034272658035034,0.3183896954724676
ZCTA5 49095,876,31,845,0.03538812785388128,0.3183056782708241
ZCTA5 00622,2133,74,2059,0.034692920768870136,0.31813737355552046
ZCTA5 12912,847,30,817,0.03541912632821724,0.31800958960664494
ZCTA5 46967,48,2,46,0.041666666666666664,0.31641333336932703
ZCTA5 21610,158,6,152,0.0379746835443038,0.3159889109191105
ZCTA5 56578,271,10,261,0.03690036900369004,0.31548458595243434
ZCTA5 74832,328,12,316,0.036585365853658534,0.3153546914487306
ZCTA5 87412,328,12,316,0.036585365853658534,0.3153546914487306
ZCTA5 48760,529,19,510,0.035916824196597356,0.3149781459118173
ZCTA5 76567,3723,128,3595,0.034380875637926404,0.31442298149465425
ZCTA5 98570,1577,55,1522,0.03487634749524413,0.314057062004485
ZCTA5 27541,1460,51,1409,0.03493150684931507,0.3139032253995744
ZCTA5 88008,2663,92,2571,0.03454750281637251,0.3137397838651632
ZCTA5 88337,935,33,902,0.03529411764705882,0.3128640684511994
ZCTA5 47527,616,22,594,0.03571428571428571,0.3119384646085896
ZCTA5 49032,1110,39,1071,0.03513513513513514,0.31143171748830745
ZCTA5 87825,674,24,650,0.03560830860534125,0.3109930912967225
ZCTA5 84337,3784,130,3654,0.034355179704016914,0.30819808073962945
ZCTA5 76853,530,19,511,0.035849056603773584,0.30659964438279197
ZCTA5 99674,559,20,539,0.03577817531305903,0.3055563678542841
ZCTA5 23504,7658,261,7397,0.03408200574562549,0.30550053380563674
ZCTA5 65740,1374,48,1326,0.034934497816593885,0.3051343730103101
ZCTA5 79830,3284,113,3171,0.03440925700365408,0.3043487855093266
ZCTA5 40734,1462,51,1411,0.03488372093023256,0.3039571464104955
ZCTA5 66779,272,10,262,0.03676470588235294,0.30362357457304867
ZCTA5 68784,704,25,679,0.03551136363636364,0.3035343856463972
ZCTA5 74868,4821,165,4656,0.03422526446795271,0.2977108111499216
ZCTA5 18510,4526,155,4371,0.03424657534246575,0.29643148161363436
ZCTA5 80514,1874,65,1809,0.03468516542155817,0.29633051939542177
ZCTA5 71264,416,15,401,0.036057692307692304,0.29529621404423156
ZCTA5 29108,7752,264,7488,0.034055727554179564,0.29450313536219597
ZCTA5 68335,216,8,208,0.037037037037037035,0.2928269848475192
ZCTA5 42776,880,31,849,0.035227272727272725,0.29249533562393176
ZCTA5 97131,1201,42,1159,0.034970857618651124,0.29228603781550605
ZCTA5 64733,474,17,457,0.035864978902953586,0.2918776290600852
ZCTA5 50252,76,3,73,0.039473684210526314,0.2918271289041714
ZCTA5 83263,3141,108,3033,0.034383954154727794,0.2897625068827179
ZCTA5 12810,302,11,291,0.03642384105960265,0.2869877508547289
ZCTA5 18370,417,15,402,0.03597122302158273,0.2858313412741542
ZCTA5 71065,504,18,486,0.03571428571428571,0.2821589576689769
ZCTA5 37810,649,23,626,0.03543913713405239,0.2812039742667408
ZCTA5 12814,649,23,626,0.03543913713405239,0.2812039742667408
ZCTA5 14411,4975,170,4805,0.034170854271356785,0.2810861683612451
ZCTA5 77070,20053,678,19375,0.03381040243355109,0.2804720129240107
ZCTA5 95659,360,13,347,0.03611111111111111,0.2803388940720467
ZCTA5 97390,389,14,375,0.03598971722365039,0.27809684369763205
ZCTA5 60606,2084,72,2012,0.0345489443378119,0.2779106139888242
ZCTA5 27883,1233,43,1190,0.034874290348742905,0.27729725374442094
ZCTA5 29044,2055,71,1984,0.03454987834549878,0.2762056620386783
ZCTA5 42029,2585,89,2496,0.03442940038684719,0.2757181191902115
ZCTA5 22949,592,21,571,0.03547297297297297,0.27314978657182976
ZCTA5 47613,1146,40,1106,0.034904013961605584,0.27293105267195417
ZCTA5 73650,332,12,320,0.03614457831325301,0.27260735943296427
ZCTA5 74361,6459,220,6239,0.034061000154822725,0.2711790592011634
ZCTA5 95685,1968,68,1900,0.034552845528455285,0.27102776128148487
ZCTA5 32254,4624,158,4466,0.034169550173010384,0.2704959605421303
ZCTA5 44902,1792,62,1730,0.03459821428571429,0.2693052763129366
ZCTA5 78873,738,26,712,0.03523035230352303,0.2683239659357791
ZCTA5 51563,275,10,265,0.03636363636363636,0.2683063739484455
ZCTA5 65626,709,25,684,0.03526093088857546,0.2675271551546782
ZCTA5 93602,1499,52,1447,0.03468979319546364,0.26602479976886484
ZCTA5 60603,564,20,544,0.03546099290780142,0.2650297192103311
ZCTA5 83218,105,4,101,0.0380952380952381,0.26446506542366577
ZCTA5 60538,9072,308,8764,0.033950617283950615,0.26291682837249003
ZCTA5 35980,1735,60,1675,0.0345821325648415,0.26126246488354055
ZCTA5 44841,247,9,238,0.03643724696356275,0.2607141061439666
ZCTA5 78374,6197,211,5986,0.034048733258028076,0.26025195326384526
ZCTA5 74963,190,7,183,0.03684210526315789,0.25969577189234183
ZCTA5 16034,681,24,657,0.03524229074889868,0.25948620399016
ZCTA5 43541,50,2,48,0.04,0.2573994454431109
ZCTA5 08751,1883,65,1818,0.03451938396176314,0.25703531942087227
ZCTA5 83537,449,16,433,0.035634743875278395,0.2569456786950339
ZCTA5 58740,276,10,266,0.036231884057971016,0.256621369533026
ZCTA5 73567,276,10,266,0.036231884057971016,0.256621369533026
ZCTA5 76651,1237,43,1194,0.034761519805982216,0.25568982328433304
ZCTA5 76530,740,26,714,0.03513513513513514,0.2542829325216525
ZCTA5 97138,4334,148,4186,0.03414859252422704,0.2542036431922553
ZCTA5 66509,1003,35,968,0.03489531405782652,0.25380320130510375
ZCTA5 76648,1003,35,968,0.03489531405782652,0.25380320130510375
ZCTA5 61336,219,8,211,0.0365296803652968,0.2530994459006069
ZCTA5 28097,2503,86,2417,0.03435876947662805,0.25165861743022905
ZCTA5 48894,624,22,602,0.035256410256410256,0.25035081311894536
ZCTA5 93405,8574,291,8283,0.033939818054583626,0.25003774525598144
ZCTA5 54828,363,13,350,0.03581267217630854,0.24988381580888303
ZCTA5 34797,421,15,406,0.035629453681710214,0.2482014157406878
ZCTA5 83213,508,18,490,0.03543307086614173,0.24802852298140737
ZCTA5 37327,4396,150,4246,0.034121929026387623,0.2461841821697419
ZCTA5 41421,191,7,184,0.03664921465968586,0.24555341464536604
ZCTA5 21529,191,7,184,0.03664921465968586,0.24555341464536604
ZCTA5 56684,106,4,102,0.03773584905660377,0.2451444931205757
ZCTA5 55352,3243,111,3132,0.034227567067530065,0.24490326852446573
ZCTA5 68521,13451,455,12996,0.03382648130250539,0.2400789497135418
ZCTA5 49330,1828,63,1765,0.03446389496717724,0.24006022388603263
ZCTA5 61459,163,6,157,0.03680981595092025,0.23824446098677712
ZCTA5 41092,1211,42,1169,0.03468208092485549,0.2376150891062184
ZCTA5 58721,249,9,240,0.03614457831325301,0.23608489852754244
ZCTA5 52807,6326,215,6111,0.033986721466961745,0.23551827446264548
ZCTA5 37641,3808,130,3678,0.03413865546218487,0.234868890239024
ZCTA5 58243,278,10,268,0.03597122302158273,0.23338031287233296
ZCTA5 50606,307,11,296,0.035830618892508145,0.23155081410472236
ZCTA5 67154,510,18,492,0.03529411764705882,0.23106542795710885
ZCTA5 27325,2538,87,2451,0.034278959810874705,0.23105238659355684
ZCTA5 00704,2863,98,2765,0.034229828850855744,0.23078104864354768
ZCTA5 51462,481,17,464,0.035343035343035345,0.23036603032499559
ZCTA5 28556,423,15,408,0.03546099290780142,0.22952246959400335
ZCTA5 71078,2568,88,2480,0.03426791277258567,0.22930073639600912
ZCTA5 78217,13786,466,13320,0.03380240824024373,0.22733158091201255
ZCTA5 04761,221,8,213,0.03619909502262444,0.22692232021032555
ZCTA5 28583,107,4,103,0.037383177570093455,0.22601076770586562
ZCTA5 58532,107,4,103,0.037383177570093455,0.22601076770586562
ZCTA5 61775,107,4,103,0.037383177570093455,0.22601076770586562
ZCTA5 64636,107,4,103,0.037383177570093455,0.22601076770586562
ZCTA5 79743,107,4,103,0.037383177570093455,0.22601076770586562
ZCTA5 18823,107,4,103,0.037383177570093455,0.22601076770586562
ZCTA5 23079,107,4,103,0.037383177570093455,0.22601076770586562
ZCTA5 47369,569,20,549,0.0351493848857645,0.22486595538671283
ZCTA5 83644,3782,129,3653,0.034108937070333155,0.22390206748824037
ZCTA5 74120,2363,81,2282,0.03427845958527296,0.2228091443552438
ZCTA5 32348,3664,125,3539,0.03411572052401747,0.22266492047630898
ZCTA5 34498,279,10,269,0.035842293906810034,0.22182356178725365
ZCTA5 52047,279,10,269,0.035842293906810034,0.22182356178725365
ZCTA5 07723,279,10,269,0.035842293906810034,0.22182356178725365
ZCTA5 37860,1567,54,1513,0.03446075303126994,0.22157104838942132
ZCTA5 59436,774,27,747,0.03488372093023256,0.22116130946678908
ZCTA5 78705,8559,290,8269,0.03388246290454492,0.22031043569969186
ZCTA5 42171,2600,89,2511,0.03423076923076923,0.22019243783979958
ZCTA5 67514,366,13,353,0.03551912568306011,0.21968365030653428
ZCTA5 44613,745,26,719,0.0348993288590604,0.21934767031818497
ZCTA5 10511,745,26,719,0.0348993288590604,0.21934767031818497
ZCTA5 33760,6600,224,6376,0.03393939393939394,0.21918271699075548
ZCTA5 81089,2187,75,2112,0.03429355281207133,0.21827628454001297
ZCTA5 32328,1274,44,1230,0.03453689167974882,0.21489824270909344
ZCTA5 03857,4022,137,3885,0.03406265539532571,0.2145742979151175
ZCTA5 83239,222,8,214,0.036036036036036036,0.21392423674961958
ZCTA5 51063,483,17,466,0.035196687370600416,0.21295804503933896
ZCTA5 99119,483,17,466,0.035196687370600416,0.21295804503933896
ZCTA5 02905,8741,296,8445,0.03386340235670976,0.21273034921211223
ZCTA5 31812,251,9,242,0.035856573705179286,0.21165652037264643
ZCTA5 98396,280,10,270,0.03571428571428571,0.21030886993610604
ZCTA5 55723,981,34,947,0.034658511722731905,0.2097581130467282
ZCTA5 64642,367,13,354,0.035422343324250684,0.20967275941037275
ZCTA5 61438,338,12,326,0.03550295857988166,0.2094603482157548
ZCTA5 15742,338,12,326,0.03550295857988166,0.2094603482157548
ZCTA5 17030,338,12,326,0.03550295857988166,0.2094603482157548
ZCTA5 72114,4943,168,4775,0.03398745700991301,0.2084754074011223
ZCTA5 91105,5299,180,5119,0.033968673334591436,0.2082482281489937
ZCTA5 68631,165,6,159,0.03636363636363636,0.20782922359672576
ZCTA5 55939,776,27,749,0.03479381443298969,0.20751898101736752
ZCTA5 76556,542,19,523,0.03505535055350553,0.20729153817985496
ZCTA5 68063,108,4,104,0.037037037037037035,0.20705994670009123
ZCTA5 67634,108,4,104,0.037037037037037035,0.20705994670009123
ZCTA5 30342,12669,428,12241,0.03378325045386376,0.2059357134891269
ZCTA5 78256,4114,140,3974,0.03403014098201264,0.20541684663455245
ZCTA5 65806,6042,205,5837,0.03392916252896392,0.20528996851389505
ZCTA5 98801,15794,533,15261,0.03374699252880841,0.20459546196209688
ZCTA5 17868,484,17,467,0.03512396694214876,0.20428141183136198
ZCTA5 37410,1571,54,1517,0.03437301082113304,0.2025135159131165
ZCTA5 78070,5687,193,5494,0.033937049410937226,0.202475311829656
ZCTA5 44450,689,24,665,0.03483309143686502,0.20127381985670673
ZCTA5 50272,52,2,50,0.038461538461538464,0.20080174679968404
ZCTA5 97826,397,14,383,0.03526448362720403,0.20058256675590805
ZCTA5 64011,1277,44,1233,0.03445575567736883,0.19902713565747474
ZCTA5 72134,137,5,132,0.0364963503649635,0.1980145310875088
ZCTA5 76367,3672,125,3547,0.03404139433551198,0.19786083555881004
ZCTA5 39481,602,21,581,0.03488372093023256,0.19504594149283963
ZCTA5 60602,602,21,581,0.03488372093023256,0.19504594149283963
ZCTA5 89424,109,4,105,0.03669724770642202,0.18828820909244537
ZCTA5 99149,109,4,105,0.03669724770642202,0.18828820909244537
ZCTA5 50539,224,8,216,0.03571428571428571,0.18810597177931795
ZCTA5 97907,224,8,216,0.03571428571428571,0.18810597177931795
ZCTA5 95585,224,8,216,0.03571428571428571,0.18810597177931795
ZCTA5 47424,3676,125,3551,0.03400435255712731,0.1854791404169428
ZCTA5 04676,457,16,441,0.0350109409190372,0.1850647991708548
ZCTA5 97465,1044,36,1008,0.034482758620689655,0.1848083572919039
ZCTA5 66856,721,25,696,0.03467406380027739,0.1821480612358665
ZCTA5 38015,868,30,838,0.03456221198156682,0.1815298808056225
ZCTA5 49799,868,30,838,0.03456221198156682,0.1815298808056225
ZCTA5 68327,138,5,133,0.036231884057971016,0.18145871059418156
ZCTA5 71752,399,14,385,0.03508771929824561,0.18145157563239994
ZCTA5 64441,81,3,78,0.037037037037037035,0.17931917394853084
ZCTA5 82336,81,3,78,0.037037037037037035,0.17931917394853084
ZCTA5 04551,341,12,329,0.03519061583577713,0.17831247628382926
ZCTA5 70453,283,10,273,0.0353356890459364,0.17601377911719074
ZCTA5 58793,254,9,245,0.03543307086614173,0.1753826505278366
ZCTA5 07621,8760,296,8464,0.033789954337899546,0.17473221919841506
ZCTA5 54659,546,19,527,0.0347985347985348,0.17468313028352558
ZCTA5 58640,634,22,612,0.03470031545741325,0.1744812883214957
ZCTA5 66870,53,2,51,0.03773584905660377,0.17334333345609804
ZCTA5 56729,53,2,51,0.03773584905660377,0.17334333345609804
ZCTA5 62895,840,29,811,0.034523809523809526,0.17238838972156073
ZCTA5 99840,400,14,386,0.035,0.1719224456041702
ZCTA5 76035,605,21,584,0.03471074380165289,0.17187052729273083
ZCTA5 10970,3562,121,3441,0.03396967995508141,0.17107254099644886
ZCTA5 52310,2643,90,2553,0.0340522133938706,0.17095696459374546
ZCTA5 98579,4779,162,4617,0.03389830508474576,0.1707140023519691
ZCTA5 12053,1312,45,1267,0.03429878048780488,0.17011622261349957
ZCTA5 81029,110,4,106,0.03636363636363636,0.16969185048359045
ZCTA5 49303,342,12,330,0.03508771929824561,0.16799151585587518
ZCTA5 83237,342,12,330,0.03508771929824561,0.16799151585587518
ZCTA5 75481,139,5,134,0.03597122302158273,0.16502480182746473
ZCTA5 81058,430,15,415,0.03488372093023256,0.1648439073202027
ZCTA5 98092,16090,542,15548,0.03368551895587321,0.16313972548169156
ZCTA5 59483,226,8,218,0.035398230088495575,0.1625209394424998
ZCTA5 29016,7279,246,7033,0.03379585107844484,0.16207613246572902
ZCTA5 10010,16390,552,15838,0.0336790726052471,0.16006406913784849
ZCTA5 25511,372,13,359,0.03494623655913978,0.1600293778350906
ZCTA5 65674,1078,37,1041,0.03432282003710575,0.1585906925309078
ZCTA5 30217,3566,121,3445,0.03393157599551318,0.1585146820518254
ZCTA5 74944,460,16,444,0.034782608695652174,0.15843737496676832
ZCTA5 05356,460,16,444,0.034782608695652174,0.15843737496676832
ZCTA5 82523,343,12,331,0.03498542274052478,0.15770104822713543
ZCTA5 74460,82,3,79,0.036585365853658534,0.1576773457243653
ZCTA5 73043,82,3,79,0.036585365853658534,0.1576773457243653
ZCTA5 85360,82,3,79,0.036585365853658534,0.1576773457243653
ZCTA5 65571,813,28,785,0.03444034440344403,0.15636055373338625
ZCTA5 60922,872,30,842,0.034403669724770644,0.15591214148298513
ZCTA5 97870,314,11,303,0.03503184713375796,0.15546200283137704
ZCTA5 45015,4607,156,4451,0.03386151508573909,0.15372699059974043
ZCTA5 28429,2885,98,2787,0.03396880415944541,0.15369781614714415
ZCTA5 54480,578,20,558,0.03460207612456748,0.15346290572106305
ZCTA5 78943,111,4,107,0.036036036036036036,0.15126727846581242
ZCTA5 97417,1050,36,1014,0.03428571428571429,0.14983101968725718
ZCTA5 12763,227,8,219,0.03524229074889868,0.149814429724713
ZCTA5 45439,3955,134,3821,0.03388116308470291,0.1493057443826428
ZCTA5 67621,169,6,163,0.03550295857988166,0.14811083261305574
ZCTA5 30820,432,15,417,0.034722222222222224,0.14655984004628347
ZCTA5 42120,962,33,929,0.034303534303534305,0.14648869583401097
ZCTA5 80238,7138,241,6897,0.03376295881199216,0.14504453102239023
ZCTA5 75684,2413,82,2331,0.03398259428097804,0.144330910808228
ZCTA5 34237,6960,235,6725,0.033764367816091954,0.1438783313806603
ZCTA5 67835,1022,35,987,0.03424657534246575,0.1408615613038356
ZCTA5 98250,3750,127,3623,0.03386666666666667,0.14044803650061666
ZCTA5 71366,668,23,645,0.0344311377245509,0.14040944388932888
ZCTA5 77835,1170,40,1130,0.03418803418803419,0.13958051976964217
ZCTA5 70581,257,9,248,0.03501945525291829,0.1395407926738516
ZCTA5 25083,257,9,248,0.03501945525291829,0.1395407926738516
ZCTA5 78610,12084,407,11677,0.03368090036411784,0.1385562656211827
ZCTA5 97469,1052,36,1016,0.034220532319391636,0.13821659504383108
ZCTA5 98815,2652,90,2562,0.033936651583710405,0.13815264880646205
ZCTA5 73432,433,15,418,0.03464203233256351,0.137449825815326
ZCTA5 84711,228,8,220,0.03508771929824561,0.13716449832118796
ZCTA5 59332,83,3,80,0.03614457831325301,0.13630367971648213
ZCTA5 32431,1615,55,1560,0.034055727554179564,0.13442167541156008
ZCTA5 04471,316,11,305,0.03481012658227848,0.134037727574621
ZCTA5 80814,1467,50,1417,0.03408316291751875,0.13395815801293745
ZCTA5 13658,905,31,874,0.03425414364640884,0.1338196951771077
ZCTA5 28701,1408,48,1360,0.03409090909090909,0.13285315178314738
ZCTA5 48815,935,32,903,0.034224598930481284,0.13099562834385015
ZCTA5 99829,287,10,277,0.03484320557491289,0.1308557026330931
ZCTA5 30427,4170,141,4029,0.03381294964028777,0.12881395105032226
ZCTA5 25506,1972,67,1905,0.03397565922920893,0.12876441438903807
ZCTA5 90291,13612,458,13154,0.03364678225095504,0.12491916399462132
ZCTA5 54435,877,30,847,0.03420752565564424,0.12405585038606558
ZCTA5 39666,3548,120,3428,0.033821871476888386,0.12177456719074238
ZCTA5 28604,3132,106,3026,0.03384418901660281,0.1213588461320314
ZCTA5 12950,288,10,278,0.034722222222222224,0.11966560829910487
ZCTA5 03846,435,15,420,0.034482758620689655,0.11929328167191564
ZCTA5 74036,2687,91,2596,0.03386676590993673,0.1189154726972123
ZCTA5 13437,171,6,165,0.03508771929824561,0.11878794004349677
ZCTA5 80643,1322,45,1277,0.0340393343419062,0.11830356500177827
ZCTA5 36480,612,21,591,0.03431372549019608,0.11824224926592992
ZCTA5 83547,142,5,137,0.035211267605633804,0.1164350122090505
ZCTA5 49446,967,33,934,0.03412616339193381,0.11619571180504266
ZCTA5 87556,967,33,934,0.03412616339193381,0.11619571180504266
ZCTA5 45388,259,9,250,0.03474903474903475,0.11588062321986878
ZCTA5 45351,84,3,81,0.03571428571428571,0.11519091210742533
ZCTA5 57452,113,4,109,0.035398230088495575,0.11491965836459984
ZCTA5 62940,113,4,109,0.035398230088495575,0.11491965836459984
ZCTA5 79749,113,4,109,0.035398230088495575,0.11491965836459984
ZCTA5 04231,113,4,109,0.035398230088495575,0.11491965836459984
ZCTA5 66736,1649,56,1593,0.03395997574287447,0.11420604531511197
ZCTA5 56527,318,11,307,0.03459119496855346,0.11274996069551903
ZCTA5 78330,318,11,307,0.03459119496855346,0.11274996069551903
ZCTA5 97429,318,11,307,0.03459119496855346,0.11274996069551903
ZCTA5 44683,3373,114,3259,0.03379780610732286,0.11096085927311176
ZCTA5 76012,10342,348,9994,0.03364919744730226,0.11025147590114355
ZCTA5 48002,1205,41,1164,0.03402489626556016,0.11016005496289474
ZCTA5 60530,201,7,194,0.03482587064676617,0.10814224850988305
ZCTA5 62926,850,29,821,0.03411764705882353,0.10755895559989963
ZCTA5 85305,4356,147,4209,0.0337465564738292,0.10728684660158408
ZCTA5 63785,348,12,336,0.034482758620689655,0.10669915483097325
ZCTA5 37645,2007,68,1939,0.03388141504733433,0.1064224376770455
ZCTA5 05039,525,18,507,0.03428571428571429,0.10594653005295467
ZCTA5 64035,407,14,393,0.0343980343980344,0.10588475694255763
ZCTA5 78722,3107,105,3002,0.03379465722561957,0.10551965717593642
ZCTA5 35983,1473,50,1423,0.03394433129667346,0.1046003708078587
ZCTA5 39826,172,6,166,0.03488372093023256,0.10425644110670876
ZCTA5 57213,260,9,251,0.03461538461538462,0.10411963481487348
ZCTA5 51652,673,23,650,0.03417533432392273,0.10402964689646738
ZCTA5 59337,319,11,308,0.034482758620689655,0.10215666320986444
ZCTA5 56010,496,17,479,0.034274193548387094,0.10155195351242917
ZCTA5 22940,496,17,479,0.034274193548387094,0.10155195351242917
ZCTA5 11765,231,8,223,0.03463203463203463,0.099548623606223
ZCTA5 12155,733,25,708,0.034106412005457026,0.09819085916271912
ZCTA5 41002,970,33,937,0.03402061855670103,0.09809540087626188
ZCTA5 35444,1415,48,1367,0.03392226148409894,0.09790355889524983
ZCTA5 80758,1415,48,1367,0.03392226148409894,0.09790355889524983
ZCTA5 63735,290,10,280,0.034482758620689655,0.09740255661276728
ZCTA5 61882,290,10,280,0.034482758620689655,0.09740255661276728
ZCTA5 58762,114,4,110,0.03508771929824561,0.09698994690096284
ZCTA5 83624,467,16,451,0.034261241970021415,0.09698200310769918
ZCTA5 32426,349,12,337,0.034383954154727794,0.09658750229423926
ZCTA5 38643,1000,34,966,0.034,0.09597484245673046
ZCTA5 72461,1564,53,1511,0.03388746803069054,0.09527713641025537
ZCTA5 62874,202,7,195,0.034653465346534656,0.09478426452626583
ZCTA5 45861,85,3,82,0.03529411764705882,0.0943320659487906
ZCTA5 65344,85,3,82,0.03529411764705882,0.0943320659487906
ZCTA5 57651,56,2,54,0.03571428571428571,0.09405298588965898
ZCTA5 74942,56,2,54,0.03571428571428571,0.09405298588965898
ZCTA5 13488,56,2,54,0.03571428571428571,0.09405298588965898
ZCTA5 56330,645,22,623,0.034108527131782945,0.09240706495710235
ZCTA5 88253,261,9,252,0.034482758620689655,0.09240417864595195
ZCTA5 01070,261,9,252,0.034482758620689655,0.09240417864595195
ZCTA5 99033,320,11,309,0.034375,0.0915967722465725
ZCTA5 56592,173,6,167,0.03468208092485549,0.0898100619330724
ZCTA5 30238,12084,406,11678,0.03359814630916915,0.08796706826441443
ZCTA5 62835,409,14,395,0.034229828850855744,0.08722703743107534
ZCTA5 50634,350,12,338,0.03428571428571429,0.08650497954939405
ZCTA5 96714,350,12,338,0.03428571428571429,0.08650497954939405
ZCTA5 75662,8894,299,8595,0.03361816955250731,0.08596945792529247
ZCTA5 65631,1893,64,1829,0.03380876914949815,0.08577859879391633
ZCTA5 47639,1537,52,1485,0.03383214053350683,0.08238854613266362
ZCTA5 58351,203,7,196,0.034482758620689655,0.08149282560012466
ZCTA5 05772,321,11,310,0.03426791277258567,0.08107005281834352
ZCTA5 57725,115,4,111,0.034782608695652174,0.07921868748338416
ZCTA5 40419,1627,55,1572,0.03380454824830977,0.07857704519620248
ZCTA5 72958,2699,91,2608,0.03371619118191923,0.0756779654588794
ZCTA5 05442,174,6,168,0.034482758620689655,0.07544769592785455
ZCTA5 34994,6961,234,6727,0.03361585979026002,0.07498396029604229
ZCTA5 56571,796,27,769,0.03391959798994975,0.0730126529302098
ZCTA5 81328,1837,62,1775,0.033750680457267285,0.07065477208314765
ZCTA5 18821,559,19,540,0.03398926654740608,0.07034557635334601
ZCTA5 15445,1154,39,1115,0.033795493934142114,0.06446616234115932
ZCTA5 37047,827,28,799,0.03385731559854897,0.0644603017134034
ZCTA5 60034,768,26,742,0.033854166666666664,0.06163309338476101
ZCTA5 05827,116,4,112,0.034482758620689655,0.06160278576396796
ZCTA5 98465,3150,106,3044,0.03365079365079365,0.061344958415177384
ZCTA5 76660,175,6,169,0.03428571428571429,0.061168257645780155
ZCTA5 65340,5655,190,5465,0.03359858532272325,0.06036066717117559
ZCTA5 42035,412,14,398,0.03398058252427184,0.05941177098149335
ZCTA5 28515,917,31,886,0.03380588876772083,0.05921685873881733
ZCTA5 19373,947,32,915,0.0337909186906019,0.057615814198403156
ZCTA5 92110,11476,385,11091,0.03354827466016033,0.05601485109068229
ZCTA5 97801,7537,253,7284,0.03356773251957012,0.054789060959986646
ZCTA5 71238,1126,38,1088,0.03374777975133215,0.054775383767151756
ZCTA5 42376,2228,75,2153,0.033662477558348294,0.05465882610155639
ZCTA5 90732,8522,286,8236,0.033560197136822345,0.05439084374653069
ZCTA5 65013,1275,43,1232,0.03372549019607843,0.05386086551328078
ZCTA5 58455,146,5,141,0.03424657534246575,0.05324066578546117
ZCTA5 70084,2497,84,2413,0.03364036844213056,0.05172057456983819
ZCTA5 30363,1901,64,1837,0.033666491320357705,0.051461859155405645
ZCTA5 55114,1574,53,1521,0.033672172808132145,0.04808055704738072
ZCTA5 66040,1455,49,1406,0.03367697594501718,0.047246182061885425
ZCTA5 63839,176,6,170,0.03409090909090909,0.04697068226393459
ZCTA5 97203,12198,409,11789,0.03353008689949172,0.046579170024271366
ZCTA5 74016,2260,76,2184,0.033628318584070796,0.046019233631850495
ZCTA5 31543,1664,56,1608,0.03365384615384615,0.045278641487642046
ZCTA5 95064,473,16,457,0.03382663847780127,0.04503920427530203
ZCTA5 83124,58,2,56,0.034482758620689655,0.04355974755368386
ZCTA5 84023,58,2,56,0.034482758620689655,0.04355974755368386
ZCTA5 99738,58,2,56,0.034482758620689655,0.04355974755368386
ZCTA5 75009,3633,122,3511,0.03358106248279659,0.04250696263807146
ZCTA5 16329,206,7,199,0.03398058252427184,0.042010466143316084
ZCTA5 12997,533,18,515,0.03377110694183865,0.04068092948613628
ZCTA5 92310,2500,84,2416,0.0336,0.04052692456319756
ZCTA5 98320,563,19,544,0.03374777975133215,0.03873204530384855
ZCTA5 29364,236,8,228,0.03389830508474576,0.037936444967104244
ZCTA5 38392,236,8,228,0.03389830508474576,0.037936444967104244
ZCTA5 75488,236,8,228,0.03389830508474576,0.037936444967104244
ZCTA5 47282,147,5,142,0.034013605442176874,0.03771465907094533
ZCTA5 33323,7038,236,6802,0.033532253481102586,0.03639195400063104
ZCTA5 23350,1517,51,1466,0.03361898483849703,0.03568149992769242
ZCTA5 44640,88,3,85,0.03409090909090909,0.033213287945786846
ZCTA5 68929,88,3,85,0.03409090909090909,0.033213287945786846
ZCTA5 73531,177,6,171,0.03389830508474576,0.03285392507078259
ZCTA5 97901,296,10,286,0.033783783783783786,0.03152897141692801
ZCTA5 55397,1011,34,977,0.033630069238377844,0.03108899778138002
ZCTA5 56659,29,1,28,0.034482758620689655,0.03080139288198398
ZCTA5 31037,1399,47,1352,0.03359542530378842,0.029365184312801752
ZCTA5 56652,207,7,200,0.033816425120772944,0.02897795352145557
ZCTA5 37096,2354,79,2275,0.033559898045879354,0.028505621335085912
ZCTA5 39739,922,31,891,0.033622559652928416,0.028420996825693264
ZCTA5 00987,21440,718,20722,0.033488805970149256,0.0281388782700627
ZCTA5 27958,4026,135,3891,0.03353204172876304,0.027449666795524588
ZCTA5 49901,118,4,114,0.03389830508474576,0.026825117490349683
ZCTA5 64656,118,4,114,0.03389830508474576,0.026825117490349683
ZCTA5 73552,505,17,488,0.033663366336633666,0.02613353418415658
ZCTA5 11719,1161,39,1122,0.03359173126614987,0.026051025832187963
ZCTA5 05826,386,13,373,0.03367875647668394,0.024529400196698817
ZCTA5 45652,1400,47,1353,0.03357142857142857,0.024382473924033983
ZCTA5 66539,1042,35,1007,0.03358925143953935,0.024234691356065933
ZCTA5 60191,5192,174,5018,0.033513097072419104,0.023580887081104444
ZCTA5 35622,2655,89,2566,0.03352165725047081,0.01931551100461307
ZCTA5 57258,59,2,57,0.03389830508474576,0.018968222483552122
ZCTA5 62334,59,2,57,0.03389830508474576,0.018968222483552122
ZCTA5 36280,1461,49,1412,0.03353867214236824,0.017945185886570486
ZCTA5 72384,357,12,345,0.03361344537815126,0.016727439968200666
ZCTA5 10532,1730,58,1672,0.03352601156069364,0.016599002870758644
ZCTA5 17101,1432,48,1384,0.0335195530726257,0.013742716469033977
ZCTA5 43148,805,27,778,0.03354037267080745,0.013588823201670198
ZCTA5 56325,89,3,86,0.033707865168539325,0.013305600703716487
ZCTA5 36344,2179,73,2106,0.033501606241395136,0.012293482778509331
ZCTA5 48749,477,16,461,0.033542976939203356,0.01077658135915579
ZCTA5 63787,298,10,288,0.03355704697986577,0.009868573394426448
ZCTA5 57328,507,17,490,0.03353057199211045,0.009556976448926838
ZCTA5 59821,955,32,923,0.033507853403141365,0.00921218077279537
ZCTA5 31054,537,18,519,0.0335195530726257,0.008415660757219046
ZCTA5 99919,328,11,317,0.03353658536585366,0.008292584592755949
ZCTA5 46721,1702,57,1645,0.033490011750881316,0.008204829800223372
ZCTA5 51540,149,5,144,0.03355704697986577,0.006978135167836088
ZCTA5 58626,149,5,144,0.03355704697986577,0.006978135167836088
ZCTA5 05734,597,20,577,0.03350083752093802,0.006330324325175401
ZCTA5 38034,1075,36,1039,0.03348837209302326,0.006221731977041607
ZCTA5 65483,1852,62,1790,0.03347732181425486,0.005521760883789749
ZCTA5 80621,4333,145,4188,0.033464112624048005,0.0036105929907743594
ZCTA5 67451,448,15,433,0.033482142857142856,0.0032832598592536077
ZCTA5 52638,209,7,202,0.03349282296650718,0.0031011775703575412
ZCTA5 67557,209,7,202,0.03349282296650718,0.0031011775703575412
ZCTA5 04360,209,7,202,0.03349282296650718,0.0031011775703575412
ZCTA5 83627,239,8,231,0.03347280334728033,0.0015951427561560272
ZCTA5 85605,239,8,231,0.03347280334728033,0.0015951427561560272
ZCTA5 31705,10910,365,10545,0.033455545371219066,7.528131557847167e-4
ZCTA5 65025,269,9,260,0.03345724907063197,2.7360240443561907e-4
ZCTA5 27847,299,10,289,0.033444816053511704,-9.071148688639005e-4
ZCTA5 30315,12286,411,11875,0.033452710402083675,-9.486209043362824e-4
ZCTA5 79607,628,21,607,0.03343949044585987,-0.002056823943623565
ZCTA5 72617,30,1,29,0.03333333333333333,-0.003683049969040408
ZCTA5 62466,1017,34,983,0.03343166175024582,-0.004005841230446279
ZCTA5 99017,60,2,58,0.03333333333333333,-0.0052086192171147535
ZCTA5 57058,778,26,752,0.033419023136246784,-0.005464103635597576
ZCTA5 95361,12020,402,11618,0.03344425956738769,-0.006090759835038985
ZCTA5 56543,90,3,87,0.03333333333333333,-0.006379229673192968
ZCTA5 31546,2423,81,2342,0.03342963268675196,-0.006738590445592299
ZCTA5 74468,120,4,116,0.03333333333333333,-0.007366099938080816
ZCTA5 82515,180,6,174,0.03333333333333333,-0.009021593121322382
ZCTA5 53206,8165,273,7892,0.033435394978567054,-0.009474435208397105
ZCTA5 78597,1527,51,1476,0.03339882121807466,-0.012045169560047817
ZCTA5 16647,330,11,319,0.03333333333333333,-0.012215294831437106
ZCTA5 49958,360,12,348,0.03333333333333333,-0.012758459346385935
ZCTA5 23890,1617,54,1563,0.03339517625231911,-0.013210154951842629
ZCTA5 32430,420,14,406,0.03333333333333333,-0.01378071112251758
ZCTA5 14091,420,14,406,0.03333333333333333,-0.01378071112251758
ZCTA5 74701,9364,313,9051,0.033425886373344725,-0.015263202888029426
ZCTA5 70426,1797,60,1737,0.0333889816360601,-0.015386349595599895
ZCTA5 63437,600,20,580,0.03333333333333333,-0.016471100190605697
ZCTA5 34205,12686,424,12262,0.03342267066057071,-0.019779696374148455
ZCTA5 31554,1888,63,1825,0.03336864406779661,-0.02068543756758288
ZCTA5 85023,12687,424,12263,0.03342003625758651,-0.021430631277819617
ZCTA5 83330,2457,82,2375,0.03337403337403337,-0.02211192763363908
ZCTA5 61733,331,11,320,0.03323262839879154,-0.02242270283298793
ZCTA5 15081,181,6,175,0.03314917127071823,-0.02282513947741291
ZCTA5 48735,451,15,436,0.03325942350332594,-0.023009013207796126
ZCTA5 31624,481,16,465,0.033264033264033266,-0.02319972994219018
ZCTA5 04863,481,16,465,0.033264033264033266,-0.02319972994219018
ZCTA5 79220,91,3,88,0.03296703296703297,-0.02584673724814264
ZCTA5 36279,961,32,929,0.03329864724245578,-0.026825036385524803
ZCTA5 15554,961,32,929,0.03329864724245578,-0.026825036385524803
ZCTA5 54634,1680,56,1624,0.03333333333333333,-0.02756142224503516
ZCTA5 74534,61,2,59,0.03278688524590164,-0.028986174937661806
ZCTA5 29696,2010,67,1943,0.03333333333333333,-0.030147063273029646
ZCTA5 63091,572,19,553,0.033216783216783216,-0.031583688268813775
ZCTA5 95916,512,17,495,0.033203125,-0.031599990762955145
ZCTA5 72863,692,23,669,0.033236994219653176,-0.03178236697671848
ZCTA5 59520,422,14,408,0.03317535545023697,-0.03186092570288064
ZCTA5 54426,1651,55,1596,0.03331314354936402,-0.031884642740847194
ZCTA5 14782,902,30,872,0.03325942350332594,-0.03253965853528695
ZCTA5 68710,302,10,292,0.033112582781456956,-0.033019394601091025
ZCTA5 57266,242,8,234,0.03305785123966942,-0.03429275740610843
ZCTA5 07440,1442,48,1394,0.033287101248266296,-0.03529776680550114
ZCTA5 13815,5574,186,5388,0.03336921420882669,-0.035305720043817455
ZCTA5 50571,182,6,176,0.03296703296703297,-0.03655280635941717
ZCTA5 29556,5036,168,4868,0.03335980937251787,-0.0372702142071123
ZCTA5 19107,7371,246,7125,0.03337403337403337,-0.03829898211474914
ZCTA5 95412,152,5,147,0.03289473684210526,-0.03836142592646511
ZCTA5 31790,663,22,641,0.033182503770739065,-0.03891189678759056
ZCTA5 75932,573,19,554,0.03315881326352531,-0.03932819385635847
ZCTA5 47390,2192,73,2119,0.0333029197080292,-0.039401016884992805
ZCTA5 79601,7611,254,7357,0.0333727499671528,-0.03954015206776031
ZCTA5 72011,1473,49,1424,0.03326544467073999,-0.04029742328370195
ZCTA5 63140,122,4,118,0.03278688524590164,-0.04099264171816042
ZCTA5 75561,1953,65,1888,0.033282130056323606,-0.04230033700677782
ZCTA5 31823,333,11,322,0.03303303303303303,-0.042745504956326105
ZCTA5 38357,1084,36,1048,0.033210332103321034,-0.04466016258660518
ZCTA5 58046,273,9,264,0.03296703296703297,-0.044767862123666034
ZCTA5 97522,273,9,264,0.03296703296703297,-0.044767862123666034
ZCTA5 38623,92,3,89,0.03260869565217391,-0.04510225486839573
ZCTA5 58704,1564,52,1512,0.03324808184143223,-0.045342112182833544
ZCTA5 72359,213,7,206,0.03286384976525822,-0.04791803421801422
ZCTA5 96013,1745,58,1687,0.0332378223495702,-0.050277341541835226
ZCTA5 73538,2015,67,1948,0.03325062034739454,-0.05083236422925331
ZCTA5 08837,6329,211,6118,0.033338600094801704,-0.05116506617698794
ZCTA5 27559,815,27,788,0.033128834355828224,-0.05166298715431677
ZCTA5 38253,364,12,352,0.03296703296703297,-0.05169347449628528
ZCTA5 83524,364,12,352,0.03296703296703297,-0.05169347449628528
ZCTA5 38578,62,2,60,0.03225806451612903,-0.05237900983275466
ZCTA5 50052,62,2,60,0.03225806451612903,-0.05237900983275466
ZCTA5 73092,334,11,323,0.03293413173652695,-0.052861312603026026
ZCTA5 21914,304,10,294,0.03289473684210526,-0.054251248817177834
ZCTA5 53184,1596,53,1543,0.03320802005012531,-0.054704030212428964
ZCTA5 71423,1536,51,1485,0.033203125,-0.05473278952014552
ZCTA5 70776,1206,40,1166,0.03316749585406302,-0.05537905294149712
ZCTA5 31701,7379,246,7133,0.033337850657270636,-0.055604508988099335
ZCTA5 26705,274,9,265,0.032846715328467155,-0.055925391473000005
ZCTA5 80231,16988,567,16421,0.03337650105957146,-0.05635404948417867
ZCTA5 54102,455,15,440,0.03296703296703297,-0.05779506148342278
ZCTA5 28091,816,27,789,0.03308823529411765,-0.05814414543828523
ZCTA5 41230,4475,149,4326,0.03329608938547486,-0.05883777343087906
ZCTA5 22203,11932,398,11534,0.03335568219912839,-0.0598758895516612
ZCTA5 34946,2258,75,2183,0.033215234720992026,-0.06316108784612903
ZCTA5 75645,3398,113,3285,0.03325485579752796,-0.06463770800879065
ZCTA5 62824,727,24,703,0.033012379642365884,-0.06625590394407749
ZCTA5 05153,275,9,266,0.03272727272727273,-0.06704245984119757
ZCTA5 71826,426,14,412,0.03286384976525822,-0.06776633387337376
ZCTA5 33841,2980,99,2881,0.03322147651006711,-0.07066487368043453
ZCTA5 45155,124,4,120,0.03225806451612903,-0.07407510608915534
ZCTA5 62289,124,4,120,0.03225806451612903,-0.07407510608915534
ZCTA5 65280,124,4,120,0.03225806451612903,-0.07407510608915534
ZCTA5 12819,124,4,120,0.03225806451612903,-0.07407510608915534
ZCTA5 38341,939,31,908,0.03301384451544196,-0.07504953789811714
ZCTA5 31749,909,30,879,0.033003300330033,-0.07560883346451634
ZCTA5 28613,8497,283,8214,0.03330587266093916,-0.07606093083976263
ZCTA5 92116,16553,552,16001,0.03334742946897843,-0.07642819447144716
ZCTA5 84760,185,6,179,0.032432432432432434,-0.07728978528090685
ZCTA5 70721,276,9,267,0.03260869565217391,-0.07811939696798216
ZCTA5 28358,13351,445,12906,0.033330836641450076,-0.079301231869902
ZCTA5 48632,2112,70,2042,0.03314393939393939,-0.0793059580314788
ZCTA5 01605,10656,355,10301,0.03331456456456457,-0.08018799641121734
ZCTA5 36765,518,17,501,0.032818532818532815,-0.08046213151093064
ZCTA5 38236,246,8,238,0.032520325203252036,-0.08145960610525721
ZCTA5 96080,11136,371,10765,0.03331537356321839,-0.08149937811948593
ZCTA5 93311,14551,485,14066,0.033331042540031615,-0.0826502716500929
ZCTA5 72677,155,5,150,0.03225806451612903,-0.08281848632792997
ZCTA5 82411,155,5,150,0.03225806451612903,-0.08281848632792997
ZCTA5 47612,337,11,326,0.032640949554896145,-0.08302880002216628
ZCTA5 66079,337,11,326,0.032640949554896145,-0.08302880002216628
ZCTA5 97812,337,11,326,0.032640949554896145,-0.08302880002216628
ZCTA5 03217,850,28,822,0.03294117647058824,-0.08318627358759152
ZCTA5 42055,1091,36,1055,0.03299725022914757,-0.08394423746717954
ZCTA5 20841,2804,93,2711,0.03316690442225392,-0.08461662305939588
ZCTA5 40060,428,14,414,0.03271028037383177,-0.08559331725220219
ZCTA5 21005,760,25,735,0.03289473684210526,-0.08577875608539884
ZCTA5 76255,2294,76,2218,0.03312990409764603,-0.08639078117867051
ZCTA5 83252,1573,52,1521,0.03305785123966942,-0.08742971959432519
ZCTA5 25085,398,13,385,0.032663316582914576,-0.08774941949573287
ZCTA5 83328,1964,65,1899,0.03309572301425662,-0.08835984657286126
ZCTA5 54731,277,9,268,0.032490974729241874,-0.08915652862393457
ZCTA5 59410,277,9,268,0.032490974729241874,-0.08915652862393457
ZCTA5 62977,277,9,268,0.032490974729241874,-0.08915652862393457
ZCTA5 04949,368,12,356,0.03260869565217391,-0.09020450973679146
ZCTA5 56117,125,4,121,0.032,-0.0904184447277702
ZCTA5 52739,186,6,180,0.03225806451612903,-0.09072310628048087
ZCTA5 61013,186,6,180,0.03225806451612903,-0.09072310628048087
ZCTA5 23938,186,6,180,0.03225806451612903,-0.09072310628048087
ZCTA5 99573,186,6,180,0.03225806451612903,-0.09072310628048087
ZCTA5 53932,1002,33,969,0.03293413173652695,-0.0915584791832221
ZCTA5 33319,18181,606,17575,0.03333149991749629,-0.09204316167917784
ZCTA5 14744,459,15,444,0.032679738562091505,-0.0922777426599207
ZCTA5 67640,247,8,239,0.032388663967611336,-0.09313220355436357
ZCTA5 29111,580,19,561,0.032758620689655175,-0.09316539117640989
ZCTA5 38927,429,14,415,0.03263403263403263,-0.09447576343028219
ZCTA5 98325,671,22,649,0.03278688524590164,-0.09613626637582752
ZCTA5 65332,520,17,503,0.032692307692307694,-0.09662433951692216
ZCTA5 70443,3709,123,3586,0.03316257751415476,-0.09878387564283872
ZCTA5 72576,1696,56,1640,0.0330188679245283,-0.09971166528908565
ZCTA5 63106,4700,156,4544,0.033191489361702124,-0.10017775901468762
ZCTA5 48627,33,1,32,0.030303030303030304,-0.1006696851262212
ZCTA5 68751,33,1,32,0.030303030303030304,-0.1006696851262212
ZCTA5 84744,95,3,92,0.031578947368421054,-0.10164737385667136
ZCTA5 98245,1847,61,1786,0.03302652950730915,-0.1022247353195342
ZCTA5 67070,430,14,416,0.03255813953488372,-0.10333765686728437
ZCTA5 57024,187,6,181,0.03208556149732621,-0.10408505207032341
ZCTA5 76627,521,17,504,0.03262955854126679,-0.10468227779873854
ZCTA5 63435,1607,53,1554,0.03298070939639079,-0.10556688676678536
ZCTA5 62639,126,4,122,0.031746031746031744,-0.10663299645676781
ZCTA5 73066,126,4,122,0.031746031746031744,-0.10663299645676781
ZCTA5 88434,126,4,122,0.031746031746031744,-0.10663299645676781
ZCTA5 26142,1005,33,972,0.03283582089552239,-0.10902739680021686
ZCTA5 38954,370,12,358,0.032432432432432434,-0.1093042625771629
ZCTA5 55726,461,15,446,0.03253796095444685,-0.10940717317434276
ZCTA5 54930,673,22,651,0.03268945022288262,-0.11033621042743379
ZCTA5 74878,552,18,534,0.03260869565217391,-0.11047751067652802
ZCTA5 03750,279,9,270,0.03225806451612903,-0.11111265913373301
ZCTA5 32024,7045,234,6811,0.03321504613200851,-0.11165306932831887
ZCTA5 73135,8335,277,8058,0.03323335332933414,-0.1121511791951517
ZCTA5 21719,431,14,417,0.03248259860788863,-0.11217910471722525
ZCTA5 73090,340,11,329,0.03235294117647059,-0.11293055662406919
ZCTA5 38474,3023,100,2923,0.033079722130334104,-0.11451585209683379
ZCTA5 79504,1127,37,1090,0.032830523513753325,-0.11644446240050711
ZCTA5 97148,1278,42,1236,0.03286384976525822,-0.11737473331135918
ZCTA5 81418,674,22,652,0.032640949554896145,-0.11742045505891108
ZCTA5 63359,553,18,535,0.0325497287522604,-0.11828894941740277
ZCTA5 59222,65,2,63,0.03076923076923077,-0.12038354310752371
ZCTA5 61012,856,28,828,0.03271028037383177,-0.12104723010656737
ZCTA5 74569,280,9,271,0.03214285714285714,-0.12203229023948578
ZCTA5 95651,280,9,271,0.03214285714285714,-0.12203229023948578
ZCTA5 96128,280,9,271,0.03214285714285714,-0.12203229023948578
ZCTA5 20143,341,11,330,0.03225806451612903,-0.12283966660174943
ZCTA5 20110,14400,479,13921,0.03326388888888889,-0.12703434258696272
ZCTA5 40943,250,8,242,0.032,-0.1278709908226947
ZCTA5 38105,3178,105,3073,0.03303964757709251,-0.12997841895994627
ZCTA5 05743,1552,51,1501,0.03286082474226804,-0.13000934135064213
ZCTA5 06855,3389,112,3277,0.03304809678371201,-0.13148861012705274
ZCTA5 38859,342,11,331,0.03216374269005848,-0.13272002380488862
ZCTA5 92352,2276,75,2201,0.032952548330404216,-0.13310496663856375
ZCTA5 76635,403,13,390,0.03225806451612903,-0.13354079661994217
ZCTA5 46763,737,24,713,0.032564450474898234,-0.13433486531262898
ZCTA5 59101,16923,563,16360,0.03326833303787745,-0.13449908306189884
ZCTA5 72421,220,7,213,0.031818181818181815,-0.1349508778863796
ZCTA5 70090,2668,88,2580,0.03298350824587706,-0.13521914413361213
ZCTA5 77532,10387,345,10042,0.03321459516703572,-0.13582922698477246
ZCTA5 74930,798,26,772,0.03258145363408521,-0.13711254735302555
ZCTA5 65058,373,12,361,0.032171581769437,-0.13776271136185572
ZCTA5 51532,312,10,302,0.03205128205128205,-0.1378123038548263
ZCTA5 95563,312,10,302,0.03205128205128205,-0.1378123038548263
ZCTA5 76474,97,3,94,0.030927835051546393,-0.13837371002647256
ZCTA5 84055,434,14,420,0.03225806451612903,-0.13858183393727572
ZCTA5 74455,1252,41,1211,0.03274760383386582,-0.13904869590537708
ZCTA5 30285,251,8,243,0.03187250996015936,-0.13935897337240913
ZCTA5 28174,2820,93,2727,0.03297872340425532,-0.1404306547158054
ZCTA5 27214,3783,125,3658,0.03304255881575469,-0.14081606397130136
ZCTA5 37097,950,31,919,0.03263157894736842,-0.14101029576527702
ZCTA5 00692,11620,386,11234,0.03321858864027539,-0.14127112218660698
ZCTA5 73068,4595,152,4443,0.033079434167573446,-0.1412937920645022
ZCTA5 55923,1826,60,1766,0.03285870755750274,-0.14152259345839868
ZCTA5 08608,556,18,538,0.03237410071942446,-0.14163939497925543
ZCTA5 65672,3603,119,3484,0.03302803219539273,-0.1422742173095416
ZCTA5 50862,66,2,64,0.030303030303030304,-0.14236843402533106
ZCTA5 73487,66,2,64,0.030303030303030304,-0.14236843402533106
ZCTA5 82323,66,2,64,0.030303030303030304,-0.14236843402533106
ZCTA5 79356,1585,52,1533,0.032807570977917984,-0.1431746459403753
ZCTA5 61006,708,23,685,0.03248587570621469,-0.1432922616671267
ZCTA5 16877,799,26,773,0.03254067584480601,-0.14360846281889267
ZCTA5 65591,526,17,509,0.03231939163498099,-0.14474295485836888
ZCTA5 05767,526,17,509,0.03231939163498099,-0.14474295485836888
ZCTA5 29935,1857,61,1796,0.03284868066774367,-0.14512175008159317
ZCTA5 75148,2249,74,2175,0.0329035126722988,-0.14524522925986325
ZCTA5 75643,860,28,832,0.03255813953488372,-0.14614151584557075
ZCTA5 42410,587,19,568,0.03236797274275979,-0.1463600757612631
ZCTA5 13733,2129,70,2059,0.03287928604978863,-0.14753365563676998
ZCTA5 92024,19544,650,18894,0.03325828898894802,-0.1523484738750227
ZCTA5 44669,527,17,510,0.03225806451612903,-0.15270974331721068
ZCTA5 79005,588,19,569,0.03231292517006803,-0.1539078704471662
ZCTA5 50559,129,4,125,0.031007751937984496,-0.15452642718094448
ZCTA5 47874,1255,41,1214,0.03266932270916335,-0.15463723670137064
ZCTA5 79533,160,5,155,0.03125,-0.1550543162734737
ZCTA5 50140,1013,33,980,0.03257650542941757,-0.15535874372726363
ZCTA5 16746,497,16,481,0.03219315895372234,-0.15634628291195865
ZCTA5 55973,98,3,95,0.030612244897959183,-0.1564591401802603
ZCTA5 13640,191,6,185,0.031413612565445025,-0.15683592228724907
ZCTA5 62023,35,1,34,0.02857142857142857,-0.16064527398981532
ZCTA5 79508,528,17,511,0.032196969696969696,-0.16066156617878785
ZCTA5 95612,406,13,393,0.03201970443349754,-0.16074605201950468
ZCTA5 95457,1347,44,1303,0.032665181885671864,-0.16105013096568985
ZCTA5 61020,1014,33,981,0.03254437869822485,-0.16112457407634867
ZCTA5 93111,6166,204,5962,0.03308465780084333,-0.16139383502253063
ZCTA5 74470,589,19,570,0.03225806451612903,-0.16144295083734125
ZCTA5 35593,650,21,629,0.03230769230769231,-0.16256067438051092
ZCTA5 56568,67,2,65,0.029850746268656716,-0.16403081644652637
ZCTA5 72395,437,14,423,0.032036613272311214,-0.1648043320174769
ZCTA5 13863,284,9,275,0.03169014084507042,-0.16532845656498302
ZCTA5 73572,1348,44,1304,0.032640949554896145,-0.16605760004433257
ZCTA5 67045,1439,47,1392,0.03266157053509382,-0.16722099235768026
ZCTA5 80827,315,10,305,0.031746031746031744,-0.16860157126602543
ZCTA5 10988,315,10,305,0.031746031746031744,-0.16860157126602543
ZCTA5 38258,590,19,571,0.03220338983050847,-0.16896536530460432
ZCTA5 13476,1379,45,1334,0.032632342277012324,-0.16973366890477237
ZCTA5 50068,130,4,126,0.03076923076923077,-0.17024803934918614
ZCTA5 50420,130,4,126,0.03076923076923077,-0.17024803934918614
ZCTA5 63431,130,4,126,0.03076923076923077,-0.17024803934918614
ZCTA5 21813,955,31,924,0.032460732984293195,-0.17074180138768394
ZCTA5 42051,1349,44,1305,0.03261675315048184,-0.17106137859815038
ZCTA5 04984,254,8,246,0.031496062992125984,-0.17355375981236226
ZCTA5 39145,1834,60,1774,0.03271537622682661,-0.17596758870745408
ZCTA5 45001,285,9,276,0.031578947368421054,-0.1760584159757032
ZCTA5 05871,591,19,572,0.032148900169204735,-0.17647516194920634
ZCTA5 27704,14583,484,14099,0.03318933004182953,-0.17790993439941116
ZCTA5 73568,408,13,395,0.031862745098039214,-0.1787726312982524
ZCTA5 16404,1290,42,1248,0.03255813953488372,-0.17898607202925543
ZCTA5 32615,5572,184,5388,0.033022254127781765,-0.1793278105396952
ZCTA5 76945,835,27,808,0.032335329341317366,-0.1798065157961053
ZCTA5 47436,561,18,543,0.03208556149732621,-0.1802805984942523
ZCTA5 61873,2379,78,2301,0.03278688524590164,-0.18101860446692378
ZCTA5 65065,2530,83,2447,0.032806324110671935,-0.181237601697759
ZCTA5 64442,347,11,336,0.03170028818443804,-0.1816970425502814
ZCTA5 66933,193,6,187,0.031088082901554404,-0.18280458907018907
ZCTA5 25703,2017,66,1951,0.03272186415468518,-0.18291766713322974
ZCTA5 50518,162,5,157,0.030864197530864196,-0.1833281297210451
ZCTA5 99158,224,7,217,0.03125,-0.18346274115756633
ZCTA5 98513,12876,427,12449,0.033162472817645235,-0.18412128270306657
ZCTA5 59006,378,12,366,0.031746031746031744,-0.18469376762643394
ZCTA5 62255,378,12,366,0.031746031746031744,-0.18469376762643394
ZCTA5 42728,6146,203,5943,0.03302961275626424,-0.18513001828961484
ZCTA5 51550,68,2,66,0.029411764705882353,-0.18538132530711907
ZCTA5 68458,68,2,66,0.029411764705882353,-0.18538132530711907
ZCTA5 99841,68,2,66,0.029411764705882353,-0.18538132530711907
ZCTA5 56210,1,0,1,0,-0.1860434724434047
ZCTA5 82229,1,0,1,0,-0.1860434724434047
ZCTA5 84743,1,0,1,0,-0.1860434724434047
ZCTA5 99706,1,0,1,0,-0.1860434724434047
ZCTA5 30458,15909,528,15381,0.033188761078634735,-0.1862215469736704
ZCTA5 05035,317,10,307,0.031545741324921134,-0.1889673484339117
ZCTA5 96132,36,1,35,0.027777777777777776,-0.18940562169084166
ZCTA5 00949,25361,843,24518,0.033240014195023856,-0.18973046668363208
ZCTA5 36607,2593,85,2508,0.03278056305437717,-0.19077528866905988
ZCTA5 70759,715,23,692,0.032167832167832165,-0.1912925254517367
ZCTA5 73004,348,11,337,0.031609195402298854,-0.1914087727103607
ZCTA5 97027,4764,157,4607,0.03295549958018472,-0.19143958012198994
ZCTA5 32355,100,3,97,0.03,-0.19209534108879114
ZCTA5 76309,5186,171,5015,0.032973389895873506,-0.19257396117044537
ZCTA5 66072,471,15,456,0.03184713375796178,-0.19396381423657394
ZCTA5 59221,685,22,663,0.032116788321167884,-0.19466576006362665
ZCTA5 76020,10119,335,9784,0.03310603814606186,-0.19479360165501786
ZCTA5 11023,2836,93,2743,0.032792665726375174,-0.19593003129804867
ZCTA5 56621,1869,61,1808,0.03263777421080792,-0.1962956900410446
ZCTA5 27576,6332,209,6123,0.033006948831332913,-0.1979397436159561
ZCTA5 54126,1385,45,1340,0.032490974729241874,-0.19936005864102346
ZCTA5 76455,349,11,338,0.03151862464183381,-0.20109303014911736
ZCTA5 45307,132,4,128,0.030303030303030304,-0.2013393702524424
ZCTA5 50567,132,4,128,0.030303030303030304,-0.2013393702524424
ZCTA5 11962,132,4,128,0.030303030303030304,-0.2013393702524424
ZCTA5 39476,2898,95,2803,0.032781228433402344,-0.20148415599275724
ZCTA5 47229,1173,38,1135,0.03239556692242114,-0.2016405430685051
ZCTA5 71375,472,15,457,0.03177966101694915,-0.20232158007726472
ZCTA5 39045,564,18,546,0.031914893617021274,-0.20330201968138256
ZCTA5 80455,257,8,249,0.0311284046692607,-0.20735304552037445
ZCTA5 78373,2023,66,1957,0.03262481463173505,-0.20746426384306774
ZCTA5 75954,1083,35,1048,0.032317636195752536,-0.2080127971535269
ZCTA5 50242,195,6,189,0.03076923076923077,-0.2085104130573892
ZCTA5 37764,3474,114,3360,0.03281519861830743,-0.20946592873370345
ZCTA5 58443,101,3,98,0.0297029702970297,-0.2096540258571197
ZCTA5 59007,101,3,98,0.0297029702970297,-0.2096540258571197
ZCTA5 58444,101,3,98,0.0297029702970297,-0.2096540258571197
ZCTA5 63044,3987,131,3856,0.032856784549786806,-0.2097966696632792
ZCTA5 57760,473,15,458,0.03171247357293869,-0.21066188430283284
ZCTA5 37360,565,18,547,0.03185840707964602,-0.21094893442244708
ZCTA5 68833,164,5,159,0.03048780487804878,-0.2112619552041876
ZCTA5 36703,5224,172,5052,0.032924961715160794,-0.21274358856405015
ZCTA5 50660,504,16,488,0.031746031746031744,-0.21326599291353562
ZCTA5 34474,6730,222,6508,0.03298662704309064,-0.21333686099866828
ZCTA5 87532,6429,212,6217,0.03297557940581739,-0.21343764490860492
ZCTA5 37183,1236,40,1196,0.032362459546925564,-0.2134574991765645
ZCTA5 04460,535,17,518,0.03177570093457944,-0.21591057352482337
ZCTA5 60176,4291,141,4150,0.0328594733162433,-0.21666854454688747
ZCTA5 42741,133,4,129,0.03007518796992481,-0.21671304215228412
ZCTA5 74050,133,4,129,0.03007518796992481,-0.21671304215228412
ZCTA5 73730,289,9,280,0.031141868512110725,-0.21861070798742843
ZCTA5 73734,320,10,310,0.03125,-0.21927991697843385
ZCTA5 32455,1723,56,1667,0.03250145095763204,-0.21994130739939025
ZCTA5 72466,597,19,578,0.031825795644891124,-0.22127162731515224
ZCTA5 39827,1511,49,1462,0.03242885506287227,-0.22165946133255165
ZCTA5 45898,382,12,370,0.031413612565445025,-0.2217994883659204
ZCTA5 04459,413,13,400,0.031476997578692496,-0.2234601812434522
ZCTA5 27885,413,13,400,0.031476997578692496,-0.2234601812434522
ZCTA5 31743,165,5,160,0.030303030303030304,-0.2251042592157301
ZCTA5 05445,1451,47,1404,0.03239145416953825,-0.22513676964077406
ZCTA5 45362,444,14,430,0.03153153153153153,-0.22530466484535652
ZCTA5 23314,3268,107,3161,0.03274173806609547,-0.2265144533764717
ZCTA5 78253,12812,424,12388,0.033093974399000935,-0.22678048597935127
ZCTA5 29667,102,3,99,0.029411764705882353,-0.22704482742166987
ZCTA5 32697,102,3,99,0.029411764705882353,-0.22704482742166987
ZCTA5 99160,102,3,99,0.029411764705882353,-0.22704482742166987
ZCTA5 79748,70,2,68,0.02857142857142857,-0.22718672520753863
ZCTA5 52340,1239,40,1199,0.03228410008071025,-0.2290551531449267
ZCTA5 50217,290,9,281,0.03103448275862069,-0.22915831635824147
ZCTA5 78830,259,8,251,0.03088803088803089,-0.22967126086007383
ZCTA5 85631,1361,44,1317,0.03232916972814107,-0.23082108010699748
ZCTA5 29812,4266,140,4126,0.032817627754336616,-0.2312357297004803
ZCTA5 47994,134,4,130,0.029850746268656716,-0.23197460526580935
ZCTA5 71223,134,4,130,0.029850746268656716,-0.23197460526580935
ZCTA5 16620,134,4,130,0.029850746268656716,-0.23197460526580935
ZCTA5 22734,1057,34,1023,0.03216650898770104,-0.23282464508873277
ZCTA5 45860,874,28,846,0.032036613272311214,-0.23306852147695437
ZCTA5 55771,752,24,728,0.031914893617021274,-0.23475295157968165
ZCTA5 03887,752,24,728,0.031914893617021274,-0.23475295157968165
ZCTA5 27020,2454,80,2374,0.032599837000814993,-0.2353791249192091
ZCTA5 62445,476,15,461,0.031512605042016806,-0.23557885027060682
ZCTA5 74131,1088,35,1053,0.03216911764705882,-0.23573563233801179
ZCTA5 77963,1939,63,1876,0.032490974729241874,-0.23588600249674255
ZCTA5 70131,11977,396,11581,0.03306337146196878,-0.23789114497540426
ZCTA5 26447,538,17,521,0.031598513011152414,-0.23937046175783658
ZCTA5 32179,3333,109,3224,0.032703270327032706,-0.24110632913912344
ZCTA5 54460,967,31,936,0.03205791106514995,-0.24147213968880374
ZCTA5 49766,906,29,877,0.03200883002207505,-0.24194748065577765
ZCTA5 60056,20724,687,20037,0.03314997104806022,-0.2435964331717291
ZCTA5 65647,784,25,759,0.03188775510204082,-0.2439214446496889
ZCTA5 58464,103,3,100,0.02912621359223301,-0.2442713878966937
ZCTA5 73844,103,3,100,0.02912621359223301,-0.2442713878966937
ZCTA5 59745,38,1,37,0.02631578947368421,-0.24471436770880542
ZCTA5 72424,38,1,37,0.02631578947368421,-0.24471436770880542
ZCTA5 71261,508,16,492,0.031496062992125984,-0.24544208092748535
ZCTA5 19507,1090,35,1055,0.03211009174311927,-0.24678945041263303
ZCTA5 27819,135,4,131,0.02962962962962963,-0.24712591577078785
ZCTA5 61543,71,2,69,0.028169014084507043,-0.2476604432655409
ZCTA5 80754,71,2,69,0.028169014084507043,-0.2476604432655409
ZCTA5 49325,662,21,641,0.03172205438066465,-0.24784999547800074
ZCTA5 47042,1699,55,1644,0.032371983519717484,-0.24808116014142018
ZCTA5 49705,354,11,343,0.031073446327683617,-0.24910832624505475
ZCTA5 55922,354,11,343,0.031073446327683617,-0.24910832624505475
ZCTA5 64421,354,11,343,0.031073446327683617,-0.24910832624505475
ZCTA5 78671,354,11,343,0.031073446327683617,-0.24910832624505475
ZCTA5 37692,2003,65,1938,0.032451323015476784,-0.24961613680501626
ZCTA5 72141,292,9,283,0.030821917808219176,-0.25014692060845056
ZCTA5 71866,261,8,253,0.03065134099616858,-0.2518212057811498
ZCTA5 53582,478,15,463,0.03138075313807531,-0.2521043516062787
ZCTA5 56243,663,21,642,0.03167420814479638,-0.2548883391692347
ZCTA5 13052,571,18,553,0.03152364273204904,-0.256551756414543
ZCTA5 99743,386,12,374,0.031088082901554404,-0.25852472912710184
ZCTA5 41601,355,11,344,0.030985915492957747,-0.25863138429366517
ZCTA5 55765,355,11,344,0.030985915492957747,-0.25863138429366517
ZCTA5 55325,1671,54,1617,0.03231597845601436,-0.258759917290209
ZCTA5 74060,199,6,193,0.03015075376884422,-0.25915728164205754
ZCTA5 37359,324,10,314,0.030864197530864196,-0.25926512741599606
ZCTA5 59248,324,10,314,0.030864197530864196,-0.25926512741599606
ZCTA5 72832,448,14,434,0.03125,-0.25945549673517493
ZCTA5 88101,17462,578,16884,0.03310044668422861,-0.25999873901212917
ZCTA5 71674,293,9,284,0.030716723549488054,-0.26058845959328253
ZCTA5 56546,104,3,101,0.028846153846153848,-0.26133723292850003
ZCTA5 97014,510,16,494,0.03137254901960784,-0.26143663605067174
ZCTA5 54641,2,0,2,0,-0.2631052019204481
ZCTA5 54643,2,0,2,0,-0.2631052019204481
ZCTA5 54765,2,0,2,0,-0.2631052019204481
ZCTA5 57571,2,0,2,0,-0.2631052019204481
ZCTA5 56577,2,0,2,0,-0.2631052019204481
ZCTA5 80473,2,0,2,0,-0.2631052019204481
ZCTA5 83433,2,0,2,0,-0.2631052019204481
ZCTA5 20118,2,0,2,0,-0.2631052019204481
ZCTA5 93634,2,0,2,0,-0.2631052019204481
ZCTA5 43804,971,31,940,0.03192584963954686,-0.26485593507668326
ZCTA5 54174,1368,44,1324,0.03216374269005848,-0.26544004760977724
ZCTA5 04041,603,19,584,0.03150912106135987,-0.26562567660510006
ZCTA5 64075,4369,143,4226,0.032730601968413826,-0.2659997114001861
ZCTA5 41563,168,5,163,0.02976190476190476,-0.266146042708658
ZCTA5 63539,72,2,70,0.027777777777777776,-0.2678599989848959
ZCTA5 74530,72,2,70,0.027777777777777776,-0.2678599989848959
ZCTA5 99131,72,2,70,0.027777777777777776,-0.2678599989848959
ZCTA5 11939,449,14,435,0.031180400890868598,-0.2679463440466152
ZCTA5 60636,11062,365,10697,0.03299584161996023,-0.268121665239782
ZCTA5 96719,511,16,495,0.03131115459882583,-0.26941078060989543
ZCTA5 49056,1369,44,1325,0.03214024835646457,-0.27037128516351866
ZCTA5 66042,294,9,285,0.030612244897959183,-0.2709951801007521
ZCTA5 76427,294,9,285,0.030612244897959183,-0.2709951801007521
ZCTA5 72762,14283,472,13811,0.03304627879297067,-0.2711450548919507
ZCTA5 28521,1003,32,971,0.031904287138584245,-0.27298244812050526
ZCTA5 97051,6063,199,5864,0.03282203529605806,-0.27376068454051955
ZCTA5 39474,2252,73,2179,0.03241563055062167,-0.27409651904119087
ZCTA5 49682,1644,53,1591,0.03223844282238443,-0.2741438610634526
ZCTA5 39854,942,30,912,0.03184713375796178,-0.2743062567029785
ZCTA5 76311,635,20,615,0.031496062992125984,-0.2744125887464309
ZCTA5 97833,388,12,376,0.030927835051546393,-0.2767474200529451
ZCTA5 05361,481,15,466,0.031185031185031187,-0.27676549020937596
ZCTA5 58636,357,11,346,0.03081232492997199,-0.2775988385609681
ZCTA5 16436,232,7,225,0.03017241379310345,-0.27798666027005675
ZCTA5 62440,543,17,526,0.03130755064456722,-0.2781852869777642
ZCTA5 52168,105,3,102,0.02857142857142857,-0.27824577654618315
ZCTA5 28678,2314,75,2239,0.032411408815903195,-0.27897335701274306
ZCTA5 86024,326,10,316,0.03067484662576687,-0.2790766019703996
ZCTA5 38929,574,18,556,0.0313588850174216,-0.27917636021810543
ZCTA5 54822,1828,59,1769,0.032275711159737416,-0.28021727393667695
ZCTA5 92121,1798,58,1740,0.03225806451612903,-0.28206960038390255
ZCTA5 53717,6127,201,5926,0.0328056144932267,-0.2823497266983442
ZCTA5 75860,1981,64,1917,0.03230691569914185,-0.2839848140709773
ZCTA5 83261,264,8,256,0.030303030303030304,-0.2847368680506621
ZCTA5 92358,420,13,407,0.030952380952380953,-0.28513613210744176
ZCTA5 56477,1097,35,1062,0.03190519598906107,-0.2853204102456186
ZCTA5 48897,544,17,527,0.03125,-0.2859060324356886
ZCTA5 56437,544,17,527,0.03125,-0.2859060324356886
ZCTA5 89011,9898,326,9572,0.03293594665589008,-0.28676116718641276
ZCTA5 28456,1525,49,1476,0.032131147540983604,-0.2873368542301088
ZCTA5 49872,73,2,71,0.0273972602739726,-0.28779375642023675
ZCTA5 61720,73,2,71,0.0273972602739726,-0.28779375642023675
ZCTA5 29432,1281,41,1240,0.03200624512099922,-0.28820900282207346
ZCTA5 95247,1769,57,1712,0.0322215941209723,-0.2883159618149842
ZCTA5 84082,233,7,226,0.030042918454935622,-0.28957759405429573
ZCTA5 64154,4438,145,4293,0.03267237494366832,-0.28966351353409137
ZCTA5 17249,170,5,165,0.029411764705882353,-0.2931136118155548
ZCTA5 25606,514,16,498,0.0311284046692607,-0.2932414891742792
ZCTA5 17262,545,17,528,0.031192660550458717,-0.2936128396729692
ZCTA5 04858,576,18,558,0.03125,-0.29419488027857305
ZCTA5 82637,1557,50,1507,0.03211303789338472,-0.2943097897817504
ZCTA5 36877,4803,157,4646,0.03268790339371226,-0.2953549892222375
ZCTA5 72347,265,8,257,0.03018867924528302,-0.29562768055292177
ZCTA5 05820,265,8,257,0.03018867924528302,-0.29562768055292177
ZCTA5 37866,638,20,618,0.03134796238244514,-0.2958632526876902
ZCTA5 24363,638,20,618,0.03134796238244514,-0.2958632526876902
ZCTA5 17057,9240,304,8936,0.0329004329004329,-0.29604994519448574
ZCTA5 50842,40,1,39,0.025,-0.2973501732005615
ZCTA5 98823,3775,123,3652,0.03258278145695364,-0.29776456722949973
ZCTA5 70345,3533,115,3418,0.032550240588734784,-0.2988185858433128
ZCTA5 32580,1497,48,1449,0.03206412825651302,-0.2991070717858977
ZCTA5 53964,1436,46,1390,0.03203342618384401,-0.299419718133868
ZCTA5 64505,5047,165,4882,0.032692688725975826,-0.30087373785573435
ZCTA5 08758,3443,112,3331,0.03252977054893988,-0.3016675639013859
ZCTA5 25124,608,19,589,0.03125,-0.30225650659850284
ZCTA5 53205,3413,111,3302,0.03252270729563434,-0.3026451773948339
ZCTA5 95389,266,8,258,0.03007518796992481,-0.30647852335489245
ZCTA5 39359,139,4,135,0.02877697841726619,-0.3066641968067202
ZCTA5 59052,74,2,72,0.02702702702702703,-0.3074697041868786
ZCTA5 66441,10241,337,9904,0.032906942681378774,-0.3080101804638739
ZCTA5 30467,4566,149,4417,0.03263250109505037,-0.3087947386343524
ZCTA5 70631,203,6,197,0.029556650246305417,-0.30882207246403975
ZCTA5 62988,516,16,500,0.031007751937984496,-0.30905285436188895
ZCTA5 13801,609,19,590,0.031198686371100164,-0.3095471085403676
ZCTA5 58251,825,26,799,0.03151515151515152,-0.30973468617022815
ZCTA5 69351,107,3,104,0.028037383177570093,-0.3116040849580676
ZCTA5 62573,702,22,680,0.03133903133903134,-0.31166414294450484
ZCTA5 38637,9550,314,9236,0.03287958115183246,-0.31230720112741095
ZCTA5 44880,1010,32,978,0.031683168316831684,-0.3130129219281792
ZCTA5 14772,1531,49,1482,0.03200522534291313,-0.31530170836666566
ZCTA5 85354,2263,73,2190,0.03225806451612903,-0.3164489919302683
ZCTA5 73840,267,8,259,0.0299625468164794,-0.317289730751365
ZCTA5 74880,703,22,681,0.031294452347083924,-0.31845915927468327
ZCTA5 34452,4933,161,4772,0.03263734036083519,-0.3190747081858964
ZCTA5 49055,2355,76,2279,0.03227176220806794,-0.31912074010991986
ZCTA5 72330,172,5,167,0.029069767441860465,-0.31977584354284255
ZCTA5 51023,1226,39,1187,0.03181076672104405,-0.32001733249048453
ZCTA5 48635,765,24,741,0.03137254901960784,-0.3201931791969297
ZCTA5 52074,140,4,136,0.02857142857142857,-0.32129054797963064
ZCTA5 28630,7986,262,7724,0.03280741297270223,-0.32145651879071235
ZCTA5 54814,1165,37,1128,0.03175965665236052,-0.3216558400224896
ZCTA5 74020,2903,94,2809,0.03238029624526352,-0.32178958494280685
ZCTA5 23117,3874,126,3748,0.03252452245740836,-0.3218091211567174
ZCTA5 35187,3,0,3,0,-0.32223674668851726
ZCTA5 47306,3,0,3,0,-0.32223674668851726
ZCTA5 69171,3,0,3,0,-0.32223674668851726
ZCTA5 88009,3,0,3,0,-0.32223674668851726
ZCTA5 16312,3,0,3,0,-0.32223674668851726
ZCTA5 18430,3,0,3,0,-0.32223674668851726
ZCTA5 86003,3,0,3,0,-0.32223674668851726
ZCTA5 97817,3,0,3,0,-0.32223674668851726
ZCTA5 49961,41,1,40,0.024390243902439025,-0.322756675605382
ZCTA5 75114,1960,63,1897,0.03214285714285714,-0.3228670918933341
ZCTA5 03042,2569,83,2486,0.032308291163877,-0.32300851506620804
ZCTA5 98625,2600,84,2516,0.03230769230769231,-0.32512134876102183
ZCTA5 39401,16396,541,15855,0.03299585264698707,-0.32641761607555736
ZCTA5 73666,75,2,73,0.02666666666666667,-0.3268954773438693
ZCTA5 12423,425,13,412,0.03058823529411765,-0.32857606823034
ZCTA5 30752,3361,109,3252,0.032430824159476346,-0.32995408273713933
ZCTA5 22576,890,28,862,0.03146067415730337,-0.3307430840503327
ZCTA5 56514,1412,45,1367,0.03186968838526912,-0.331123076881538
ZCTA5 67004,300,9,291,0.03,-0.33271889066305965
ZCTA5 16372,205,6,199,0.02926829268292683,-0.3332996105275279
ZCTA5 44304,1474,47,1427,0.03188602442333786,-0.3348268229578845
ZCTA5 58330,141,4,137,0.028368794326241134,-0.33581687928654763
ZCTA5 85141,141,4,137,0.028368794326241134,-0.33581687928654763
ZCTA5 74570,426,13,413,0.03051643192488263,-0.3372040246727259
ZCTA5 67861,768,24,744,0.03125,-0.33970698664608767
ZCTA5 60177,7482,245,7237,0.032745255279337075,-0.341047290211369
ZCTA5 57223,489,15,474,0.03067484662576687,-0.34179763698863874
ZCTA5 72482,489,15,474,0.03067484662576687,-0.34179763698863874
ZCTA5 70546,6213,203,6010,0.03267342668598101,-0.3422679513747152
ZCTA5 15955,923,29,894,0.0314192849404117,-0.34381183013294275
ZCTA5 52309,174,5,169,0.028735632183908046,-0.3461405782520363
ZCTA5 68922,583,18,565,0.030874785591766724,-0.34635930159427447
ZCTA5 50538,238,7,231,0.029411764705882353,-0.3468167026026625
ZCTA5 65760,238,7,231,0.029411764705882353,-0.3468167026026625
ZCTA5 75001,8361,274,8087,0.03277119961727066,-0.3473318308383142
ZCTA5 76664,1262,40,1222,0.03169572107765452,-0.3474098918757711
ZCTA5 57270,333,10,323,0.03003003003003003,-0.3474936217381085
ZCTA5 60929,333,10,323,0.03003003003003003,-0.3474936217381085
ZCTA5 45729,521,16,505,0.030710172744721688,-0.3483198625918883
ZCTA5 47568,270,8,262,0.02962962962962963,-0.34948882169691936
ZCTA5 47854,270,8,262,0.02962962962962963,-0.34948882169691936
ZCTA5 57632,270,8,262,0.02962962962962963,-0.34948882169691936
ZCTA5 72639,270,8,262,0.02962962962962963,-0.34948882169691936
ZCTA5 59259,142,4,138,0.028169014084507043,-0.3502447577294604
ZCTA5 77853,459,14,445,0.030501089324618737,-0.35184912175969124
ZCTA5 85013,9903,325,9578,0.03281833787741088,-0.3519193914205017
ZCTA5 18970,302,9,293,0.029801324503311258,-0.35302654005691164
ZCTA5 12577,584,18,566,0.030821917808219176,-0.35376116771033667
ZCTA5 92649,14247,469,13778,0.03291921106197796,-0.35514828538885873
ZCTA5 97064,1264,40,1224,0.03164556962025317,-0.3576006964641342
ZCTA5 68730,740,23,717,0.031081081081081083,-0.35901082210354684
ZCTA5 20004,1295,41,1254,0.03166023166023166,-0.35902505125003664
ZCTA5 31709,6190,202,5988,0.03263327948303716,-0.3591994718831509
ZCTA5 78561,175,5,170,0.02857142857142857,-0.3592137529053059
ZCTA5 49452,678,21,657,0.030973451327433628,-0.3592273557641893
ZCTA5 54463,271,8,263,0.02952029520295203,-0.3601447485390398
ZCTA5 73491,271,8,263,0.02952029520295203,-0.3601447485390398
ZCTA5 57050,110,3,107,0.02727272727272727,-0.3605412122446637
ZCTA5 16667,554,17,537,0.030685920577617327,-0.3623561998390767
ZCTA5 84308,77,2,75,0.025974025974025976,-0.3650253928220287
ZCTA5 97640,77,2,75,0.025974025974025976,-0.3650253928220287
ZCTA5 07735,6980,228,6752,0.032664756446991405,-0.36680824553234
ZCTA5 27824,617,19,598,0.03079416531604538,-0.3674523980862866
ZCTA5 87937,958,30,928,0.031315240083507306,-0.36817862213482183
ZCTA5 77515,10939,359,10580,0.03281835633970198,-0.36985884627798954
ZCTA5 37310,1788,57,1731,0.031879194630872486,-0.3703757561483743
ZCTA5 89027,7889,258,7631,0.03270376473570795,-0.37069430949820453
ZCTA5 23421,1451,46,1405,0.03170227429359063,-0.37112889835507773
ZCTA5 31207,4,0,4,0,-0.3720869448868094
ZCTA5 45618,4,0,4,0,-0.3720869448868094
ZCTA5 47405,4,0,4,0,-0.3720869448868094
ZCTA5 58239,4,0,4,0,-0.3720869448868094
ZCTA5 79831,4,0,4,0,-0.3720869448868094
ZCTA5 04741,4,0,4,0,-0.3720869448868094
ZCTA5 07881,4,0,4,0,-0.3720869448868094
ZCTA5 98438,4,0,4,0,-0.3720869448868094
ZCTA5 55052,804,25,779,0.03109452736318408,-0.37209343788364074
ZCTA5 84069,176,5,171,0.028409090909090908,-0.37221535997311955
ZCTA5 25831,711,22,689,0.030942334739803096,-0.37247988095033024
ZCTA5 62617,304,9,295,0.029605263157894735,-0.37320400212993815
ZCTA5 26534,990,31,959,0.031313131313131314,-0.3746462197629852
ZCTA5 32502,1452,46,1406,0.03168044077134986,-0.37588345208590473
ZCTA5 85304,9312,305,9007,0.03275343642611684,-0.3760856250720833
ZCTA5 58476,111,3,108,0.02702702702702703,-0.37657194331116856
ZCTA5 06021,111,3,108,0.02702702702702703,-0.37657194331116856
ZCTA5 72949,3742,121,3621,0.03233564938535542,-0.38053082322188775
ZCTA5 56137,494,15,479,0.030364372469635626,-0.3819159504457976
ZCTA5 35006,1084,34,1050,0.03136531365313653,-0.38247482983234277
ZCTA5 49834,78,2,76,0.02564102564102564,-0.3837432134142114
ZCTA5 99644,78,2,76,0.02564102564102564,-0.3837432134142114
ZCTA5 76048,9437,309,9128,0.03274345660697255,-0.3839928260672262
ZCTA5 62872,400,12,388,0.03,-0.3841906821775823
ZCTA5 88242,2403,77,2326,0.03204327923429047,-0.38464301359505143
ZCTA5 98837,15050,495,14555,0.03289036544850498,-0.3846990326126241
ZCTA5 88267,463,14,449,0.03023758099352052,-0.3849106518580258
ZCTA5 37079,899,28,871,0.03114571746384872,-0.38492743960397396
ZCTA5 16238,177,5,172,0.02824858757062147,-0.3851462985466009
ZCTA5 76534,961,30,931,0.031217481789802288,-0.38560769947052687
ZCTA5 26280,682,21,661,0.030791788856304986,-0.3866682449088356
ZCTA5 68944,495,15,480,0.030303030303030304,-0.3898920139617992
ZCTA5 81140,838,26,812,0.031026252983293555,-0.39087076550928784
ZCTA5 18332,838,26,812,0.031026252983293555,-0.39087076550928784
ZCTA5 61519,112,3,109,0.026785714285714284,-0.39246650496201624
ZCTA5 16683,145,4,141,0.027586206896551724,-0.39295280721020376
ZCTA5 75439,401,12,389,0.029925187032418952,-0.3930019100617253
ZCTA5 93222,683,21,662,0.03074670571010249,-0.39350383078902756
ZCTA5 16116,1117,35,1082,0.03133393017009848,-0.3940859721235433
ZCTA5 70501,11285,370,10915,0.03278688524590164,-0.39425460357565345
ZCTA5 93601,652,20,632,0.03067484662576687,-0.39467391544753716
ZCTA5 98467,6175,201,5974,0.03255060728744939,-0.3948917558321518
ZCTA5 73773,777,24,753,0.03088803088803089,-0.39780229284805313
ZCTA5 24312,777,24,753,0.03088803088803089,-0.39780229284805313
ZCTA5 46582,5115,166,4949,0.03245356793743891,-0.39799883406421116
ZCTA5 35063,1303,41,1262,0.031465848042977744,-0.39915299782091357
ZCTA5 40740,1118,35,1083,0.03130590339892665,-0.39947376890385267
ZCTA5 10968,1118,35,1083,0.03130590339892665,-0.39947376890385267
ZCTA5 15456,1149,36,1113,0.031331592689295036,-0.40013165895311287
ZCTA5 54411,1887,60,1827,0.03179650238473768,-0.40046755776470955
ZCTA5 23702,4205,136,4069,0.032342449464922714,-0.4009338945978916
ZCTA5 80466,1611,51,1560,0.03165735567970205,-0.4010821152333556
ZCTA5 52566,79,2,77,0.02531645569620253,-0.40223824992272217
ZCTA5 59913,243,7,236,0.02880658436213992,-0.4029035555602613
ZCTA5 60537,243,7,236,0.02880658436213992,-0.4029035555602613
ZCTA5 85367,10717,351,10366,0.03275170290193151,-0.40445928135432263
ZCTA5 84007,211,6,205,0.02843601895734597,-0.4053731422928986
ZCTA5 98619,211,6,205,0.02843601895734597,-0.4053731422928986
ZCTA5 50119,146,4,142,0.0273972602739726,-0.4070018334957978
ZCTA5 58021,146,4,142,0.0273972602739726,-0.4070018334957978
ZCTA5 57331,146,4,142,0.0273972602739726,-0.4070018334957978
ZCTA5 27208,685,21,664,0.030656934306569343,-0.40714566409964087
ZCTA5 54421,1243,39,1204,0.031375703942075624,-0.4075287275038447
ZCTA5 05761,371,11,360,0.029649595687331536,-0.40753529889193535
ZCTA5 17731,113,3,110,0.02654867256637168,-0.40822756612176825
ZCTA5 92532,6908,225,6683,0.03257093225246092,-0.4082779722343577
ZCTA5 48829,1274,40,1234,0.03139717425431711,-0.408317513406131
ZCTA5 81132,1274,40,1234,0.03139717425431711,-0.408317513406131
ZCTA5 72104,8574,280,8294,0.032656869605784934,-0.41060107937597823
ZCTA5 72082,779,24,755,0.03080872913992298,-0.4106227053253526
ZCTA5 47917,179,5,174,0.027932960893854747,-0.410799683240534
ZCTA5 55786,179,5,174,0.027932960893854747,-0.410799683240534
ZCTA5 29374,1398,44,1354,0.031473533619456366,-0.41184982328528935
ZCTA5 44611,717,22,695,0.030683403068340307,-0.41260563834671804
ZCTA5 50026,276,8,268,0.028985507246376812,-0.41286016346898996
ZCTA5 67838,308,9,299,0.02922077922077922,-0.4131759225501539
ZCTA5 69156,308,9,299,0.02922077922077922,-0.4131759225501539
ZCTA5 24374,308,9,299,0.02922077922077922,-0.4131759225501539
ZCTA5 23086,1306,41,1265,0.03139356814701378,-0.4141384422711427
ZCTA5 98279,340,10,330,0.029411764705882353,-0.41452524514572026
ZCTA5 97442,842,26,816,0.030878859857482184,-0.4155871519687941
ZCTA5 29409,5,0,5,0,-0.4160058511535618
ZCTA5 32612,5,0,5,0,-0.4160058511535618
ZCTA5 32830,5,0,5,0,-0.4160058511535618
ZCTA5 41760,5,0,5,0,-0.4160058511535618
ZCTA5 43403,5,0,5,0,-0.4160058511535618
ZCTA5 46125,5,0,5,0,-0.4160058511535618
ZCTA5 59062,5,0,5,0,-0.4160058511535618
ZCTA5 61625,5,0,5,0,-0.4160058511535618
ZCTA5 62962,5,0,5,0,-0.4160058511535618
ZCTA5 63750,5,0,5,0,-0.4160058511535618
ZCTA5 65623,5,0,5,0,-0.4160058511535618
ZCTA5 80479,5,0,5,0,-0.4160058511535618
ZCTA5 76939,5,0,5,0,-0.4160058511535618
ZCTA5 88343,5,0,5,0,-0.4160058511535618
ZCTA5 83671,5,0,5,0,-0.4160058511535618
ZCTA5 82219,5,0,5,0,-0.4160058511535618
ZCTA5 12862,5,0,5,0,-0.4160058511535618
ZCTA5 18459,5,0,5,0,-0.4160058511535618
ZCTA5 19535,5,0,5,0,-0.4160058511535618
ZCTA5 23708,5,0,5,0,-0.4160058511535618
ZCTA5 92267,5,0,5,0,-0.4160058511535618
ZCTA5 61732,749,23,726,0.030707610146862484,-0.4180282873727755
ZCTA5 97360,936,29,907,0.030982905982905984,-0.4204691743849525
ZCTA5 73011,147,4,143,0.027210884353741496,-0.42095971810716815
ZCTA5 21801,10787,353,10434,0.03272457587837212,-0.42144610509230956
ZCTA5 14560,812,25,787,0.03078817733990148,-0.4224866958959971
ZCTA5 27897,656,20,636,0.03048780487804878,-0.4225239104083752
ZCTA5 62046,277,8,269,0.02888086642599278,-0.4232925235984632
ZCTA5 05062,277,8,269,0.02888086642599278,-0.4232925235984632
ZCTA5 62006,180,5,175,0.027777777777777776,-0.4235238454213306
ZCTA5 68320,180,5,175,0.027777777777777776,-0.4235238454213306
ZCTA5 74558,180,5,175,0.027777777777777776,-0.4235238454213306
ZCTA5 54123,114,3,111,0.02631578947368421,-0.42385771821374363
ZCTA5 71256,341,10,331,0.02932551319648094,-0.4239918094873274
ZCTA5 26519,750,23,727,0.030666666666666665,-0.4245428559929601
ZCTA5 22742,625,19,606,0.0304,-0.4246270399438025
ZCTA5 21903,2292,73,2219,0.0318499127399651,-0.42713577570833794
ZCTA5 72944,1216,38,1178,0.03125,-0.4274552509471156
ZCTA5 73933,688,21,667,0.030523255813953487,-0.4275355447609096
ZCTA5 65567,500,15,485,0.03,-0.4295382408355455
ZCTA5 78039,626,19,607,0.03035143769968051,-0.43172353805221847
ZCTA5 52620,342,10,332,0.029239766081871343,-0.4334315634656524
ZCTA5 11363,2661,85,2576,0.03194287861706126,-0.4335673729280375
ZCTA5 94583,12003,393,11610,0.03274181454636341,-0.43406341055116726
ZCTA5 30660,374,11,363,0.029411764705882353,-0.4347577448987326
ZCTA5 53943,374,11,363,0.029411764705882353,-0.4347577448987326
ZCTA5 54768,1711,54,1657,0.031560490940970194,-0.4356249309939151
ZCTA5 89109,4187,135,4052,0.032242655839503226,-0.43598501909838894
ZCTA5 76631,181,5,176,0.027624309392265192,-0.4361807720087916
ZCTA5 04281,1742,55,1687,0.03157290470723306,-0.4366722400382639
ZCTA5 54847,1032,32,1000,0.031007751937984496,-0.4370667381287003
ZCTA5 98629,2968,95,2873,0.032008086253369275,-0.438139462311709
ZCTA5 38644,81,2,79,0.024691358024691357,-0.4385843013645269
ZCTA5 59002,81,2,79,0.024691358024691357,-0.4385843013645269
ZCTA5 58361,115,3,112,0.02608695652173913,-0.43935947809865966
ZCTA5 92363,2234,71,2163,0.03178155774395703,-0.4396636991267103
ZCTA5 33136,5830,189,5641,0.03241852487135506,-0.4397862691377533
ZCTA5 68111,7954,259,7695,0.03256223283882324,-0.4424139723820892
ZCTA5 73122,4950,160,4790,0.03232323232323232,-0.4425220241772647
ZCTA5 56575,311,9,302,0.028938906752411574,-0.4428269559146035
ZCTA5 52171,343,10,333,0.029154518950437316,-0.44284468113155884
ZCTA5 63821,343,10,333,0.029154518950437316,-0.44284468113155884
ZCTA5 25637,343,10,333,0.029154518950437316,-0.44284468113155884
ZCTA5 84071,375,11,364,0.029333333333333333,-0.44378492454399543
ZCTA5 60163,1713,54,1659,0.03152364273204904,-0.4443606768810231
ZCTA5 60447,4647,150,4497,0.03227888960619755,-0.4455744667409741
ZCTA5 76542,17384,571,16813,0.032846295444086515,-0.4457677628786967
ZCTA5 22736,247,7,240,0.02834008097165992,-0.44697851325269405
ZCTA5 04967,1529,48,1481,0.031393067364290386,-0.4482117406406674
ZCTA5 50277,182,5,177,0.027472527472527472,-0.44877128231390856
ZCTA5 75202,1344,42,1302,0.03125,-0.44939010264834395
ZCTA5 51529,754,23,731,0.03050397877984085,-0.450516464741615
ZCTA5 56588,215,6,209,0.027906976744186046,-0.4523367631751603
ZCTA5 54826,312,9,303,0.028846153846153848,-0.45264936534162425
ZCTA5 66732,116,3,113,0.02586206896551724,-0.45473529087668446
ZCTA5 16659,116,3,113,0.02586206896551724,-0.45473529087668446
ZCTA5 35559,6,0,6,0,-0.4557115774618846
ZCTA5 36727,6,0,6,0,-0.4557115774618846
ZCTA5 49434,6,0,6,0,-0.4557115774618846
ZCTA5 58009,6,0,6,0,-0.4557115774618846
ZCTA5 72338,6,0,6,0,-0.4557115774618846
ZCTA5 72636,6,0,6,0,-0.4557115774618846
ZCTA5 79916,6,0,6,0,-0.4557115774618846
ZCTA5 82422,6,0,6,0,-0.4557115774618846
ZCTA5 82224,6,0,6,0,-0.4557115774618846
ZCTA5 82052,6,0,6,0,-0.4557115774618846
ZCTA5 84753,6,0,6,0,-0.4557115774618846
ZCTA5 81227,6,0,6,0,-0.4557115774618846
ZCTA5 04635,6,0,6,0,-0.4557115774618846
ZCTA5 06269,6,0,6,0,-0.4557115774618846
ZCTA5 12604,6,0,6,0,-0.4557115774618846
ZCTA5 12911,6,0,6,0,-0.4557115774618846
ZCTA5 14261,6,0,6,0,-0.4557115774618846
ZCTA5 13475,6,0,6,0,-0.4557115774618846
ZCTA5 19472,6,0,6,0,-0.4557115774618846
ZCTA5 24570,6,0,6,0,-0.4557115774618846
ZCTA5 95735,6,0,6,0,-0.4557115774618846
ZCTA5 99651,6,0,6,0,-0.4557115774618846
ZCTA5 49349,3065,98,2967,0.03197389885807504,-0.4557670658367301
ZCTA5 37036,2177,69,2108,0.0316949931097841,-0.45647969307918923
ZCTA5 74939,248,7,241,0.028225806451612902,-0.45789020893928767
ZCTA5 62661,630,19,611,0.03015873015873016,-0.45999940217222124
ZCTA5 98203,13621,446,13175,0.03274355774172234,-0.46126322588225843
ZCTA5 81235,345,10,335,0.028985507246376812,-0.4615916953591685
ZCTA5 16240,599,18,581,0.03005008347245409,-0.463326641221593
ZCTA5 57544,216,6,210,0.027777777777777776,-0.46394712755718764
ZCTA5 80733,216,6,210,0.027777777777777776,-0.46394712755718764
ZCTA5 67869,536,16,520,0.029850746268656716,-0.4639492105316187
ZCTA5 51354,441,13,428,0.02947845804988662,-0.4643078445673198
ZCTA5 75414,1006,31,975,0.030815109343936383,-0.4655052335122858
ZCTA5 24549,1595,50,1545,0.03134796238244514,-0.4678008772195176
ZCTA5 61849,788,24,764,0.030456852791878174,-0.4679187632733086
ZCTA5 81148,117,3,114,0.02564102564102564,-0.46998753256038345
ZCTA5 20693,346,10,336,0.028901734104046242,-0.4709259317155439
ZCTA5 24317,1565,49,1516,0.031309904153354634,-0.47175337717083876
ZCTA5 99330,314,9,305,0.028662420382165606,-0.4722035851271035
ZCTA5 70113,3590,115,3475,0.03203342618384401,-0.4734241428343219
ZCTA5 59865,1287,40,1247,0.03108003108003108,-0.47366692885680106
ZCTA5 51242,83,2,81,0.024096385542168676,-0.4741097796986789
ZCTA5 58752,83,2,81,0.024096385542168676,-0.4741097796986789
ZCTA5 68381,83,2,81,0.024096385542168676,-0.4741097796986789
ZCTA5 73642,83,2,81,0.024096385542168676,-0.4741097796986789
ZCTA5 00647,1905,60,1845,0.031496062992125984,-0.4752965459453219
ZCTA5 65570,217,6,211,0.027649769585253458,-0.47550634438456874
ZCTA5 39074,5541,179,5362,0.03230463815195813,-0.4758917854587545
ZCTA5 46565,2428,77,2351,0.03171334431630972,-0.4770485386761298
ZCTA5 95843,14206,465,13741,0.032732648176826695,-0.4782954878580808
ZCTA5 78389,538,16,522,0.02973977695167286,-0.4791278557467239
ZCTA5 15059,1721,54,1667,0.03137710633352702,-0.4792035012802298
ZCTA5 27852,1164,36,1128,0.030927835051546393,-0.47934059239530685
ZCTA5 72561,250,7,243,0.028,-0.4795878149248142
ZCTA5 84327,250,7,243,0.028,-0.4795878149248142
ZCTA5 46803,3470,111,3359,0.031988472622478385,-0.4801707566001444
ZCTA5 13071,347,10,337,0.02881844380403458,-0.48023421139031247
ZCTA5 17058,696,21,675,0.03017241379310345,-0.4814870194141269
ZCTA5 92070,315,9,306,0.02857142857142857,-0.48193582196944595
ZCTA5 98271,10761,351,10410,0.03261778645107332,-0.4825431405090736
ZCTA5 18844,759,23,736,0.030303030303030304,-0.48279484937029726
ZCTA5 76449,978,30,948,0.03067484662576687,-0.48337485381640877
ZCTA5 54824,947,29,918,0.030623020063357972,-0.4845216405622541
ZCTA5 53503,822,25,797,0.030413625304136254,-0.484799074321275
ZCTA5 39662,602,18,584,0.029900332225913623,-0.48491842854557055
ZCTA5 63961,602,18,584,0.029900332225913623,-0.48491842854557055
ZCTA5 98252,3716,119,3597,0.032023681377825616,-0.4849639966287607
ZCTA5 17581,283,8,275,0.028268551236749116,-0.48513610353982817
ZCTA5 41408,185,5,180,0.02702702702702703,-0.48615228836437313
ZCTA5 83228,185,5,180,0.02702702702702703,-0.48615228836437313
ZCTA5 98621,185,5,180,0.02702702702702703,-0.48615228836437313
ZCTA5 49852,48,1,47,0.020833333333333332,-0.48626682669237103
ZCTA5 12139,48,1,47,0.020833333333333332,-0.48626682669237103
ZCTA5 49046,3411,109,3302,0.031955438287892116,-0.48680036720011177
ZCTA5 43782,218,6,212,0.027522935779816515,-0.48701493383446176
ZCTA5 99103,218,6,212,0.027522935779816515,-0.48701493383446176
ZCTA5 71845,885,27,858,0.030508474576271188,-0.48734253898519486
ZCTA5 22830,697,21,676,0.03012912482065997,-0.48818839486736365
ZCTA5 26814,152,4,148,0.02631578947368421,-0.48942873541761084
ZCTA5 74423,348,10,338,0.028735632183908046,-0.48951670025169536
ZCTA5 44431,1816,57,1759,0.031387665198237887,-0.48974968372050964
ZCTA5 43608,4999,161,4838,0.03220644128825765,-0.4906281961611257
ZCTA5 71426,84,2,82,0.023809523809523808,-0.4915782552779384
ZCTA5 17829,84,2,82,0.023809523809523808,-0.4915782552779384
ZCTA5 45775,508,15,493,0.02952755905511811,-0.4921773828819317
ZCTA5 29724,7,0,7,0,-0.492224761132147
ZCTA5 28733,7,0,7,0,-0.492224761132147
ZCTA5 36473,7,0,7,0,-0.492224761132147
ZCTA5 50012,7,0,7,0,-0.492224761132147
ZCTA5 59081,7,0,7,0,-0.492224761132147
ZCTA5 59333,7,0,7,0,-0.492224761132147
ZCTA5 59461,7,0,7,0,-0.492224761132147
ZCTA5 63467,7,0,7,0,-0.492224761132147
ZCTA5 62344,7,0,7,0,-0.492224761132147
ZCTA5 62279,7,0,7,0,-0.492224761132147
ZCTA5 66621,7,0,7,0,-0.492224761132147
ZCTA5 65062,7,0,7,0,-0.492224761132147
ZCTA5 72528,7,0,7,0,-0.492224761132147
ZCTA5 83602,7,0,7,0,-0.492224761132147
ZCTA5 82084,7,0,7,0,-0.492224761132147
ZCTA5 06389,7,0,7,0,-0.492224761132147
ZCTA5 08890,7,0,7,0,-0.492224761132147
ZCTA5 14168,7,0,7,0,-0.492224761132147
ZCTA5 13860,7,0,7,0,-0.492224761132147
ZCTA5 22731,7,0,7,0,-0.492224761132147
ZCTA5 90089,7,0,7,0,-0.492224761132147
ZCTA5 95430,7,0,7,0,-0.492224761132147
ZCTA5 24104,1384,43,1341,0.03106936416184971,-0.493399458926941
ZCTA5 74745,3872,124,3748,0.03202479338842975,-0.49465408758928753
ZCTA5 65326,855,26,829,0.0304093567251462,-0.4951287983748285
ZCTA5 79041,1105,34,1071,0.03076923076923077,-0.4963540638184171
ZCTA5 83342,413,12,401,0.029055690072639227,-0.4971055619913277
ZCTA5 02746,6219,201,6018,0.032320308731307285,-0.4972945944978914
ZCTA5 35446,730,22,708,0.030136986301369864,-0.4984303608527371
ZCTA5 46951,730,22,708,0.030136986301369864,-0.4984303608527371
ZCTA5 73726,219,6,213,0.0273972602739726,-0.4984734082209519
ZCTA5 58429,186,5,181,0.026881720430107527,-0.4984850353539564
ZCTA5 72140,186,5,181,0.026881720430107527,-0.4984850353539564
ZCTA5 33051,349,10,339,0.02865329512893983,-0.49877356259247363
ZCTA5 65717,1012,31,981,0.030632411067193676,-0.4992125845093029
ZCTA5 56373,1199,37,1162,0.030859049207673062,-0.49973940501930314
ZCTA5 32908,3996,128,3868,0.03203203203203203,-0.499967587277075
ZCTA5 15655,153,4,149,0.026143790849673203,-0.5028673963564407
ZCTA5 15350,153,4,149,0.026143790849673203,-0.5028673963564407
ZCTA5 93711,15945,522,15423,0.032737535277516466,-0.503293523317563
ZCTA5 15558,825,25,800,0.030303030303030304,-0.503348425631106
ZCTA5 49614,1044,32,1012,0.03065134099616858,-0.5036424115622996
ZCTA5 71227,1480,46,1434,0.031081081081081083,-0.5077179736575504
ZCTA5 62360,700,21,679,0.03,-0.5082365005350689
ZCTA5 53827,85,2,83,0.023529411764705882,-0.5088573110945108
ZCTA5 59444,85,2,83,0.023529411764705882,-0.5088573110945108
ZCTA5 59713,85,2,83,0.023529411764705882,-0.5088573110945108
ZCTA5 57386,85,2,83,0.023529411764705882,-0.5088573110945108
ZCTA5 88120,85,2,83,0.023529411764705882,-0.5088573110945108
ZCTA5 83824,85,2,83,0.023529411764705882,-0.5088573110945108
ZCTA5 81027,85,2,83,0.023529411764705882,-0.5088573110945108
ZCTA5 41722,542,16,526,0.02952029520295203,-0.50932158780135806
ZCTA5 52038,220,6,214,0.02727272727272727,-0.5098822721508399
ZCTA5 48832,574,17,557,0.029616724738675958,-0.5112934950159487
ZCTA5 46408,6347,205,6142,0.03229872380652277,-0.5119492925045818
ZCTA5 60921,606,18,588,0.0297029702970297,-0.5135453858702139
ZCTA5 47177,447,13,434,0.029082774049217,-0.5139784826191255
ZCTA5 54854,415,12,403,0.02891566265060241,-0.514171300350452
ZCTA5 51108,2007,63,1944,0.03139013452914798,-0.5142457202351695
ZCTA5 75938,1046,32,1014,0.030592734225621414,-0.5146654746864232
ZCTA5 52048,154,4,150,0.025974025974025976,-0.5162238611394796
ZCTA5 52202,351,10,341,0.02849002849002849,-0.5172110571236345
ZCTA5 19022,1327,41,1286,0.03089675960813866,-0.5180987081114542
ZCTA5 13753,1854,58,1796,0.03128371089536138,-0.5197392279142506
ZCTA5 73834,607,18,589,0.029654036243822075,-0.5206734638434722
ZCTA5 38133,7537,244,7293,0.03237362345760913,-0.5217203473008728
ZCTA5 27549,9965,324,9641,0.0325137982940291,-0.5220811316757613
ZCTA5 18351,188,5,183,0.026595744680851064,-0.5229636590686046
ZCTA5 39459,1328,41,1287,0.030873493975903613,-0.5230088351106035
ZCTA5 56569,512,15,497,0.029296875,-0.5231391954646275
ZCTA5 49688,985,30,955,0.030456852791878174,-0.5231490813133751
ZCTA5 38371,384,11,373,0.028645833333333332,-0.5239994060256618
ZCTA5 03243,384,11,373,0.028645833333333332,-0.5239994060256618
ZCTA5 38542,8,0,8,0,-0.5262104038408962
ZCTA5 36616,8,0,8,0,-0.5262104038408962
ZCTA5 36753,8,0,8,0,-0.5262104038408962
ZCTA5 36859,8,0,8,0,-0.5262104038408962
ZCTA5 50127,8,0,8,0,-0.5262104038408962
ZCTA5 49877,8,0,8,0,-0.5262104038408962
ZCTA5 54010,8,0,8,0,-0.5262104038408962
ZCTA5 64065,8,0,8,0,-0.5262104038408962
ZCTA5 69042,8,0,8,0,-0.5262104038408962
ZCTA5 56541,8,0,8,0,-0.5262104038408962
ZCTA5 72181,8,0,8,0,-0.5262104038408962
ZCTA5 77481,8,0,8,0,-0.5262104038408962
ZCTA5 79759,8,0,8,0,-0.5262104038408962
ZCTA5 78677,8,0,8,0,-0.5262104038408962
ZCTA5 13902,8,0,8,0,-0.5262104038408962
ZCTA5 13353,8,0,8,0,-0.5262104038408962
ZCTA5 19375,8,0,8,0,-0.5262104038408962
ZCTA5 18454,8,0,8,0,-0.5262104038408962
ZCTA5 89402,8,0,8,0,-0.5262104038408962
ZCTA5 95053,8,0,8,0,-0.5262104038408962
ZCTA5 97604,8,0,8,0,-0.5262104038408962
ZCTA5 98853,8,0,8,0,-0.5262104038408962
ZCTA5 99790,8,0,8,0,-0.5262104038408962
ZCTA5 42757,1142,35,1107,0.03064798598949212,-0.5273811773930102
ZCTA5 45873,829,25,804,0.030156815440289506,-0.5279788339170834
ZCTA5 00769,13270,433,12837,0.03262999246420498,-0.5280331558913834
ZCTA5 99744,50,1,49,0.02,-0.5290632820795649
ZCTA5 31816,2165,68,2097,0.03140877598152425,-0.52928054092017085
ZCTA5 51650,155,4,151,0.025806451612903226,-0.5294992996186583
ZCTA5 31567,320,9,311,0.028125,-0.5301566062034399
ZCTA5 72030,320,9,311,0.028125,-0.5301566062034399
ZCTA5 96039,449,13,436,0.028953229398663696,-0.5303923554174402
ZCTA5 76431,1174,36,1138,0.030664395229982964,-0.5315923111809117
ZCTA5 62920,1392,43,1349,0.03089080459770115,-0.5318715091913891
ZCTA5 73434,222,6,216,0.02702702702702703,-0.5325531494398469
ZCTA5 83604,222,6,216,0.02702702702702703,-0.5325531494398469
ZCTA5 63848,577,17,560,0.029462738301559793,-0.533197850230224
ZCTA5 26448,577,17,560,0.029462738301559793,-0.533197850230224
ZCTA5 61929,288,8,280,0.027777777777777776,-0.5357199979697918
ZCTA5 72512,1050,32,1018,0.030476190476190476,-0.5366499289097129
ZCTA5 37809,862,26,836,0.030162412993039442,-0.5374709772860536
ZCTA5 23944,1331,41,1290,0.030803906836964687,-0.5377175091513113
ZCTA5 45767,1019,31,988,0.03042198233562316,-0.5382916971104451
ZCTA5 49632,450,13,437,0.028888888888888888,-0.5385728762084605
ZCTA5 04734,321,9,312,0.028037383177570093,-0.5397141069933821
ZCTA5 60171,3765,120,3645,0.03187250996015936,-0.5397349830159034
ZCTA5 85539,1766,55,1711,0.03114382785956965,-0.539945234715436
ZCTA5 84632,386,11,375,0.02849740932642487,-0.5415788584509021
ZCTA5 95758,21018,689,20329,0.032781425444856786,-0.5424506767327882
ZCTA5 00754,13673,446,13227,0.032619030205514515,-0.5431196243968563
ZCTA5 83241,863,26,837,0.030127462340672075,-0.5434924836204503
ZCTA5 45851,256,7,249,0.02734375,-0.5437006250493103
ZCTA5 65685,256,7,249,0.02734375,-0.5437006250493103
ZCTA5 70452,4684,150,4534,0.03202391118701964,-0.5443902233233722
ZCTA5 80546,122,3,119,0.02459016393442623,-0.5444738107957542
ZCTA5 64661,354,10,344,0.02824858757062147,-0.5446791189024001
ZCTA5 84032,6605,213,6392,0.032248296744890236,-0.5450417856491845
ZCTA5 52247,1922,60,1862,0.031217481789802288,-0.5453316383467076
ZCTA5 15043,769,23,746,0.02990897269180754,-0.5467344610955102
ZCTA5 81001,12042,392,11650,0.03255273210430161,-0.5501568166297491
ZCTA5 59825,927,28,899,0.030204962243797196,-0.5501626480984542
ZCTA5 76872,387,11,376,0.028423772609819122,-0.5503358127558556
ZCTA5 39063,1209,37,1172,0.030603804797353185,-0.5511742189744832
ZCTA5 98119,12558,409,12149,0.03256888039496735,-0.5517567779892438
ZCTA5 76228,355,10,345,0.028169014084507043,-0.5537855864794795
ZCTA5 01255,355,10,345,0.028169014084507043,-0.5537855864794795
ZCTA5 38685,516,15,501,0.029069767441860465,-0.5538680080493995
ZCTA5 15692,548,16,532,0.029197080291970802,-0.554209956379301
ZCTA5 54493,257,7,250,0.027237354085603113,-0.5542468837146005
ZCTA5 37144,1116,34,1082,0.03046594982078853,-0.5551615391884527
ZCTA5 03752,290,8,282,0.027586206896551724,-0.5557191893292502
ZCTA5 63656,157,4,153,0.025477707006369428,-0.5558116539254155
ZCTA5 68448,157,4,153,0.025477707006369428,-0.5558116539254155
ZCTA5 04224,928,28,900,0.03017241379310345,-0.5559733205401135
ZCTA5 47024,1210,37,1173,0.030578512396694214,-0.5562947877443128
ZCTA5 67146,739,22,717,0.029769959404600813,-0.5569794442703633
ZCTA5 33428,13682,446,13236,0.03259757345417336,-0.5572556601436404
ZCTA5 84624,1956,61,1895,0.031186094069529654,-0.5578537493040108
ZCTA5 30581,9,0,9,0,-0.5581304173302142
ZCTA5 36476,9,0,9,0,-0.5581304173302142
ZCTA5 36913,9,0,9,0,-0.5581304173302142
ZCTA5 38749,9,0,9,0,-0.5581304173302142
ZCTA5 38945,9,0,9,0,-0.5581304173302142
ZCTA5 43463,9,0,9,0,-0.5581304173302142
ZCTA5 43928,9,0,9,0,-0.5581304173302142
ZCTA5 42124,9,0,9,0,-0.5581304173302142
ZCTA5 43032,9,0,9,0,-0.5581304173302142
ZCTA5 45145,9,0,9,0,-0.5581304173302142
ZCTA5 47458,9,0,9,0,-0.5581304173302142
ZCTA5 50227,9,0,9,0,-0.5581304173302142
ZCTA5 49819,9,0,9,0,-0.5581304173302142
ZCTA5 52588,9,0,9,0,-0.5581304173302142
ZCTA5 55450,9,0,9,0,-0.5581304173302142
ZCTA5 57650,9,0,9,0,-0.5581304173302142
ZCTA5 58362,9,0,9,0,-0.5581304173302142
ZCTA5 61328,9,0,9,0,-0.5581304173302142
ZCTA5 61331,9,0,9,0,-0.5581304173302142
ZCTA5 63370,9,0,9,0,-0.5581304173302142
ZCTA5 68382,9,0,9,0,-0.5581304173302142
ZCTA5 69365,9,0,9,0,-0.5581304173302142
ZCTA5 69353,9,0,9,0,-0.5581304173302142
ZCTA5 72377,9,0,9,0,-0.5581304173302142
ZCTA5 75832,9,0,9,0,-0.5581304173302142
ZCTA5 76573,9,0,9,0,-0.5581304173302142
ZCTA5 82844,9,0,9,0,-0.5581304173302142
ZCTA5 81021,9,0,9,0,-0.5581304173302142
ZCTA5 87518,9,0,9,0,-0.5581304173302142
ZCTA5 01066,9,0,9,0,-0.5581304173302142
ZCTA5 08011,9,0,9,0,-0.5581304173302142
ZCTA5 05901,9,0,9,0,-0.5581304173302142
ZCTA5 12438,9,0,9,0,-0.5581304173302142
ZCTA5 15072,9,0,9,0,-0.5581304173302142
ZCTA5 22845,9,0,9,0,-0.5581304173302142
ZCTA5 23884,9,0,9,0,-0.5581304173302142
ZCTA5 24130,9,0,9,0,-0.5581304173302142
ZCTA5 86038,9,0,9,0,-0.5581304173302142
ZCTA5 97057,9,0,9,0,-0.5581304173302142
ZCTA5 99647,9,0,9,0,-0.5581304173302142
ZCTA5 99136,9,0,9,0,-0.5581304173302142
ZCTA5 02169,25076,823,24253,0.03282022651140533,-0.5583379927991825
ZCTA5 57264,123,3,120,0.024390243902439025,-0.559030960630548
ZCTA5 67842,191,5,186,0.02617801047120419,-0.5592252592198642
ZCTA5 72085,88,2,86,0.022727272727272728,-0.5596052981433561
ZCTA5 53506,485,14,471,0.0288659793814433,-0.5619309853052735
ZCTA5 46323,8104,262,7842,0.032329713721618955,-0.5629710774321678
ZCTA5 44099,740,22,718,0.02972972972972973,-0.56344207364528
ZCTA5 30411,898,27,871,0.030066815144766147,-0.5645107080746827
ZCTA5 30420,421,12,409,0.028503562945368172,-0.5648974478670513
ZCTA5 58623,961,29,932,0.030176899063475548,-0.564999031013027
ZCTA5 54542,225,6,219,0.02666666666666667,-0.5661995755240625
ZCTA5 33605,7041,227,6814,0.03223973867348388,-0.5667371173716017
ZCTA5 76266,5365,172,5193,0.0320596458527493,-0.5680659532017237
ZCTA5 67491,158,4,154,0.02531645569620253,-0.5688507883459323
ZCTA5 68664,158,4,154,0.02531645569620253,-0.5688507883459323
ZCTA5 56127,158,4,154,0.02531645569620253,-0.5688507883459323
ZCTA5 53930,518,15,503,0.02895752895752896,-0.5691462924803606
ZCTA5 42234,1056,32,1024,0.030303030303030304,-0.5694737361013242
ZCTA5 04963,2977,94,2883,0.031575411488075245,-0.5700879591091095
ZCTA5 72633,614,18,596,0.029315960912052116,-0.57025367218886
ZCTA5 74946,52,1,51,0.019230769230769232,-0.5703884059602253
ZCTA5 98660,5427,174,5253,0.032061912658927584,-0.5704102570808225
ZCTA5 58530,454,13,441,0.028634361233480177,-0.5711208705860654
ZCTA5 15715,192,5,187,0.026041666666666668,-0.5711935733538928
ZCTA5 62442,1213,37,1176,0.030502885408079144,-0.5716317134466129
ZCTA5 22488,422,12,410,0.02843601895734597,-0.5732841956524157
ZCTA5 58845,124,3,121,0.024193548387096774,-0.5734794374706355
ZCTA5 37887,1898,59,1839,0.03108535300316122,-0.5739278635581913
ZCTA5 39530,3347,106,3241,0.031670152375261426,-0.5739967859132886
ZCTA5 43943,1276,39,1237,0.030564263322884012,-0.5740956123033686
ZCTA5 97347,805,24,781,0.02981366459627329,-0.5744235460032562
ZCTA5 47373,1057,32,1025,0.030274361400189215,-0.5749266735502225
ZCTA5 50519,259,7,252,0.02702702702702703,-0.5752231449400165
ZCTA5 72926,259,7,252,0.02702702702702703,-0.5752231449400165
ZCTA5 79789,259,7,252,0.02702702702702703,-0.5752231449400165
ZCTA5 99134,259,7,252,0.02702702702702703,-0.5752231449400165
ZCTA5 66738,89,2,87,0.02247191011235955,-0.5761731357886466
ZCTA5 83839,615,18,597,0.02926829268292683,-0.5772918595765969
ZCTA5 82839,487,14,473,0.028747433264887063,-0.5776368047236379
ZCTA5 70772,325,9,316,0.027692307692307693,-0.5776618468646632
ZCTA5 14897,325,9,316,0.027692307692307693,-0.5776618468646632
ZCTA5 15961,325,9,316,0.027692307692307693,-0.5776618468646632
ZCTA5 15341,325,9,316,0.027692307692307693,-0.5776618468646632
ZCTA5 96781,455,13,442,0.02857142857142857,-0.5792147725312405
ZCTA5 52157,869,26,843,0.02991944764096663,-0.5794795203501113
ZCTA5 74871,869,26,843,0.02991944764096663,-0.5794795203501113
ZCTA5 43107,1152,35,1117,0.030381944444444444,-0.579900791237911
ZCTA5 49345,5095,163,4932,0.031992149165848874,-0.5803799138038518
ZCTA5 59430,159,4,155,0.025157232704402517,-0.5818133349526746
ZCTA5 72473,1027,31,996,0.03018500486854917,-0.5826339248658079
ZCTA5 25559,648,19,629,0.029320987654320986,-0.5851181281983889
ZCTA5 65661,1153,35,1118,0.030355594102341718,-0.5851282427896748
ZCTA5 82720,391,11,380,0.028132992327365727,-0.5851480504637755
ZCTA5 97326,391,11,380,0.028132992327365727,-0.5851480504637755
ZCTA5 45107,3627,115,3512,0.03170664460987042,-0.5853021769351836
ZCTA5 75104,15820,516,15304,0.03261694058154235,-0.5856687164828519
ZCTA5 76578,456,13,443,0.02850877192982456,-0.587291603870134
ZCTA5 44878,965,29,936,0.03005181347150259,-0.5877826377156707
ZCTA5 14783,125,3,122,0.024,-0.5878211474877799
ZCTA5 26325,125,3,122,0.024,-0.5878211474877799
ZCTA5 74966,1435,44,1391,0.030662020905923345,-0.5882203495651197
ZCTA5 29079,10,0,10,0,-0.5883211167279302
ZCTA5 38365,10,0,10,0,-0.5883211167279302
ZCTA5 43523,10,0,10,0,-0.5883211167279302
ZCTA5 87730,10,0,10,0,-0.5883211167279302
ZCTA5 57364,10,0,10,0,-0.5883211167279302
ZCTA5 58713,10,0,10,0,-0.5883211167279302
ZCTA5 59276,10,0,10,0,-0.5883211167279302
ZCTA5 59312,10,0,10,0,-0.5883211167279302
ZCTA5 63745,10,0,10,0,-0.5883211167279302
ZCTA5 65784,10,0,10,0,-0.5883211167279302
ZCTA5 68881,10,0,10,0,-0.5883211167279302
ZCTA5 68946,10,0,10,0,-0.5883211167279302
ZCTA5 79942,10,0,10,0,-0.5883211167279302
ZCTA5 82648,10,0,10,0,-0.5883211167279302
ZCTA5 79251,10,0,10,0,-0.5883211167279302
ZCTA5 79353,10,0,10,0,-0.5883211167279302
ZCTA5 07846,10,0,10,0,-0.5883211167279302
ZCTA5 12811,10,0,10,0,-0.5883211167279302
ZCTA5 13623,10,0,10,0,-0.5883211167279302
ZCTA5 13643,10,0,10,0,-0.5883211167279302
ZCTA5 17056,10,0,10,0,-0.5883211167279302
ZCTA5 21867,10,0,10,0,-0.5883211167279302
ZCTA5 25936,10,0,10,0,-0.5883211167279302
ZCTA5 92384,10,0,10,0,-0.5883211167279302
ZCTA5 94573,10,0,10,0,-0.5883211167279302
ZCTA5 95680,10,0,10,0,-0.5883211167279302
ZCTA5 99144,10,0,10,0,-0.5883211167279302
ZCTA5 98641,10,0,10,0,-0.5883211167279302
ZCTA5 30421,1404,43,1361,0.030626780626780627,-0.5891752719549469
ZCTA5 28781,424,12,412,0.02830188679245283,-0.5900006515302371
ZCTA5 50170,1154,35,1119,0.030329289428076257,-0.590351272510777
ZCTA5 98286,90,2,88,0.022222222222222223,-0.5925739365100587
ZCTA5 61561,966,29,937,0.030020703933747412,-0.5934641742266693
ZCTA5 79086,713,21,692,0.029453015427769985,-0.5941578705798507
ZCTA5 56760,160,4,156,0.025,-0.594700346401123
ZCTA5 76234,5895,189,5706,0.03206106870229008,-0.5948568754195527
ZCTA5 55017,294,8,286,0.027210884353741496,-0.5953269425599123
ZCTA5 28612,4795,153,4642,0.031908237747653806,-0.5953470448617489
ZCTA5 66781,457,13,444,0.028446389496717725,-0.5953514475632088
ZCTA5 58030,261,7,254,0.02681992337164751,-0.5960465902082512
ZCTA5 12187,261,7,254,0.02681992337164751,-0.5960465902082512
ZCTA5 05839,327,9,318,0.027522935779816515,-0.5964690425048711
ZCTA5 56686,360,10,350,0.027777777777777776,-0.5989531661832519
ZCTA5 12147,228,6,222,0.02631578947368421,-0.5994253336143898
ZCTA5 19009,228,6,222,0.02631578947368421,-0.5994253336143898
ZCTA5 67031,904,27,877,0.029867256637168143,-0.59976049609808
ZCTA5 05456,490,14,476,0.02857142857142857,-0.6010795760743162
ZCTA5 75125,2091,65,2026,0.031085604973696796,-0.6023376710600232
ZCTA5 98640,2091,65,2026,0.031085604973696796,-0.6023376710600232
ZCTA5 82433,393,11,382,0.027989821882951654,-0.6024265285020256
ZCTA5 97502,10830,351,10479,0.032409972299168976,-0.6043563785535534
ZCTA5 74547,1376,42,1334,0.030523255813953487,-0.6046265657974478
ZCTA5 83811,619,18,601,0.029079159935379646,-0.605334470255178
ZCTA5 39342,555,16,539,0.02882882882882883,-0.6059835874461869
ZCTA5 51527,195,5,190,0.02564102564102564,-0.6067512955104938
ZCTA5 91759,195,5,190,0.02564102564102564,-0.6067512955104938
ZCTA5 48621,523,15,508,0.028680688336520075,-0.6070947395307937
ZCTA5 62539,523,15,508,0.028680688336520075,-0.6070947395307937
ZCTA5 61845,161,4,157,0.024844720496894408,-0.6075128537887305
ZCTA5 97480,161,4,157,0.024844720496894408,-0.6075128537887305
ZCTA5 28369,1063,32,1031,0.030103480714957668,-0.607539082921421
ZCTA5 47263,91,2,89,0.02197802197802198,-0.6088116966037518
ZCTA5 66746,91,2,89,0.02197802197802198,-0.6088116966037518
ZCTA5 83827,91,2,89,0.02197802197802198,-0.6088116966037518
ZCTA5 97488,491,14,477,0.028513238289205704,-0.608863191146713
ZCTA5 66963,54,1,53,0.018518518518518517,-0.6103606199809473
ZCTA5 51572,229,6,223,0.026200873362445413,-0.6104092114476579
ZCTA5 07603,2866,90,2776,0.0314026517794836,-0.6107921076742797
ZCTA5 61774,394,11,383,0.027918781725888325,-0.6110342768621586
ZCTA5 79744,459,13,446,0.02832244008714597,-0.6114205008594618
ZCTA5 84078,8950,289,8661,0.03229050279329609,-0.6122560346884526
ZCTA5 03838,588,17,571,0.02891156462585034,-0.6125822476252795
ZCTA5 14860,556,16,540,0.02877697841726619,-0.6133283936134404
ZCTA5 78212,10805,350,10455,0.03239241092086997,-0.6138100180683909
ZCTA5 30147,1659,51,1608,0.03074141048824593,-0.6144836596930254
ZCTA5 93460,1939,60,1879,0.030943785456420837,-0.6147606082586264
ZCTA5 47970,748,22,726,0.029411764705882353,-0.6148402991825299
ZCTA5 54547,748,22,726,0.029411764705882353,-0.6148402991825299
ZCTA5 04763,296,8,288,0.02702702702702703,-0.6149394083737572
ZCTA5 72736,2466,77,2389,0.031224655312246552,-0.6157231435975397
ZCTA5 56101,2497,78,2419,0.031237484981978373,-0.6160159409423147
ZCTA5 54657,127,3,124,0.023622047244094488,-0.6161916443726354
ZCTA5 57329,127,3,124,0.023622047244094488,-0.6161916443726354
ZCTA5 74750,127,3,124,0.023622047244094488,-0.6161916443726354
ZCTA5 78618,127,3,124,0.023622047244094488,-0.6161916443726354
ZCTA5 16876,127,3,124,0.023622047244094488,-0.6161916443726354
ZCTA5 33620,11,0,11,0,-0.6170363927895977
ZCTA5 36910,11,0,11,0,-0.6170363927895977
ZCTA5 37213,11,0,11,0,-0.6170363927895977
ZCTA5 39760,11,0,11,0,-0.6170363927895977
ZCTA5 42338,11,0,11,0,-0.6170363927895977
ZCTA5 42322,11,0,11,0,-0.6170363927895977
ZCTA5 46502,11,0,11,0,-0.6170363927895977
ZCTA5 46922,11,0,11,0,-0.6170363927895977
ZCTA5 44285,11,0,11,0,-0.6170363927895977
ZCTA5 59244,11,0,11,0,-0.6170363927895977
ZCTA5 59756,11,0,11,0,-0.6170363927895977
ZCTA5 63433,11,0,11,0,-0.6170363927895977
ZCTA5 68010,11,0,11,0,-0.6170363927895977
ZCTA5 69220,11,0,11,0,-0.6170363927895977
ZCTA5 76824,11,0,11,0,-0.6170363927895977
ZCTA5 79324,11,0,11,0,-0.6170363927895977
ZCTA5 88114,11,0,11,0,-0.6170363927895977
ZCTA5 88264,11,0,11,0,-0.6170363927895977
ZCTA5 88255,11,0,11,0,-0.6170363927895977
ZCTA5 83354,11,0,11,0,-0.6170363927895977
ZCTA5 83601,11,0,11,0,-0.6170363927895977
ZCTA5 07926,11,0,11,0,-0.6170363927895977
ZCTA5 11931,11,0,11,0,-0.6170363927895977
ZCTA5 19955,11,0,11,0,-0.6170363927895977
ZCTA5 22711,11,0,11,0,-0.6170363927895977
ZCTA5 21627,11,0,11,0,-0.6170363927895977
ZCTA5 24412,11,0,11,0,-0.6170363927895977
ZCTA5 96061,11,0,11,0,-0.6170363927895977
ZCTA5 99726,11,0,11,0,-0.6170363927895977
ZCTA5 99154,11,0,11,0,-0.6170363927895977
ZCTA5 96123,11,0,11,0,-0.6170363927895977
ZCTA5 43064,4926,157,4769,0.0318717011774259,-0.6176853345153691
ZCTA5 31765,1128,34,1094,0.030141843971631204,-0.6186730219064708
ZCTA5 57793,939,28,911,0.029818956336528223,-0.6194915193265594
ZCTA5 90814,8954,289,8665,0.03227607773062319,-0.6199836687681913
ZCTA5 29373,162,4,158,0.024691358024691357,-0.6202518672336427
ZCTA5 45341,1598,49,1549,0.030663329161451813,-0.6204388042954915
ZCTA5 62414,749,22,727,0.029372496662216287,-0.6212276018418327
ZCTA5 69162,3424,108,3316,0.03154205607476635,-0.6222455681984087
ZCTA5 55753,428,12,416,0.028037383177570093,-0.6232081699161351
ZCTA5 45613,1066,32,1034,0.0300187617260788,-0.6237781214961294
ZCTA5 16925,1255,38,1217,0.030278884462151396,-0.6255739398031279
ZCTA5 79852,363,10,353,0.027548209366391185,-0.6257672678947878
ZCTA5 31513,5847,187,5660,0.03198221310073542,-0.6259623312895688
ZCTA5 67353,264,7,257,0.026515151515151516,-0.6270008383098423
ZCTA5 04448,558,16,542,0.02867383512544803,-0.6279799485299683
ZCTA5 19540,4409,140,4269,0.03175323202540259,-0.6281190047662089
ZCTA5 36033,1381,42,1339,0.03041274438812455,-0.6285625703322625
ZCTA5 47868,1287,39,1248,0.030303030303030304,-0.6286819821126484
ZCTA5 70532,909,27,882,0.0297029702970297,-0.6289620775713592
ZCTA5 72523,526,15,511,0.028517110266159697,-0.6296966478311216
ZCTA5 76654,55,1,54,0.01818181818181818,-0.6298725303398804
ZCTA5 80652,197,5,192,0.025380710659898477,-0.6301735797766471
ZCTA5 89046,197,5,192,0.025380710659898477,-0.6301735797766471
ZCTA5 13664,128,3,125,0.0234375,-0.630224001258568
ZCTA5 97880,128,3,125,0.0234375,-0.630224001258568
ZCTA5 35619,1694,52,1642,0.030696576151121605,-0.631193690320882
ZCTA5 43222,1413,43,1370,0.03043170559094126,-0.631839576796186
ZCTA5 14770,1162,35,1127,0.030120481927710843,-0.6319773446478416
ZCTA5 44287,2749,86,2663,0.03128410331029465,-0.6327606712577268
ZCTA5 73841,163,4,159,0.024539877300613498,-0.632918376434314
ZCTA5 64125,591,17,574,0.028764805414551606,-0.6339839098549591
ZCTA5 14839,298,8,290,0.026845637583892617,-0.634426797290618
ZCTA5 71958,1005,30,975,0.029850746268656716,-0.6352886203622023
ZCTA5 33069,10453,338,10115,0.032335214770879174,-0.6362490249592019
ZCTA5 60107,13217,429,12788,0.03245819777559204,-0.6368122647244262
ZCTA5 85147,1163,35,1128,0.03009458297506449,-0.6371609594932398
ZCTA5 49288,527,15,512,0.028462998102466792,-0.6372031099470477
ZCTA5 76859,911,27,884,0.029637760702524697,-0.640599080262697
ZCTA5 17884,93,2,91,0.021505376344086023,-0.640813373976361
ZCTA5 96769,93,2,91,0.021505376344086023,-0.640813373976361
ZCTA5 77430,784,23,761,0.029336734693877552,-0.6411451073509402
ZCTA5 49814,560,16,544,0.02857142857142857,-0.6425810959592613
ZCTA5 45348,365,10,355,0.0273972602739726,-0.643526402855666
ZCTA5 97478,14526,472,14054,0.03249346000275368,-0.6439680889620758
ZCTA5 72128,299,8,291,0.026755852842809364,-0.6441241661861378
ZCTA5 57465,129,3,126,0.023255813953488372,-0.6441567345559654
ZCTA5 36267,12,0,12,0,-0.6444734933770345
ZCTA5 58001,12,0,12,0,-0.6444734933770345
ZCTA5 59240,12,0,12,0,-0.6444734933770345
ZCTA5 62336,12,0,12,0,-0.6444734933770345
ZCTA5 65246,12,0,12,0,-0.6444734933770345
ZCTA5 67012,12,0,12,0,-0.6444734933770345
ZCTA5 67143,12,0,12,0,-0.6444734933770345
ZCTA5 56720,12,0,12,0,-0.6444734933770345
ZCTA5 72059,12,0,12,0,-0.6444734933770345
ZCTA5 74117,12,0,12,0,-0.6444734933770345
ZCTA5 80913,12,0,12,0,-0.6444734933770345
ZCTA5 79085,12,0,12,0,-0.6444734933770345
ZCTA5 77412,12,0,12,0,-0.6444734933770345
ZCTA5 76836,12,0,12,0,-0.6444734933770345
ZCTA5 88344,12,0,12,0,-0.6444734933770345
ZCTA5 88431,12,0,12,0,-0.6444734933770345
ZCTA5 83243,12,0,12,0,-0.6444734933770345
ZCTA5 02584,12,0,12,0,-0.6444734933770345
ZCTA5 85633,12,0,12,0,-0.6444734933770345
ZCTA5 17742,12,0,12,0,-0.6444734933770345
ZCTA5 21862,12,0,12,0,-0.6444734933770345
ZCTA5 25126,12,0,12,0,-0.6444734933770345
ZCTA5 25855,12,0,12,0,-0.6444734933770345
ZCTA5 27841,12,0,12,0,-0.6444734933770345
ZCTA5 94972,12,0,12,0,-0.6444734933770345
ZCTA5 92304,12,0,12,0,-0.6444734933770345
ZCTA5 98544,12,0,12,0,-0.6444734933770345
ZCTA5 38736,164,4,160,0.024390243902439025,-0.645513351210764
ZCTA5 12851,164,4,160,0.024390243902439025,-0.645513351210764
ZCTA5 17938,912,27,885,0.029605263157894735,-0.6464082932770963
ZCTA5 64763,657,19,638,0.0289193302891933,-0.6464208744393617
ZCTA5 21871,753,22,731,0.029216467463479414,-0.6466946019785251
ZCTA5 88312,1228,37,1191,0.03013029315960912,-0.647765214026048
ZCTA5 24151,8207,264,7943,0.03216766175216279,-0.6481786547216299
ZCTA5 12197,817,24,793,0.02937576499388005,-0.648295454410518
ZCTA5 23324,8695,280,8415,0.03220241518113859,-0.6491495230972127
ZCTA5 48475,1071,32,1039,0.029878618113912233,-0.6507446486481038
ZCTA5 22511,529,15,514,0.02835538752362949,-0.6521751197955779
ZCTA5 67457,333,9,324,0.02702702702702703,-0.6522417385198909
ZCTA5 72529,2291,71,2220,0.030990833697075514,-0.6557123882461048
ZCTA5 96120,267,7,260,0.026217228464419477,-0.6576254379467912
ZCTA5 68981,165,4,161,0.024242424242424242,-0.6580377420281862
ZCTA5 39466,10009,323,9686,0.03227095613947447,-0.6583409427126103
ZCTA5 12937,723,21,702,0.029045643153526972,-0.6592248996795627
ZCTA5 04911,946,28,918,0.02959830866807611,-0.6595368412368998
ZCTA5 71964,1325,40,1285,0.03018867924528302,-0.6610435897469257
ZCTA5 54530,367,10,357,0.027247956403269755,-0.6611933098748987
ZCTA5 08001,367,10,357,0.027247956403269755,-0.6611933098748987
ZCTA5 54232,334,9,325,0.02694610778443114,-0.6614444426822372
ZCTA5 56644,334,9,325,0.02694610778443114,-0.6614444426822372
ZCTA5 51542,400,11,389,0.0275,-0.6622472460684582
ZCTA5 97810,400,11,389,0.0275,-0.6622472460684582
ZCTA5 78941,1010,30,980,0.0297029702970297,-0.6629842423323334
ZCTA5 56735,301,8,293,0.026578073089700997,-0.66342738715983
ZCTA5 84782,301,8,293,0.026578073089700997,-0.66342738715983
ZCTA5 73455,234,6,228,0.02564102564102564,-0.6646627426931608
ZCTA5 55749,200,5,195,0.025,-0.6648952003977918
ZCTA5 76701,724,21,703,0.029005524861878452,-0.6656837277518938
ZCTA5 48464,788,23,765,0.02918781725888325,-0.6660258623433051
ZCTA5 12983,3346,105,3241,0.03138075313807531,-0.6670054187874004
ZCTA5 11932,466,13,453,0.027896995708154508,-0.6671389926681963
ZCTA5 63820,57,1,56,0.017543859649122806,-0.6680075827749838
ZCTA5 49755,884,26,858,0.029411764705882353,-0.6684018739082878
ZCTA5 41636,368,10,358,0.02717391304347826,-0.6699925246810872
ZCTA5 69044,368,10,358,0.02717391304347826,-0.6699925246810872
ZCTA5 19374,368,10,358,0.02717391304347826,-0.6699925246810872
ZCTA5 53811,1264,38,1226,0.030063291139240507,-0.670438772270823
ZCTA5 61449,166,4,162,0.024096385542168676,-0.670492480503592
ZCTA5 79250,499,14,485,0.028056112224448898,-0.6705904012246191
ZCTA5 74442,401,11,390,0.02743142144638404,-0.6707115535880747
ZCTA5 28749,13,0,13,0,-0.6707892793600674
ZCTA5 29338,13,0,13,0,-0.6707892793600674
ZCTA5 38767,13,0,13,0,-0.6707892793600674
ZCTA5 36865,13,0,13,0,-0.6707892793600674
ZCTA5 40334,13,0,13,0,-0.6707892793600674
ZCTA5 42603,13,0,13,0,-0.6707892793600674
ZCTA5 44687,13,0,13,0,-0.6707892793600674
ZCTA5 58065,13,0,13,0,-0.6707892793600674
ZCTA5 59842,13,0,13,0,-0.6707892793600674
ZCTA5 63464,13,0,13,0,-0.6707892793600674
ZCTA5 64066,13,0,13,0,-0.6707892793600674
ZCTA5 64092,13,0,13,0,-0.6707892793600674
ZCTA5 72353,13,0,13,0,-0.6707892793600674
ZCTA5 77467,13,0,13,0,-0.6707892793600674
ZCTA5 77436,13,0,13,0,-0.6707892793600674
ZCTA5 81335,13,0,13,0,-0.6707892793600674
ZCTA5 83666,13,0,13,0,-0.6707892793600674
ZCTA5 04454,13,0,13,0,-0.6707892793600674
ZCTA5 04442,13,0,13,0,-0.6707892793600674
ZCTA5 14854,13,0,13,0,-0.6707892793600674
ZCTA5 15723,13,0,13,0,-0.6707892793600674
ZCTA5 16361,13,0,13,0,-0.6707892793600674
ZCTA5 22509,13,0,13,0,-0.6707892793600674
ZCTA5 26366,13,0,13,0,-0.6707892793600674
ZCTA5 24719,13,0,13,0,-0.6707892793600674
ZCTA5 25853,13,0,13,0,-0.6707892793600674
ZCTA5 97406,13,0,13,0,-0.6707892793600674
ZCTA5 99547,13,0,13,0,-0.6707892793600674
ZCTA5 99833,1170,35,1135,0.029914529914529916,-0.6733252775018586
ZCTA5 19310,1012,30,982,0.029644268774703556,-0.6740252484652303
ZCTA5 65619,2854,89,2765,0.031184302733006306,-0.67438169849935
ZCTA5 38871,629,18,611,0.028616852146263912,-0.6746837021710568
ZCTA5 79567,1202,36,1166,0.029950083194675542,-0.675616227086844
ZCTA5 36523,1044,31,1013,0.029693486590038315,-0.67575510377585
ZCTA5 65321,201,5,196,0.024875621890547265,-0.6763616646946593
ZCTA5 16829,269,7,262,0.026022304832713755,-0.6778627141121925
ZCTA5 70342,1705,52,1653,0.030498533724340176,-0.6787158426920517
ZCTA5 73663,402,11,391,0.02736318407960199,-0.6791558208332739
ZCTA5 53961,336,9,327,0.026785714285714284,-0.679771926863195
ZCTA5 35989,1329,40,1289,0.030097817908201655,-0.6804612814242905
ZCTA5 77466,167,4,163,0.023952095808383235,-0.682878479896139
ZCTA5 17856,1235,37,1198,0.029959514170040485,-0.6829845792856507
ZCTA5 56626,132,3,129,0.022727272727272728,-0.6853737189046366
ZCTA5 14760,8073,259,7814,0.03208224947355382,-0.6855429929533929
ZCTA5 62987,501,14,487,0.027944111776447105,-0.6858741776555458
ZCTA5 85736,1863,57,1806,0.030595813204508857,-0.6861168260280269
ZCTA5 71956,663,19,644,0.02865761689291101,-0.6868412239325224
ZCTA5 85643,3198,100,3098,0.031269543464665414,-0.6870610928863874
ZCTA5 42440,370,10,360,0.02702702702702703,-0.6875231595836123
ZCTA5 52630,202,5,197,0.024752475247524754,-0.6877753980727819
ZCTA5 35474,2238,69,2169,0.030831099195710455,-0.6901068524502177
ZCTA5 49126,469,13,456,0.02771855010660981,-0.6907739309004551
ZCTA5 82082,760,22,738,0.02894736842105263,-0.6909490559554814
ZCTA5 58256,304,8,296,0.02631578947368421,-0.6921567554426984
ZCTA5 96749,5783,184,5599,0.03181739581532077,-0.6922286411049455
ZCTA5 36467,4002,126,3876,0.031484257871064465,-0.6930523450753231
ZCTA5 28587,168,4,164,0.023809523809523808,-0.695196635581764
ZCTA5 38327,168,4,164,0.023809523809523808,-0.695196635581764
ZCTA5 49724,404,11,393,0.027227722772277228,-0.6959846737676608
ZCTA5 28725,14,0,14,0,-0.6961109329289394
ZCTA5 38702,14,0,14,0,-0.6961109329289394
ZCTA5 41366,14,0,14,0,-0.6961109329289394
ZCTA5 45721,14,0,14,0,-0.6961109329289394
ZCTA5 58325,14,0,14,0,-0.6961109329289394
ZCTA5 57630,14,0,14,0,-0.6961109329289394
ZCTA5 61435,14,0,14,0,-0.6961109329289394
ZCTA5 58219,14,0,14,0,-0.6961109329289394
ZCTA5 66863,14,0,14,0,-0.6961109329289394
ZCTA5 68954,14,0,14,0,-0.6961109329289394
ZCTA5 76937,14,0,14,0,-0.6961109329289394
ZCTA5 83446,14,0,14,0,-0.6961109329289394
ZCTA5 79234,14,0,14,0,-0.6961109329289394
ZCTA5 88349,14,0,14,0,-0.6961109329289394
ZCTA5 82845,14,0,14,0,-0.6961109329289394
ZCTA5 03575,14,0,14,0,-0.6961109329289394
ZCTA5 07870,14,0,14,0,-0.6961109329289394
ZCTA5 12490,14,0,14,0,-0.6961109329289394
ZCTA5 16140,14,0,14,0,-0.6961109329289394
ZCTA5 12784,14,0,14,0,-0.6961109329289394
ZCTA5 15625,14,0,14,0,-0.6961109329289394
ZCTA5 17076,14,0,14,0,-0.6961109329289394
ZCTA5 21781,14,0,14,0,-0.6961109329289394
ZCTA5 25870,14,0,14,0,-0.6961109329289394
ZCTA5 24601,14,0,14,0,-0.6961109329289394
ZCTA5 26282,14,0,14,0,-0.6961109329289394
ZCTA5 95923,14,0,14,0,-0.6961109329289394
ZCTA5 95435,14,0,14,0,-0.6961109329289394
ZCTA5 95970,237,6,231,0.02531645569620253,-0.6966970856137429
ZCTA5 47393,535,15,520,0.028037383177570093,-0.6967679160328589
ZCTA5 52035,437,12,425,0.02745995423340961,-0.6968543037686846
ZCTA5 61448,1427,43,1384,0.030133146461107218,-0.6976819131966218
ZCTA5 73843,338,9,329,0.026627218934911243,-0.6979966450796403
ZCTA5 10471,8598,276,8322,0.03210048848569435,-0.6980777937580994
ZCTA5 74467,6092,194,5898,0.03184504267892318,-0.6984815183442176
ZCTA5 62319,133,3,130,0.022556390977443608,-0.6989242794350821
ZCTA5 99820,133,3,130,0.022556390977443608,-0.6989242794350821
ZCTA5 73749,203,5,198,0.024630541871921183,-0.6991369705282039
ZCTA5 80501,16475,535,15940,0.03247344461305007,-0.7000973184063702
ZCTA5 74959,2645,82,2563,0.03100189035916824,-0.7013907447230533
ZCTA5 75433,1017,30,987,0.029498525073746312,-0.7015354738789367
ZCTA5 18610,1679,51,1628,0.030375223347230494,-0.7016198252562769
ZCTA5 51453,305,8,297,0.02622950819672131,-0.7016739588841258
ZCTA5 99118,305,8,297,0.02622950819672131,-0.7016739588841258
ZCTA5 13491,1365,41,1324,0.030036630036630037,-0.7021876039843242
ZCTA5 99729,97,2,95,0.020618556701030927,-0.7030210417001368
ZCTA5 98349,1742,53,1689,0.030424799081515498,-0.7031549692736841
ZCTA5 40440,890,26,864,0.029213483146067417,-0.7035621719611493
ZCTA5 72069,536,15,521,0.027985074626865673,-0.7041534966025924
ZCTA5 50069,405,11,394,0.027160493827160494,-0.7043694768486637
ZCTA5 47523,1334,40,1294,0.029985007496251874,-0.7046535422203587
ZCTA5 65791,1805,55,1750,0.030470914127423823,-0.7048615267070075
ZCTA5 13134,59,1,58,0.01694915254237288,-0.7050294023969083
ZCTA5 28790,1271,38,1233,0.02989771833202203,-0.7051191724067983
ZCTA5 39346,986,29,957,0.029411764705882353,-0.7059110558016828
ZCTA5 28453,1208,36,1172,0.029801324503311258,-0.7060530801138233
ZCTA5 98237,1743,53,1690,0.030407343660355707,-0.7074094430505039
ZCTA5 31722,169,4,165,0.023668639053254437,-0.7074478255127166
ZCTA5 64471,169,4,165,0.023668639053254437,-0.7074478255127166
ZCTA5 74436,1837,56,1781,0.030484485574305935,-0.7078473836858169
ZCTA5 97086,11163,360,10803,0.03224939532383768,-0.7079262940840567
ZCTA5 47995,634,18,616,0.028391167192429023,-0.7089616623233356
ZCTA5 44430,1461,44,1417,0.030116358658453114,-0.709513014106039
ZCTA5 11558,2927,91,2836,0.031089853091902972,-0.7113687321990816
ZCTA5 48744,1744,53,1691,0.030389908256880736,-0.7116615348314739
ZCTA5 48208,4101,129,3972,0.03145574250182882,-0.711727379382226
ZCTA5 99021,3546,111,3435,0.031302876480541454,-0.7124398453577596
ZCTA5 01355,406,11,395,0.027093596059113302,-0.7127346744581181
ZCTA5 56219,439,12,427,0.02733485193621868,-0.7130238652299354
ZCTA5 43556,667,19,648,0.02848575712143928,-0.7135931611033022
ZCTA5 02118,12962,419,12543,0.03232525844777041,-0.7148083196315347
ZCTA5 66214,5148,163,4985,0.031662781662781664,-0.7148112778298304
ZCTA5 87035,2742,85,2657,0.03099927060539752,-0.7148988674719172
ZCTA5 10960,6161,196,5965,0.0318130173673105,-0.7164051901126721
ZCTA5 94531,12507,404,12103,0.03230191092987927,-0.7166708902423663
ZCTA5 54813,239,6,233,0.02510460251046025,-0.7178442146182178
ZCTA5 12923,239,6,233,0.02510460251046025,-0.7178442146182178
ZCTA5 57367,98,2,96,0.02040816326530612,-0.7182182312678859
ZCTA5 66873,98,2,96,0.02040816326530612,-0.7182182312678859
ZCTA5 67020,603,17,586,0.028192371475953566,-0.7185592220740576
ZCTA5 80101,170,4,166,0.023529411764705882,-0.7196329106625625
ZCTA5 35013,15,0,15,0,-0.720543270443905
ZCTA5 40816,15,0,15,0,-0.720543270443905
ZCTA5 46183,15,0,15,0,-0.720543270443905
ZCTA5 44493,15,0,15,0,-0.720543270443905
ZCTA5 47880,15,0,15,0,-0.720543270443905
ZCTA5 53047,15,0,15,0,-0.720543270443905
ZCTA5 54417,15,0,15,0,-0.720543270443905
ZCTA5 74753,15,0,15,0,-0.720543270443905
ZCTA5 72826,15,0,15,0,-0.720543270443905
ZCTA5 77454,15,0,15,0,-0.720543270443905
ZCTA5 83469,15,0,15,0,-0.720543270443905
ZCTA5 81655,15,0,15,0,-0.720543270443905
ZCTA5 04286,15,0,15,0,-0.720543270443905
ZCTA5 04764,15,0,15,0,-0.720543270443905
ZCTA5 04645,15,0,15,0,-0.720543270443905
ZCTA5 08095,15,0,15,0,-0.720543270443905
ZCTA5 13826,15,0,15,0,-0.720543270443905
ZCTA5 15443,15,0,15,0,-0.720543270443905
ZCTA5 19538,15,0,15,0,-0.720543270443905
ZCTA5 17083,15,0,15,0,-0.720543270443905
ZCTA5 22989,15,0,15,0,-0.720543270443905
ZCTA5 91948,15,0,15,0,-0.720543270443905
ZCTA5 97819,15,0,15,0,-0.720543270443905
ZCTA5 97494,15,0,15,0,-0.720543270443905
ZCTA5 93530,15,0,15,0,-0.720543270443905
ZCTA5 95721,15,0,15,0,-0.720543270443905
ZCTA5 99923,15,0,15,0,-0.720543270443905
ZCTA5 99333,15,0,15,0,-0.720543270443905
ZCTA5 19941,957,28,929,0.029258098223615466,-0.7218886896115947
ZCTA5 50044,374,10,364,0.026737967914438502,-0.7223169975193036
ZCTA5 71643,506,14,492,0.02766798418972332,-0.7238302641217542
ZCTA5 78022,1338,40,1298,0.029895366218236172,-0.7239439296243524
ZCTA5 27262,8612,276,8336,0.03204830469112866,-0.7255767942956302
ZCTA5 62045,135,3,132,0.022222222222222223,-0.7257518896610196
ZCTA5 56141,135,3,132,0.022222222222222223,-0.7257518896610196
ZCTA5 75081,14975,485,14490,0.032387312186978295,-0.7260815576154188
ZCTA5 64641,274,7,267,0.025547445255474453,-0.7278458452408085
ZCTA5 70559,990,29,961,0.029292929292929294,-0.7281349282484878
ZCTA5 68786,441,12,429,0.027210884353741496,-0.7291236197014875
ZCTA5 53569,474,13,461,0.027426160337552744,-0.7298472480605944
ZCTA5 04450,474,13,461,0.027426160337552744,-0.7298472480605944
ZCTA5 37307,1999,61,1938,0.030515257628814407,-0.730748457425509
ZCTA5 49655,1213,36,1177,0.02967848309975268,-0.7313051773584133
ZCTA5 01031,507,14,493,0.027613412228796843,-0.7313785559157175
ZCTA5 72435,171,4,167,0.023391812865497075,-0.7317527354571973
ZCTA5 74435,1245,37,1208,0.02971887550200803,-0.7329627384930222
ZCTA5 06791,1937,59,1878,0.030459473412493547,-0.7329802837622956
ZCTA5 27849,670,19,651,0.028358208955223882,-0.7335562312846314
ZCTA5 65640,342,9,333,0.02631578947368421,-0.7341431031264162
ZCTA5 78009,2779,86,2693,0.030946383591219862,-0.7352105099628139
ZCTA5 32145,1875,57,1818,0.0304,-0.7354756074502451
ZCTA5 27557,2717,84,2633,0.030916451969083547,-0.7356392815329215
ZCTA5 70355,409,11,398,0.02689486552567237,-0.7377136951249256
ZCTA5 36584,275,7,268,0.025454545454545455,-0.7377401274204846
ZCTA5 28783,703,20,683,0.02844950213371266,-0.7379432364176689
ZCTA5 55719,2500,77,2423,0.0308,-0.7380314543312543
ZCTA5 54485,136,3,133,0.022058823529411766,-0.7390318574287548
ZCTA5 62375,136,3,133,0.022058823529411766,-0.7390318574287548
ZCTA5 47955,376,10,366,0.026595744680851064,-0.7395822992830802
ZCTA5 47359,1310,39,1271,0.029770992366412213,-0.7413628443173431
ZCTA5 82426,1088,32,1056,0.029411764705882353,-0.7415253012284763
ZCTA5 89031,20812,677,20135,0.03252931001345378,-0.742050233992385
ZCTA5 97024,4081,128,3953,0.0313648615535408,-0.7422761367094992
ZCTA5 95903,343,9,334,0.026239067055393587,-0.7431175458109056
ZCTA5 57321,172,4,168,0.023255813953488372,-0.7438081281923938
ZCTA5 74359,172,4,168,0.023255813953488372,-0.7438081281923938
ZCTA5 49925,207,5,202,0.024154589371980676,-0.7440727330709387
ZCTA5 55711,207,5,202,0.024154589371980676,-0.7440727330709387
ZCTA5 64728,207,5,202,0.024154589371980676,-0.7440727330709387
ZCTA5 74457,207,5,202,0.024154589371980676,-0.7440727330709387
ZCTA5 29905,16,0,16,0,-0.7441738897736188
ZCTA5 28672,16,0,16,0,-0.7441738897736188
ZCTA5 36766,16,0,16,0,-0.7441738897736188
ZCTA5 38021,16,0,16,0,-0.7441738897736188
ZCTA5 41390,16,0,16,0,-0.7441738897736188
ZCTA5 39115,16,0,16,0,-0.7441738897736188
ZCTA5 41397,16,0,16,0,-0.7441738897736188
ZCTA5 43786,16,0,16,0,-0.7441738897736188
ZCTA5 46704,16,0,16,0,-0.7441738897736188
ZCTA5 46946,16,0,16,0,-0.7441738897736188
ZCTA5 44652,16,0,16,0,-0.7441738897736188
ZCTA5 44816,16,0,16,0,-0.7441738897736188
ZCTA5 58339,16,0,16,0,-0.7441738897736188
ZCTA5 58452,16,0,16,0,-0.7441738897736188
ZCTA5 59354,16,0,16,0,-0.7441738897736188
ZCTA5 87729,16,0,16,0,-0.7441738897736188
ZCTA5 57562,16,0,16,0,-0.7441738897736188
ZCTA5 62098,16,0,16,0,-0.7441738897736188
ZCTA5 72464,16,0,16,0,-0.7441738897736188
ZCTA5 72679,16,0,16,0,-0.7441738897736188
ZCTA5 78338,16,0,16,0,-0.7441738897736188
ZCTA5 88314,16,0,16,0,-0.7441738897736188
ZCTA5 88034,16,0,16,0,-0.7441738897736188
ZCTA5 81653,16,0,16,0,-0.7441738897736188
ZCTA5 83322,16,0,16,0,-0.7441738897736188
ZCTA5 84329,16,0,16,0,-0.7441738897736188
ZCTA5 04343,16,0,16,0,-0.7441738897736188
ZCTA5 14302,16,0,16,0,-0.7441738897736188
ZCTA5 13062,16,0,16,0,-0.7441738897736188
ZCTA5 16802,16,0,16,0,-0.7441738897736188
ZCTA5 23486,16,0,16,0,-0.7441738897736188
ZCTA5 24962,16,0,16,0,-0.7441738897736188
ZCTA5 24415,16,0,16,0,-0.7441738897736188
ZCTA5 26236,16,0,16,0,-0.7441738897736188
ZCTA5 94512,16,0,16,0,-0.7441738897736188
ZCTA5 95226,16,0,16,0,-0.7441738897736188
ZCTA5 59722,1909,58,1851,0.030382399161864852,-0.7463905691197211
ZCTA5 64465,1909,58,1851,0.030382399161864852,-0.7463905691197211
ZCTA5 60634,26116,852,25264,0.032623678970745904,-0.7464365839710575
ZCTA5 60935,377,10,367,0.026525198938992044,-0.748182495901677
ZCTA5 61940,100,2,98,0.02,-0.748208468870543
ZCTA5 79239,100,2,98,0.02,-0.748208468870543
ZCTA5 38451,1627,49,1578,0.03011677934849416,-0.7486421838254287
ZCTA5 30733,737,21,716,0.028493894165535955,-0.7488755756568641
ZCTA5 42204,242,6,236,0.024793388429752067,-0.7492588733358136
ZCTA5 92617,3991,125,3866,0.03132047105988474,-0.7496409521023242
ZCTA5 69130,2129,65,2064,0.030530765617660875,-0.750156125245571
ZCTA5 12941,575,16,559,0.02782608695652174,-0.7505224536097145
ZCTA5 50060,1058,31,1027,0.02930056710775047,-0.7513447413001011
ZCTA5 58735,137,3,134,0.021897810218978103,-0.7522244874668098
ZCTA5 74729,1122,33,1089,0.029411764705882353,-0.7530225031486737
ZCTA5 32113,1942,59,1883,0.03038105046343975,-0.7531447055270367
ZCTA5 13053,1848,56,1792,0.030303030303030304,-0.7533429419534646
ZCTA5 27235,1848,56,1792,0.030303030303030304,-0.7533429419534646
ZCTA5 13650,673,19,654,0.02823179791976226,-0.7534337823991398
ZCTA5 06708,11129,358,10771,0.03216820918321502,-0.754476560543594
ZCTA5 68532,208,5,203,0.02403846153846154,-0.755181735540496
ZCTA5 45167,1534,46,1488,0.02998696219035202,-0.755206359662882
ZCTA5 55085,173,4,169,0.023121387283236993,-0.7557999014383809
ZCTA5 36046,576,16,560,0.027777777777777776,-0.7576224867633666
ZCTA5 79547,311,8,303,0.02572347266881029,-0.7581697800752033
ZCTA5 27504,5442,172,5270,0.031606027195883866,-0.7582223606721518
ZCTA5 15077,62,1,61,0.016129032258064516,-0.7586433883803113
ZCTA5 12484,1155,34,1121,0.02943722943722944,-0.7592033646255004
ZCTA5 61410,1535,46,1489,0.02996742671009772,-0.7597088656279589
ZCTA5 70791,8874,284,8590,0.0320036060401172,-0.7599473402192124
ZCTA5 55388,2163,66,2097,0.030513176144244106,-0.760671669721217
ZCTA5 50150,445,12,433,0.02696629213483146,-0.7611164879975865
ZCTA5 22735,868,25,843,0.02880184331797235,-0.7622555938400111
ZCTA5 66006,2787,86,2701,0.03085755292429135,-0.7623472043525269
ZCTA5 72470,101,2,99,0.019801980198019802,-0.7630072699639627
ZCTA5 73032,101,2,99,0.019801980198019802,-0.7630072699639627
ZCTA5 74073,2070,63,2007,0.030434782608695653,-0.763973985677837
ZCTA5 70549,1283,38,1245,0.029618082618862042,-0.764141788022842
ZCTA5 72175,138,3,135,0.021739130434782608,-0.7653311531356003
ZCTA5 30751,17,0,17,0,-0.7670768878408462
ZCTA5 30664,17,0,17,0,-0.7670768878408462
ZCTA5 35032,17,0,17,0,-0.7670768878408462
ZCTA5 34141,17,0,17,0,-0.7670768878408462
ZCTA5 36454,17,0,17,0,-0.7670768878408462
ZCTA5 46968,17,0,17,0,-0.7670768878408462
ZCTA5 48630,17,0,17,0,-0.7670768878408462
ZCTA5 59058,17,0,17,0,-0.7670768878408462
ZCTA5 87581,17,0,17,0,-0.7670768878408462
ZCTA5 60969,17,0,17,0,-0.7670768878408462
ZCTA5 63746,17,0,17,0,-0.7670768878408462
ZCTA5 64765,17,0,17,0,-0.7670768878408462
ZCTA5 66506,17,0,17,0,-0.7670768878408462
ZCTA5 67559,17,0,17,0,-0.7670768878408462
ZCTA5 56565,17,0,17,0,-0.7670768878408462
ZCTA5 72037,17,0,17,0,-0.7670768878408462
ZCTA5 76841,17,0,17,0,-0.7670768878408462
ZCTA5 79518,17,0,17,0,-0.7670768878408462
ZCTA5 79094,17,0,17,0,-0.7670768878408462
ZCTA5 77415,17,0,17,0,-0.7670768878408462
ZCTA5 88126,17,0,17,0,-0.7670768878408462
ZCTA5 88134,17,0,17,0,-0.7670768878408462
ZCTA5 84024,17,0,17,0,-0.7670768878408462
ZCTA5 81232,17,0,17,0,-0.7670768878408462
ZCTA5 07703,17,0,17,0,-0.7670768878408462
ZCTA5 15463,17,0,17,0,-0.7670768878408462
ZCTA5 19735,17,0,17,0,-0.7670768878408462
ZCTA5 18046,17,0,17,0,-0.7670768878408462
ZCTA5 20686,17,0,17,0,-0.7670768878408462
ZCTA5 25201,17,0,17,0,-0.7670768878408462
ZCTA5 95305,17,0,17,0,-0.7670768878408462
ZCTA5 95974,17,0,17,0,-0.7670768878408462
ZCTA5 93928,17,0,17,0,-0.7670768878408462
ZCTA5 98314,17,0,17,0,-0.7670768878408462
ZCTA5 98297,17,0,17,0,-0.7670768878408462
ZCTA5 50484,174,4,170,0.022988505747126436,-0.7677288524319271
ZCTA5 50235,174,4,170,0.022988505747126436,-0.7677288524319271
ZCTA5 37059,512,14,498,0.02734375,-0.7689087978154636
ZCTA5 83672,3286,102,3184,0.0310407790626902,-0.7693764408108094
ZCTA5 49817,244,6,238,0.02459016393442623,-0.770002247584318
ZCTA5 00631,643,18,625,0.027993779160186624,-0.770014093983656
ZCTA5 59858,545,15,530,0.027522935779816515,-0.7700382227165499
ZCTA5 64048,1569,47,1522,0.02995538559592097,-0.7707289116947186
ZCTA5 31648,413,11,402,0.026634382566585957,-0.7707509427392032
ZCTA5 53550,413,11,402,0.026634382566585957,-0.7707509427392032
ZCTA5 32435,2883,89,2794,0.030870620881026708,-0.7714637608290509
ZCTA5 40461,1348,40,1308,0.02967359050445104,-0.771925847604825
ZCTA5 78735,7352,234,7118,0.031828073993471165,-0.7754133471000286
ZCTA5 60469,1822,55,1767,0.030186608122941824,-0.7756605441995409
ZCTA5 73448,1979,60,1919,0.03031834259727135,-0.7757989453726146
ZCTA5 46345,63,1,62,0.015873015873015872,-0.7760375991446313
ZCTA5 62861,63,1,62,0.015873015873015872,-0.7760375991446313
ZCTA5 55306,6279,199,6080,0.031692944736423,-0.7761449960130806
ZCTA5 74054,279,7,272,0.025089605734767026,-0.7769851009757064
ZCTA5 58750,210,5,205,0.023809523809523808,-0.7772534674449868
ZCTA5 59243,102,2,100,0.0196078431372549,-0.7776788745118449
ZCTA5 99335,102,2,100,0.0196078431372549,-0.7776788745118449
ZCTA5 37770,999,29,970,0.02902902902902903,-0.7778230154155183
ZCTA5 98819,139,3,136,0.02158273381294964,-0.7783531954409053
ZCTA5 71019,3010,93,2917,0.030897009966777408,-0.7802212590335297
ZCTA5 38543,245,6,239,0.024489795918367346,-0.7803150891034627
ZCTA5 75436,807,23,784,0.028500619578686492,-0.7825704765107174
ZCTA5 83336,1761,53,1708,0.030096536059057353,-0.7835855799139851
ZCTA5 71003,481,13,468,0.02702702702702703,-0.7838970107437475
ZCTA5 83346,547,15,532,0.027422303473491772,-0.7845384743846805
ZCTA5 30655,8949,286,8663,0.031958878086937086,-0.7866823965509233
ZCTA5 12916,808,23,785,0.028465346534653466,-0.788631049196278
ZCTA5 05345,1065,31,1034,0.02910798122065728,-0.7887774141973575
ZCTA5 30451,18,0,18,0,-0.7893156057613443
ZCTA5 38765,18,0,18,0,-0.7893156057613443
ZCTA5 36038,18,0,18,0,-0.7893156057613443
ZCTA5 41538,18,0,18,0,-0.7893156057613443
ZCTA5 50593,18,0,18,0,-0.7893156057613443
ZCTA5 59537,18,0,18,0,-0.7893156057613443
ZCTA5 61077,18,0,18,0,-0.7893156057613443
ZCTA5 67515,18,0,18,0,-0.7893156057613443
ZCTA5 67150,18,0,18,0,-0.7893156057613443
ZCTA5 67021,18,0,18,0,-0.7893156057613443
ZCTA5 71711,18,0,18,0,-0.7893156057613443
ZCTA5 71820,18,0,18,0,-0.7893156057613443
ZCTA5 74360,18,0,18,0,-0.7893156057613443
ZCTA5 79376,18,0,18,0,-0.7893156057613443
ZCTA5 82222,18,0,18,0,-0.7893156057613443
ZCTA5 04944,18,0,18,0,-0.7893156057613443
ZCTA5 04019,18,0,18,0,-0.7893156057613443
ZCTA5 08064,18,0,18,0,-0.7893156057613443
ZCTA5 10279,18,0,18,0,-0.7893156057613443
ZCTA5 14112,18,0,18,0,-0.7893156057613443
ZCTA5 13647,18,0,18,0,-0.7893156057613443
ZCTA5 18251,18,0,18,0,-0.7893156057613443
ZCTA5 18935,18,0,18,0,-0.7893156057613443
ZCTA5 26268,18,0,18,0,-0.7893156057613443
ZCTA5 26228,18,0,18,0,-0.7893156057613443
ZCTA5 97908,18,0,18,0,-0.7893156057613443
ZCTA5 99579,18,0,18,0,-0.7893156057613443
ZCTA5 99670,18,0,18,0,-0.7893156057613443
ZCTA5 48770,776,22,754,0.028350515463917526,-0.7906459119959766
ZCTA5 29370,382,10,372,0.02617801047120419,-0.7908639460103416
ZCTA5 57269,140,3,137,0.02142857142857143,-0.7912919240347615
ZCTA5 50566,176,4,172,0.022727272727272728,-0.7914014022101737
ZCTA5 59024,176,4,172,0.022727272727272728,-0.7914014022101737
ZCTA5 29916,548,15,533,0.02737226277372263,-0.7917697110178805
ZCTA5 40977,3913,122,3791,0.031178124201380015,-0.7917976505486302
ZCTA5 85735,4315,135,4180,0.031286210892236384,-0.7919915158109794
ZCTA5 49847,449,12,437,0.026726057906458798,-0.7928383667882648
ZCTA5 94582,13620,439,13181,0.03223201174743025,-0.7932449982195994
ZCTA5 57349,614,17,597,0.02768729641693811,-0.7946826656574325
ZCTA5 01850,5457,172,5285,0.03151914971596115,-0.794956665750005
ZCTA5 74652,315,8,307,0.025396825396825397,-0.7952700726728664
ZCTA5 79036,1764,53,1711,0.030045351473922902,-0.7962078015675559
ZCTA5 13329,1701,51,1650,0.029982363315696647,-0.7963074248515407
ZCTA5 83868,349,9,340,0.025787965616045846,-0.7964540950358303
ZCTA5 65046,516,14,502,0.027131782945736434,-0.7986831617369099
ZCTA5 70040,483,13,470,0.026915113871635612,-0.7992028942027272
ZCTA5 16948,582,16,566,0.027491408934707903,-0.799977599122209
ZCTA5 80836,450,12,438,0.02666666666666667,-0.8007271187160186
ZCTA5 30441,713,20,693,0.028050490883590462,-0.8024238736509998
ZCTA5 62512,177,4,173,0.022598870056497175,-0.8031465221639844
ZCTA5 15376,648,18,630,0.027777777777777776,-0.8035799969546877
ZCTA5 79342,141,3,138,0.02127659574468085,-0.8041486181782606
ZCTA5 95957,316,8,308,0.02531645569620253,-0.8044764998454443
ZCTA5 33145,11555,371,11184,0.0321073128515794,-0.8051841994727793
ZCTA5 71671,3484,108,3376,0.030998851894374284,-0.8059795490854156
ZCTA5 51530,282,7,275,0.024822695035460994,-0.8060773335760618
ZCTA5 69352,282,7,275,0.024822695035460994,-0.8060773335760618
ZCTA5 61030,940,27,913,0.02872340425531915,-0.8066140863938314
ZCTA5 61321,104,2,102,0.019230769230769232,-0.8066510195293215
ZCTA5 72084,451,12,439,0.026607538802660754,-0.8085993469760784
ZCTA5 58062,65,1,64,0.015384615384615385,-0.8101569851673655
ZCTA5 58775,65,1,64,0.015384615384615385,-0.8101569851673655
ZCTA5 28533,19,0,19,0,-0.8109446954861952
ZCTA5 31045,19,0,19,0,-0.8109446954861952
ZCTA5 35052,19,0,19,0,-0.8109446954861952
ZCTA5 40363,19,0,19,0,-0.8109446954861952
ZCTA5 41729,19,0,19,0,-0.8109446954861952
ZCTA5 39762,19,0,19,0,-0.8109446954861952
ZCTA5 44693,19,0,19,0,-0.8109446954861952
ZCTA5 47104,19,0,19,0,-0.8109446954861952
ZCTA5 50620,19,0,19,0,-0.8109446954861952
ZCTA5 58323,19,0,19,0,-0.8109446954861952
ZCTA5 59322,19,0,19,0,-0.8109446954861952
ZCTA5 59082,19,0,19,0,-0.8109446954861952
ZCTA5 64496,19,0,19,0,-0.8109446954861952
ZCTA5 71823,19,0,19,0,-0.8109446954861952
ZCTA5 70340,19,0,19,0,-0.8109446954861952
ZCTA5 72325,19,0,19,0,-0.8109446954861952
ZCTA5 76831,19,0,19,0,-0.8109446954861952
ZCTA5 76628,19,0,19,0,-0.8109446954861952
ZCTA5 79770,19,0,19,0,-0.8109446954861952
ZCTA5 79537,19,0,19,0,-0.8109446954861952
ZCTA5 82217,19,0,19,0,-0.8109446954861952
ZCTA5 02713,19,0,19,0,-0.8109446954861952
ZCTA5 13794,19,0,19,0,-0.8109446954861952
ZCTA5 16682,19,0,19,0,-0.8109446954861952
ZCTA5 15421,19,0,19,0,-0.8109446954861952
ZCTA5 17723,19,0,19,0,-0.8109446954861952
ZCTA5 17343,19,0,19,0,-0.8109446954861952
ZCTA5 26215,19,0,19,0,-0.8109446954861952
ZCTA5 25183,19,0,19,0,-0.8109446954861952
ZCTA5 92280,19,0,19,0,-0.8109446954861952
ZCTA5 56241,1673,50,1623,0.029886431560071727,-0.8115472016778716
ZCTA5 12788,747,21,726,0.028112449799196786,-0.8119158796808759
ZCTA5 86046,2427,74,2353,0.030490317264112072,-0.812019173264967
ZCTA5 45656,2677,82,2595,0.030631303698169594,-0.8122502433792853
ZCTA5 75862,4199,131,4068,0.031197904262919744,-0.8130955918485875
ZCTA5 94586,317,8,309,0.025236593059936908,-0.8136558496263242
ZCTA5 96097,4323,135,4188,0.031228313671061762,-0.8138949916515876
ZCTA5 45616,584,16,568,0.0273972602739726,-0.8140036669915957
ZCTA5 96052,584,16,568,0.0273972602739726,-0.8140036669915957
ZCTA5 97856,178,4,174,0.02247191011235955,-0.814831862907339
ZCTA5 43845,1800,54,1746,0.03,-0.8149915099093623
ZCTA5 56528,715,20,695,0.027972027972027972,-0.8152160793602213
ZCTA5 47023,617,17,600,0.027552674230145867,-0.8152178284654027
ZCTA5 99610,780,22,758,0.028205128205128206,-0.815261708567883
ZCTA5 73463,1166,34,1132,0.029159519725557463,-0.8155456029865724
ZCTA5 48089,12355,397,11958,0.032132739781465,-0.8168735511196692
ZCTA5 68817,142,3,139,0.02112676056338028,-0.8169245276679713
ZCTA5 19559,142,3,139,0.02112676056338028,-0.8169245276679713
ZCTA5 83204,7188,228,6960,0.03171953255425709,-0.8178916326916363
ZCTA5 39337,748,21,727,0.02807486631016043,-0.818175396703471
ZCTA5 61102,6113,193,5920,0.03157205954523147,-0.8183776535954779
ZCTA5 51564,214,5,209,0.02336448598130841,-0.8208258310238313
ZCTA5 43529,105,2,103,0.01904761904761905,-0.8209566185160317
ZCTA5 59914,105,2,103,0.01904761904761905,-0.8209566185160317
ZCTA5 80745,105,2,103,0.01904761904761905,-0.8209566185160317
ZCTA5 77535,9885,316,9569,0.03196762771876581,-0.8219623634800273
ZCTA5 73007,943,27,916,0.02863202545068929,-0.8235052360936842
ZCTA5 89510,651,18,633,0.027649769585253458,-0.8236011477954169
ZCTA5 38828,1581,47,1534,0.029728020240354206,-0.8239457855248593
ZCTA5 78343,1486,44,1442,0.029609690444145357,-0.8241743070815688
ZCTA5 62347,749,21,728,0.028037383177570093,-0.8244269163108894
ZCTA5 19453,749,21,728,0.028037383177570093,-0.8244269163108894
ZCTA5 47244,284,7,277,0.02464788732394366,-0.8253133164971809
ZCTA5 20608,284,7,277,0.02464788732394366,-0.8253133164971809
ZCTA5 45855,66,1,65,0.015151515151515152,-0.8268963745436915
ZCTA5 56724,66,1,65,0.015151515151515152,-0.8268963745436915
ZCTA5 70441,1550,46,1504,0.02967741935483871,-0.8269065520018182
ZCTA5 64658,1296,38,1258,0.029320987654320986,-0.827481992488521
ZCTA5 38721,420,11,409,0.02619047619047619,-0.8278469740772905
ZCTA5 27537,8940,285,8655,0.031879194630872486,-0.8281853679656507
ZCTA5 53529,847,24,823,0.02833530106257379,-0.8284868028054079
ZCTA5 45319,143,3,140,0.02097902097902098,-0.8296208737276061
ZCTA5 13314,143,3,140,0.02097902097902098,-0.8296208737276061
ZCTA5 54749,487,13,474,0.026694045174537988,-0.829635717277598
ZCTA5 79019,652,18,634,0.027607361963190184,-0.8302553341580826
ZCTA5 28383,2932,90,2842,0.030695770804911322,-0.8306436338353116
ZCTA5 62903,1137,33,1104,0.029023746701846966,-0.8307997941112276
ZCTA5 83871,815,23,792,0.02822085889570552,-0.83085471673238
ZCTA5 49667,250,6,244,0.024,-0.8313046390269337
ZCTA5 55962,319,8,311,0.025078369905956112,-0.8319340632578526
ZCTA5 30665,20,0,20,0,-0.8320117023071236
ZCTA5 30438,20,0,20,0,-0.8320117023071236
ZCTA5 31561,20,0,20,0,-0.8320117023071236
ZCTA5 40979,20,0,20,0,-0.8320117023071236
ZCTA5 40025,20,0,20,0,-0.8320117023071236
ZCTA5 44828,20,0,20,0,-0.8320117023071236
ZCTA5 55111,20,0,20,0,-0.8320117023071236
ZCTA5 59039,20,0,20,0,-0.8320117023071236
ZCTA5 60926,20,0,20,0,-0.8320117023071236
ZCTA5 57782,20,0,20,0,-0.8320117023071236
ZCTA5 63053,20,0,20,0,-0.8320117023071236
ZCTA5 61091,20,0,20,0,-0.8320117023071236
ZCTA5 68362,20,0,20,0,-0.8320117023071236
ZCTA5 68969,20,0,20,0,-0.8320117023071236
ZCTA5 67334,20,0,20,0,-0.8320117023071236
ZCTA5 72332,20,0,20,0,-0.8320117023071236
ZCTA5 77468,20,0,20,0,-0.8320117023071236
ZCTA5 79258,20,0,20,0,-0.8320117023071236
ZCTA5 76685,20,0,20,0,-0.8320117023071236
ZCTA5 76061,20,0,20,0,-0.8320117023071236
ZCTA5 77460,20,0,20,0,-0.8320117023071236
ZCTA5 88136,20,0,20,0,-0.8320117023071236
ZCTA5 81429,20,0,20,0,-0.8320117023071236
ZCTA5 84728,20,0,20,0,-0.8320117023071236
ZCTA5 12922,20,0,20,0,-0.8320117023071236
ZCTA5 13102,20,0,20,0,-0.8320117023071236
ZCTA5 23398,20,0,20,0,-0.8320117023071236
ZCTA5 23304,20,0,20,0,-0.8320117023071236
ZCTA5 25907,20,0,20,0,-0.8320117023071236
ZCTA5 95944,20,0,20,0,-0.8320117023071236
ZCTA5 95699,20,0,20,0,-0.8320117023071236
ZCTA5 99767,20,0,20,0,-0.8320117023071236
ZCTA5 55049,880,25,855,0.028409090909090908,-0.8322988471694496
ZCTA5 14769,387,10,377,0.025839793281653745,-0.8330240025222234
ZCTA5 71110,977,28,949,0.028659160696008188,-0.8335028138220466
ZCTA5 56521,285,7,278,0.02456140350877193,-0.8348843902729424
ZCTA5 83325,285,7,278,0.02456140350877193,-0.8348843902729424
ZCTA5 43151,106,2,104,0.018867924528301886,-0.835145144650813
ZCTA5 16352,106,2,104,0.018867924528301886,-0.835145144650813
ZCTA5 41472,3680,114,3566,0.03097826086956522,-0.835286912174611
ZCTA5 36321,620,17,603,0.027419354838709678,-0.8356581925919524
ZCTA5 47847,421,11,410,0.026128266033254157,-0.8359304024029646
ZCTA5 83861,2528,77,2451,0.03045886075949367,-0.837538642078035
ZCTA5 30564,1330,39,1291,0.029323308270676692,-0.8377953941794506
ZCTA5 13312,180,4,176,0.022222222222222223,-0.8380260977213385
ZCTA5 44826,686,19,667,0.027696793002915453,-0.8386019329021157
ZCTA5 55335,686,19,667,0.027696793002915453,-0.8386019329021157
ZCTA5 97453,455,12,443,0.026373626373626374,-0.8399246280551493
ZCTA5 10925,1648,49,1599,0.029733009708737865,-0.8400969148930546
ZCTA5 27893,15356,495,14861,0.032234957020057305,-0.8402529411665824
ZCTA5 13655,1171,34,1137,0.029035012809564473,-0.8409861485755487
ZCTA5 49760,320,8,312,0.025,-0.8410332954284458
ZCTA5 67123,251,6,245,0.02390438247011952,-0.8413899608625196
ZCTA5 63373,216,5,211,0.023148148148148147,-0.84233418375954106
ZCTA5 65322,216,5,211,0.023148148148148147,-0.84233418375954106
ZCTA5 83202,7844,249,7595,0.0317440081591025,-0.8423436421854984
ZCTA5 55354,1011,29,982,0.028684470820969338,-0.8434064917748622
ZCTA5 64444,489,13,476,0.026584867075664622,-0.8447637356817037
ZCTA5 15631,489,13,476,0.026584867075664622,-0.8447637356817037
ZCTA5 54113,1332,39,1293,0.02927927927927928,-0.8473613018671085
ZCTA5 13028,456,12,444,0.02631578947368421,-0.8477154364274873
ZCTA5 53924,589,16,573,0.027164685908319185,-0.8488702179294582
ZCTA5 52318,355,9,346,0.02535211267605634,-0.8489397886652937
ZCTA5 15459,622,17,605,0.027331189710610933,-0.8492329362013019
ZCTA5 75428,3747,116,3631,0.03095809981318388,-0.8497195161355798
ZCTA5 23954,655,18,637,0.02748091603053435,-0.8501597639332287
ZCTA5 72662,1141,33,1108,0.028921998247151623,-0.8513731173702438
ZCTA5 81433,252,6,246,0.023809523809523808,-0.851438514037453
ZCTA5 25067,423,11,412,0.026004728132387706,-0.852043352482701
ZCTA5 89801,8922,284,8638,0.03183142793095718,-0.8524422922782726
ZCTA5 29122,21,0,21,0,-0.852558295024333
ZCTA5 30448,21,0,21,0,-0.852558295024333
ZCTA5 43736,21,0,21,0,-0.852558295024333
ZCTA5 51656,21,0,21,0,-0.852558295024333
ZCTA5 51341,21,0,21,0,-0.852558295024333
ZCTA5 87724,21,0,21,0,-0.852558295024333
ZCTA5 58484,21,0,21,0,-0.852558295024333
ZCTA5 59025,21,0,21,0,-0.852558295024333
ZCTA5 62961,21,0,21,0,-0.852558295024333
ZCTA5 63047,21,0,21,0,-0.852558295024333
ZCTA5 66728,21,0,21,0,-0.852558295024333
ZCTA5 65730,21,0,21,0,-0.852558295024333
ZCTA5 65735,21,0,21,0,-0.852558295024333
ZCTA5 56177,21,0,21,0,-0.852558295024333
ZCTA5 56456,21,0,21,0,-0.852558295024333
ZCTA5 72749,21,0,21,0,-0.852558295024333
ZCTA5 80862,21,0,21,0,-0.852558295024333
ZCTA5 88410,21,0,21,0,-0.852558295024333
ZCTA5 84755,21,0,21,0,-0.852558295024333
ZCTA5 87516,21,0,21,0,-0.852558295024333
ZCTA5 84732,21,0,21,0,-0.852558295024333
ZCTA5 01097,21,0,21,0,-0.852558295024333
ZCTA5 04541,21,0,21,0,-0.852558295024333
ZCTA5 12864,21,0,21,0,-0.852558295024333
ZCTA5 12872,21,0,21,0,-0.852558295024333
ZCTA5 11770,21,0,21,0,-0.852558295024333
ZCTA5 15447,21,0,21,0,-0.852558295024333
ZCTA5 17739,21,0,21,0,-0.852558295024333
ZCTA5 25911,21,0,21,0,-0.852558295024333
ZCTA5 26327,21,0,21,0,-0.852558295024333
ZCTA5 26349,21,0,21,0,-0.852558295024333
ZCTA5 96119,21,0,21,0,-0.852558295024333
ZCTA5 63453,217,5,212,0.02304147465437788,-0.853020534242822
ZCTA5 15060,287,7,280,0.024390243902439025,-0.8539338976377882
ZCTA5 16691,145,3,142,0.020689655172413793,-0.8547796227062018
ZCTA5 73002,356,9,347,0.025280898876404494,-0.8576069033311116
ZCTA5 01128,1078,31,1047,0.0287569573283859,-0.8576697407647663
ZCTA5 05653,182,4,178,0.02197802197802198,-0.8609897582683997
ZCTA5 77082,22334,724,21610,0.03241694277782753,-0.8620918377772613
ZCTA5 67474,108,2,106,0.018518518518518517,-0.8631802667155063
ZCTA5 80812,108,2,106,0.018518518518518517,-0.8631802667155063
ZCTA5 49879,458,12,446,0.026200873362445413,-0.863248985426744
ZCTA5 57237,288,7,281,0.024305555555555556,-0.8634128011042398
ZCTA5 56090,288,7,281,0.024305555555555556,-0.8634128011042398
ZCTA5 94946,288,7,281,0.024305555555555556,-0.8634128011042398
ZCTA5 92678,218,5,213,0.022935779816513763,-0.8636622702184313
ZCTA5 12546,1208,35,1173,0.028973509933774833,-0.8660566528417335
ZCTA5 65438,983,28,955,0.028484231943031537,-0.8665583594306098
ZCTA5 99141,2128,64,2064,0.03007518796992481,-0.8668521686091365
ZCTA5 84309,146,3,143,0.02054794520547945,-0.8672443327770568
ZCTA5 54875,492,13,479,0.026422764227642278,-0.8673467608807283
ZCTA5 97136,756,21,735,0.027777777777777776,-0.8679655984484514
ZCTA5 68666,592,16,576,0.02702702702702703,-0.8696556513598546
ZCTA5 74951,526,14,512,0.026615969581749048,-0.8721734943174984
ZCTA5 45859,183,4,179,0.02185792349726776,-0.872386833935809
ZCTA5 28647,22,0,22,0,-0.8726212351608214
ZCTA5 37851,22,0,22,0,-0.8726212351608214
ZCTA5 40110,22,0,22,0,-0.8726212351608214
ZCTA5 44850,22,0,22,0,-0.8726212351608214
ZCTA5 50839,22,0,22,0,-0.8726212351608214
ZCTA5 49634,22,0,22,0,-0.8726212351608214
ZCTA5 59703,22,0,22,0,-0.8726212351608214
ZCTA5 62622,22,0,22,0,-0.8726212351608214
ZCTA5 60141,22,0,22,0,-0.8726212351608214
ZCTA5 69335,22,0,22,0,-0.8726212351608214
ZCTA5 71048,22,0,22,0,-0.8726212351608214
ZCTA5 56022,22,0,22,0,-0.8726212351608214
ZCTA5 71666,22,0,22,0,-0.8726212351608214
ZCTA5 76873,22,0,22,0,-0.8726212351608214
ZCTA5 77876,22,0,22,0,-0.8726212351608214
ZCTA5 75856,22,0,22,0,-0.8726212351608214
ZCTA5 82058,22,0,22,0,-0.8726212351608214
ZCTA5 79032,22,0,22,0,-0.8726212351608214
ZCTA5 78851,22,0,22,0,-0.8726212351608214
ZCTA5 80914,22,0,22,0,-0.8726212351608214
ZCTA5 87539,22,0,22,0,-0.8726212351608214
ZCTA5 83337,22,0,22,0,-0.8726212351608214
ZCTA5 02357,22,0,22,0,-0.8726212351608214
ZCTA5 82051,22,0,22,0,-0.8726212351608214
ZCTA5 04057,22,0,22,0,-0.8726212351608214
ZCTA5 04852,22,0,22,0,-0.8726212351608214
ZCTA5 05740,22,0,22,0,-0.8726212351608214
ZCTA5 14035,22,0,22,0,-0.8726212351608214
ZCTA5 13333,22,0,22,0,-0.8726212351608214
ZCTA5 19457,22,0,22,0,-0.8726212351608214
ZCTA5 97712,22,0,22,0,-0.8726212351608214
ZCTA5 94720,22,0,22,0,-0.8726212351608214
ZCTA5 93519,22,0,22,0,-0.8726212351608214
ZCTA5 99105,22,0,22,0,-0.8726212351608214
ZCTA5 99174,22,0,22,0,-0.8726212351608214
ZCTA5 98670,22,0,22,0,-0.8726212351608214
ZCTA5 99724,22,0,22,0,-0.8726212351608214
ZCTA5 80512,822,23,799,0.027980535279805353,-0.8727325291781347
ZCTA5 03448,289,7,282,0.02422145328719723,-0.8728614465541953
ZCTA5 19116,12664,406,12258,0.03205938092229943,-0.872934871770901
ZCTA5 76832,219,5,214,0.0228310502283105,-0.8742598352817313
ZCTA5 36850,1049,30,1019,0.028598665395614873,-0.874565535984254
ZCTA5 68665,358,9,349,0.025139664804469275,-0.8748734043032601
ZCTA5 22733,358,9,349,0.025139664804469275,-0.8748734043032601
ZCTA5 14747,855,24,831,0.028070175438596492,-0.8755021519844568
ZCTA5 42133,626,17,609,0.027156549520766772,-0.876258554402058
ZCTA5 12472,626,17,609,0.027156549520766772,-0.876258554402058
ZCTA5 57569,109,2,107,0.01834862385321101,-0.8770313335993767
ZCTA5 68759,109,2,107,0.01834862385321101,-0.8770313335993767
ZCTA5 69367,109,2,107,0.01834862385321101,-0.8770313335993767
ZCTA5 97835,109,2,107,0.01834862385321101,-0.8770313335993767
ZCTA5 70094,11078,354,10724,0.031955226575194076,-0.8774089482681295
ZCTA5 56229,725,20,705,0.027586206896551724,-0.878669188871385
ZCTA5 16664,725,20,705,0.027586206896551724,-0.878669188871385
ZCTA5 08317,460,12,448,0.02608695652173913,-0.8787189561973193
ZCTA5 73008,7739,245,7494,0.0316578369298359,-0.8788436517590392
ZCTA5 64836,8691,276,8415,0.03175698998964446,-0.8799261715434278
ZCTA5 79745,2289,69,2220,0.03014416775884666,-0.8806934021165592
ZCTA5 12780,856,24,832,0.028037383177570093,-0.8813494460771147
ZCTA5 67879,494,13,481,0.02631578947368421,-0.8823302006168471
ZCTA5 79257,393,10,383,0.02544529262086514,-0.8829484933209206
ZCTA5 18465,594,16,578,0.026936026936026935,-0.8834572624215671
ZCTA5 65768,184,4,180,0.021739130434782608,-0.883728294564091
ZCTA5 84750,184,4,180,0.021739130434782608,-0.883728294564091
ZCTA5 54856,693,19,674,0.027417027417027416,-0.8838262697368173
ZCTA5 57376,427,11,416,0.02576112412177986,-0.8840562255072482
ZCTA5 02830,2290,69,2221,0.030131004366812226,-0.8843888253534028
ZCTA5 70661,824,23,801,0.027912621359223302,-0.8846350072296664
ZCTA5 25053,1722,51,1671,0.029616724738675958,-0.8855863109470877
ZCTA5 92344,6082,191,5891,0.031404143373890164,-0.8891246834487527
ZCTA5 72932,661,18,643,0.02723146747352496,-0.8897099660040594
ZCTA5 80650,628,17,611,0.027070063694267517,-0.8897100110693896
ZCTA5 31796,495,13,482,0.026262626262626262,-0.8898005396477469
ZCTA5 66543,495,13,482,0.026262626262626262,-0.8898005396477469
ZCTA5 46303,5187,162,5025,0.031231925968768073,-0.8900789434468743
ZCTA5 46532,694,19,675,0.027377521613832854,-0.8902513913867465
ZCTA5 23942,595,16,579,0.02689075630252101,-0.8903415879352331
ZCTA5 61416,110,2,108,0.01818181818181818,-0.8907742749729177
ZCTA5 64484,394,10,384,0.025380710659898477,-0.8912000231693379
ZCTA5 43156,70,1,69,0.014285714285714285,-0.891869045558722
ZCTA5 59746,70,1,69,0.014285714285714285,-0.891869045558722
ZCTA5 50155,148,3,145,0.02027027027027027,-0.8919500008526012
ZCTA5 96086,148,3,145,0.02027027027027027,-0.8919500008526012
ZCTA5 64784,428,11,417,0.02570093457943925,-0.8920155962481019
ZCTA5 32461,23,0,23,0,-0.8922331498506415
ZCTA5 37165,23,0,23,0,-0.8922331498506415
ZCTA5 40818,23,0,23,0,-0.8922331498506415
ZCTA5 38007,23,0,23,0,-0.8922331498506415
ZCTA5 47367,23,0,23,0,-0.8922331498506415
ZCTA5 47467,23,0,23,0,-0.8922331498506415
ZCTA5 53599,23,0,23,0,-0.8922331498506415
ZCTA5 53802,23,0,23,0,-0.8922331498506415
ZCTA5 59933,23,0,23,0,-0.8922331498506415
ZCTA5 58423,23,0,23,0,-0.8922331498506415
ZCTA5 57780,23,0,23,0,-0.8922331498506415
ZCTA5 59465,23,0,23,0,-0.8922331498506415
ZCTA5 62541,23,0,23,0,-0.8922331498506415
ZCTA5 69027,23,0,23,0,-0.8922331498506415
ZCTA5 72669,23,0,23,0,-0.8922331498506415
ZCTA5 73946,23,0,23,0,-0.8922331498506415
ZCTA5 77440,23,0,23,0,-0.8922331498506415
ZCTA5 78860,23,0,23,0,-0.8922331498506415
ZCTA5 81237,23,0,23,0,-0.8922331498506415
ZCTA5 80434,23,0,23,0,-0.8922331498506415
ZCTA5 85922,23,0,23,0,-0.8922331498506415
ZCTA5 16871,23,0,23,0,-0.8922331498506415
ZCTA5 15564,23,0,23,0,-0.8922331498506415
ZCTA5 24846,23,0,23,0,-0.8922331498506415
ZCTA5 26259,23,0,23,0,-0.8922331498506415
ZCTA5 27982,23,0,23,0,-0.8922331498506415
ZCTA5 99548,23,0,23,0,-0.8922331498506415
ZCTA5 63103,4662,145,4517,0.0311025311025311,-0.8929652758253653
ZCTA5 76951,462,12,450,0.025974025974025976,-0.8941259555729596
ZCTA5 14202,1756,52,1704,0.029612756264236904,-0.8952111011586041
ZCTA5 15552,2293,69,2224,0.03009158307893589,-0.8954656738702546
ZCTA5 14711,695,19,676,0.027338129496402876,-0.8966677233621693
ZCTA5 03442,596,16,580,0.026845637583892617,-0.8972149810613185
ZCTA5 39825,496,13,483,0.02620967741935484,-0.8972567092505307
ZCTA5 37370,1915,57,1858,0.029765013054830286,-0.8978091128631907
ZCTA5 17304,1118,32,1086,0.028622540250447227,-0.898431205939558
ZCTA5 54829,2294,69,2225,0.03007846556233653,-0.8991548214001309
ZCTA5 67490,395,10,385,0.02531645569620253,-0.8994320699777564
ZCTA5 72040,1279,37,1242,0.028928850664581705,-0.9000264361749918
ZCTA5 74029,2042,61,1981,0.029872673849167482,-0.900046872171852
ZCTA5 66834,361,9,352,0.024930747922437674,-0.9006058974584955
ZCTA5 63767,292,7,285,0.023972602739726026,-0.9010281050724965
ZCTA5 78638,892,25,867,0.028026905829596414,-0.9014318222777732
ZCTA5 98639,463,12,451,0.02591792656587473,-0.9018060282579199
ZCTA5 99574,1022,29,993,0.02837573385518591,-0.9028703208799088
ZCTA5 52560,149,3,146,0.020134228187919462,-0.9041931162291545
ZCTA5 72170,111,2,109,0.018018018018018018,-0.9044111650881498
ZCTA5 59482,222,5,217,0.02252252252252252,-0.9057918425345804
ZCTA5 04781,222,5,217,0.02252252252252252,-0.9057918425345804
ZCTA5 50264,186,4,182,0.021505376344086023,-0.9062469644274319
ZCTA5 64660,186,4,182,0.021505376344086023,-0.9062469644274319
ZCTA5 04777,186,4,182,0.021505376344086023,-0.9062469644274319
ZCTA5 99663,186,4,182,0.021505376344086023,-0.9062469644274319
ZCTA5 36763,71,1,70,0.014084507042253521,-0.9076453031977386
ZCTA5 78884,430,11,419,0.02558139534883721,-0.9078823494297455
ZCTA5 46988,362,9,353,0.024861878453038673,-0.9091393342257924
ZCTA5 30260,7969,252,7717,0.03162253733216213,-0.909331542224005
ZCTA5 48662,664,18,646,0.02710843373493976,-0.9093574645271841
ZCTA5 70789,258,6,252,0.023255813953488372,-0.9109751903030121
ZCTA5 31081,24,0,24,0,-0.9114231549237692
ZCTA5 30412,24,0,24,0,-0.9114231549237692
ZCTA5 40808,24,0,24,0,-0.9114231549237692
ZCTA5 43434,24,0,24,0,-0.9114231549237692
ZCTA5 50426,24,0,24,0,-0.9114231549237692
ZCTA5 54857,24,0,24,0,-0.9114231549237692
ZCTA5 59547,24,0,24,0,-0.9114231549237692
ZCTA5 57027,24,0,24,0,-0.9114231549237692
ZCTA5 63742,24,0,24,0,-0.9114231549237692
ZCTA5 63079,24,0,24,0,-0.9114231549237692
ZCTA5 60519,24,0,24,0,-0.9114231549237692
ZCTA5 65715,24,0,24,0,-0.9114231549237692
ZCTA5 67036,24,0,24,0,-0.9114231549237692
ZCTA5 67518,24,0,24,0,-0.9114231549237692
ZCTA5 67656,24,0,24,0,-0.9114231549237692
ZCTA5 56687,24,0,24,0,-0.9114231549237692
ZCTA5 72367,24,0,24,0,-0.9114231549237692
ZCTA5 73551,24,0,24,0,-0.9114231549237692
ZCTA5 72578,24,0,24,0,-0.9114231549237692
ZCTA5 82640,24,0,24,0,-0.9114231549237692
ZCTA5 88055,24,0,24,0,-0.9114231549237692
ZCTA5 78871,24,0,24,0,-0.9114231549237692
ZCTA5 79025,24,0,24,0,-0.9114231549237692
ZCTA5 84540,24,0,24,0,-0.9114231549237692
ZCTA5 01343,24,0,24,0,-0.9114231549237692
ZCTA5 04933,24,0,24,0,-0.9114231549237692
ZCTA5 15741,24,0,24,0,-0.9114231549237692
ZCTA5 16728,24,0,24,0,-0.9114231549237692
ZCTA5 20839,24,0,24,0,-0.9114231549237692
ZCTA5 96071,24,0,24,0,-0.9114231549237692
ZCTA5 04606,498,13,485,0.02610441767068273,-0.9121267910427344
ZCTA5 78132,9812,312,9500,0.031797798613942115,-0.91247388038296
ZCTA5 76528,6123,192,5931,0.03135717785399314,-0.9125538769250153
ZCTA5 77871,1153,33,1120,0.028620988725065046,-0.9126789106742642
ZCTA5 43811,328,8,320,0.024390243902439025,-0.9128937359751693
ZCTA5 35085,3270,100,3170,0.03058103975535168,-0.9137014872895135
ZCTA5 62865,829,23,806,0.027744270205066344,-0.9142709793982101
ZCTA5 78010,1282,37,1245,0.028861154446177848,-0.9145607923381701
ZCTA5 60803,8433,267,8166,0.03166133048737104,-0.9156190799589186
ZCTA5 45719,431,11,420,0.025522041763341066,-0.9157899087553377
ZCTA5 46941,397,10,387,0.02518891687657431,-0.9158381458887372
ZCTA5 74741,397,10,387,0.02518891687657431,-0.9158381458887372
ZCTA5 25063,665,18,647,0.02706766917293233,-0.9158879362947313
ZCTA5 65779,862,24,838,0.027842227378190254,-0.9162967432661357
ZCTA5 49309,731,20,711,0.027359781121751026,-0.9163421277067216
ZCTA5 98256,150,3,147,0.02,-0.916364484980951
ZCTA5 68790,363,9,354,0.024793388429752067,-0.9176509624626781
ZCTA5 21913,363,9,354,0.024793388429752067,-0.9176509624626781
ZCTA5 58520,112,2,110,0.017857142857142856,-0.9179440181508736
ZCTA5 56295,112,2,110,0.017857142857142856,-0.9179440181508736
ZCTA5 99135,112,2,110,0.017857142857142856,-0.9179440181508736
ZCTA5 30457,2331,70,2261,0.03003003003003003,-0.9193817053001836
ZCTA5 67436,294,7,287,0.023809523809523808,-0.9196587050190723
ZCTA5 73077,2834,86,2748,0.030345800988002825,-0.9202519102572628
ZCTA5 42275,259,6,253,0.023166023166023165,-0.9207750290199593
ZCTA5 58773,329,8,321,0.0243161094224924,-0.9217622122908306
ZCTA5 43019,3179,97,3082,0.030512739855300407,-0.9223137134245112
ZCTA5 56680,72,1,71,0.013888888888888888,-0.9232456052537923
ZCTA5 95004,1252,36,1216,0.02875399361022364,-0.9248830072449887
ZCTA5 12846,1381,40,1341,0.02896451846488052,-0.9278553940357495
ZCTA5 45816,151,3,148,0.019867549668874173,-0.9284651281529477
ZCTA5 57436,188,4,184,0.02127659574468085,-0.9285508423473687
ZCTA5 32831,25,0,25,0,-0.9302173622170236
ZCTA5 32133,25,0,25,0,-0.9302173622170236
ZCTA5 37140,25,0,25,0,-0.9302173622170236
ZCTA5 36512,25,0,25,0,-0.9302173622170236
ZCTA5 39088,25,0,25,0,-0.9302173622170236
ZCTA5 41775,25,0,25,0,-0.9302173622170236
ZCTA5 43970,25,0,25,0,-0.9302173622170236
ZCTA5 45897,25,0,25,0,-0.9302173622170236
ZCTA5 48816,25,0,25,0,-0.9302173622170236
ZCTA5 58224,25,0,25,0,-0.9302173622170236
ZCTA5 57214,25,0,25,0,-0.9302173622170236
ZCTA5 61479,25,0,25,0,-0.9302173622170236
ZCTA5 65484,25,0,25,0,-0.9302173622170236
ZCTA5 56140,25,0,25,0,-0.9302173622170236
ZCTA5 72428,25,0,25,0,-0.9302173622170236
ZCTA5 77617,25,0,25,0,-0.9302173622170236
ZCTA5 73425,25,0,25,0,-0.9302173622170236
ZCTA5 75759,25,0,25,0,-0.9302173622170236
ZCTA5 79247,25,0,25,0,-0.9302173622170236
ZCTA5 77451,25,0,25,0,-0.9302173622170236
ZCTA5 82837,25,0,25,0,-0.9302173622170236
ZCTA5 83238,25,0,25,0,-0.9302173622170236
ZCTA5 83235,25,0,25,0,-0.9302173622170236
ZCTA5 81043,25,0,25,0,-0.9302173622170236
ZCTA5 02203,25,0,25,0,-0.9302173622170236
ZCTA5 06336,25,0,25,0,-0.9302173622170236
ZCTA5 12933,25,0,25,0,-0.9302173622170236
ZCTA5 13847,25,0,25,0,-0.9302173622170236
ZCTA5 15776,25,0,25,0,-0.9302173622170236
ZCTA5 16331,25,0,25,0,-0.9302173622170236
ZCTA5 22530,25,0,25,0,-0.9302173622170236
ZCTA5 21717,25,0,25,0,-0.9302173622170236
ZCTA5 21644,25,0,25,0,-0.9302173622170236
ZCTA5 27861,25,0,25,0,-0.9302173622170236
ZCTA5 99146,25,0,25,0,-0.9302173622170236
ZCTA5 36034,330,8,322,0.024242424242424242,-0.9306058993296289
ZCTA5 74533,330,8,322,0.024242424242424242,-0.9306058993296289
ZCTA5 24448,113,2,111,0.017699115044247787,-0.9313747906081363
ZCTA5 97389,601,16,585,0.026622296173044926,-0.9314193683672545
ZCTA5 21030,10129,322,9807,0.03178991015894955,-0.9315116119484224
ZCTA5 16836,433,11,422,0.025404157043879907,-0.9315538300372415
ZCTA5 55053,399,10,389,0.02506265664160401,-0.9321675749735437
ZCTA5 04776,399,10,389,0.02506265664160401,-0.9321675749735437
ZCTA5 88041,568,15,553,0.02640845070422535,-0.9338294004281764
ZCTA5 46017,2335,70,2265,0.029978586723768737,-0.9339942527808637
ZCTA5 43149,931,26,905,0.027926960257787327,-0.9378862477566414
ZCTA5 66412,73,1,72,0.0136986301369863,-0.9386749408842827
ZCTA5 43451,434,11,423,0.02534562211981567,-0.9394103648660254
ZCTA5 64738,434,11,423,0.02534562211981567,-0.9394103648660254
ZCTA5 73067,866,24,842,0.02771362586605081,-0.9394661934359871
ZCTA5 65778,189,4,185,0.021164021164021163,-0.9396237720453622
ZCTA5 05648,189,4,185,0.021164021164021163,-0.9396237720453622
ZCTA5 68942,152,3,149,0.019736842105263157,-0.9404960449087566
ZCTA5 74042,152,3,149,0.019736842105263157,-0.9404960449087566
ZCTA5 14060,152,3,149,0.019736842105263157,-0.9404960449087566
ZCTA5 74033,4090,126,3964,0.03080684596577017,-0.9415533246139358
ZCTA5 04920,768,21,747,0.02734375,-0.9417171066923613
ZCTA5 67871,2053,61,1992,0.029712615684364344,-0.9427985081521882
ZCTA5 65745,1159,33,1126,0.028472821397756688,-0.9431021149165089
ZCTA5 54618,834,23,811,0.027577937649880094,-0.9437370318799209
ZCTA5 64657,114,2,112,0.017543859649122806,-0.9447053833284501
ZCTA5 73006,1224,35,1189,0.028594771241830064,-0.9454607110363222
ZCTA5 60910,226,5,221,0.022123893805309734,-0.947241910537196
ZCTA5 73738,469,12,457,0.0255863539445629,-0.9475631141325183
ZCTA5 95689,703,19,684,0.02702702702702703,-0.9476852749891617
ZCTA5 97121,570,15,555,0.02631578947368421,-0.9477746707138814
ZCTA5 52747,769,21,748,0.027308192457737322,-0.9478135069003496
ZCTA5 29831,1705,50,1655,0.02932551319648094,-0.9480745079168043
ZCTA5 49743,332,8,324,0.024096385542168676,-0.9482195593973578
ZCTA5 43761,26,0,26,0,-0.9486392963654822
ZCTA5 42061,26,0,26,0,-0.9486392963654822
ZCTA5 45112,26,0,26,0,-0.9486392963654822
ZCTA5 57426,26,0,26,0,-0.9486392963654822
ZCTA5 61037,26,0,26,0,-0.9486392963654822
ZCTA5 63826,26,0,26,0,-0.9486392963654822
ZCTA5 65436,26,0,26,0,-0.9486392963654822
ZCTA5 68379,26,0,26,0,-0.9486392963654822
ZCTA5 73553,26,0,26,0,-0.9486392963654822
ZCTA5 79259,26,0,26,0,-0.9486392963654822
ZCTA5 75642,26,0,26,0,-0.9486392963654822
ZCTA5 83636,26,0,26,0,-0.9486392963654822
ZCTA5 88411,26,0,26,0,-0.9486392963654822
ZCTA5 79231,26,0,26,0,-0.9486392963654822
ZCTA5 87512,26,0,26,0,-0.9486392963654822
ZCTA5 03911,26,0,26,0,-0.9486392963654822
ZCTA5 05447,26,0,26,0,-0.9486392963654822
ZCTA5 06350,26,0,26,0,-0.9486392963654822
ZCTA5 06414,26,0,26,0,-0.9486392963654822
ZCTA5 14774,26,0,26,0,-0.9486392963654822
ZCTA5 13415,26,0,26,0,-0.9486392963654822
ZCTA5 19736,26,0,26,0,-0.9486392963654822
ZCTA5 18420,26,0,26,0,-0.9486392963654822
ZCTA5 20660,26,0,26,0,-0.9486392963654822
ZCTA5 24131,26,0,26,0,-0.9486392963654822
ZCTA5 95679,26,0,26,0,-0.9486392963654822
ZCTA5 96049,26,0,26,0,-0.9486392963654822
ZCTA5 99565,26,0,26,0,-0.9486392963654822
ZCTA5 96773,26,0,26,0,-0.9486392963654822
ZCTA5 95664,537,14,523,0.0260707635009311,-0.9515064510601474
ZCTA5 70778,1322,38,1284,0.028744326777609682,-0.9523413526118405
ZCTA5 15617,153,3,150,0.0196078431372549,-0.9524582131479652
ZCTA5 75754,2372,71,2301,0.02993254637436762,-0.9538349115066506
ZCTA5 61059,74,1,73,0.013513513513513514,-0.9539380839775637
ZCTA5 49342,704,19,685,0.026988636363636364,-0.9540237410647661
ZCTA5 40322,1258,36,1222,0.028616852146263912,-0.9541468419223985
ZCTA5 56473,1451,42,1409,0.028945554789800137,-0.9550974132122904
ZCTA5 32428,5585,174,5411,0.031154879140555057,-0.9556164929591856
ZCTA5 52570,298,7,291,0.02348993288590604,-0.95657448263314
ZCTA5 04929,333,8,325,0.024024024024024024,-0.9569898553016737
ZCTA5 62050,115,2,113,0.017391304347826087,-0.9579376436807032
ZCTA5 63966,1000,28,972,0.028,-0.9591756298496285
ZCTA5 83110,1516,44,1472,0.029023746701846966,-0.9593249695456059
ZCTA5 49052,368,9,359,0.024456521739130436,-0.9598865321532349
ZCTA5 33711,7224,227,6997,0.031423034330011076,-0.9600810893862164
ZCTA5 36025,1388,40,1348,0.02881844380403458,-0.9604684227806249
ZCTA5 55736,672,18,654,0.026785714285714284,-0.9613426782904221
ZCTA5 12093,672,18,654,0.026785714285714284,-0.9613426782904221
ZCTA5 58049,191,4,187,0.020942408376963352,-0.9616145961524794
ZCTA5 67753,191,4,187,0.020942408376963352,-0.9616145961524794
ZCTA5 73073,191,4,187,0.020942408376963352,-0.9616145961524794
ZCTA5 56009,572,15,557,0.026223776223776224,-0.9616740078038984
ZCTA5 84403,13025,416,12609,0.03193857965451056,-0.9619590416213596
ZCTA5 13407,2058,61,1997,0.029640427599611274,-0.9621576203998098
ZCTA5 64730,2784,84,2700,0.03017241379310345,-0.9629740388282538
ZCTA5 57055,505,13,492,0.02574257425742574,-0.9637348413301929
ZCTA5 67745,154,3,151,0.01948051948051948,-0.9643525901019961
ZCTA5 26136,299,7,292,0.023411371237458192,-0.9657326918447748
ZCTA5 31084,27,0,27,0,-0.9667102400655518
ZCTA5 41643,27,0,27,0,-0.9667102400655518
ZCTA5 43902,27,0,27,0,-0.9667102400655518
ZCTA5 59242,27,0,27,0,-0.9667102400655518
ZCTA5 61562,27,0,27,0,-0.9667102400655518
ZCTA5 64833,27,0,27,0,-0.9667102400655518
ZCTA5 65320,27,0,27,0,-0.9667102400655518
ZCTA5 71316,27,0,27,0,-0.9667102400655518
ZCTA5 71722,27,0,27,0,-0.9667102400655518
ZCTA5 72828,27,0,27,0,-0.9667102400655518
ZCTA5 83011,27,0,27,0,-0.9667102400655518
ZCTA5 88125,27,0,27,0,-0.9667102400655518
ZCTA5 79785,27,0,27,0,-0.9667102400655518
ZCTA5 79519,27,0,27,0,-0.9667102400655518
ZCTA5 80746,27,0,27,0,-0.9667102400655518
ZCTA5 05362,27,0,27,0,-0.9667102400655518
ZCTA5 06243,27,0,27,0,-0.9667102400655518
ZCTA5 13450,27,0,27,0,-0.9667102400655518
ZCTA5 17270,27,0,27,0,-0.9667102400655518
ZCTA5 21866,27,0,27,0,-0.9667102400655518
ZCTA5 89450,27,0,27,0,-0.9667102400655518
ZCTA5 27825,27,0,27,0,-0.9667102400655518
ZCTA5 95646,27,0,27,0,-0.9667102400655518
ZCTA5 56540,838,23,815,0.027446300715990454,-0.9671890424423273
ZCTA5 64106,3881,119,3762,0.03066220046379799,-0.9672928709200644
ZCTA5 62284,228,5,223,0.021929824561403508,-0.9677202495821787
ZCTA5 14101,673,18,655,0.02674591381872214,-0.967799639723042
ZCTA5 58422,75,1,74,0.013333333333333334,-0.9690396053932278
ZCTA5 67553,75,1,74,0.013333333333333334,-0.9690396053932278
ZCTA5 49947,264,6,258,0.022727272727272728,-0.9692648085690225
ZCTA5 97452,640,17,623,0.0265625,-0.9695776777384216
ZCTA5 58272,116,2,114,0.017241379310344827,-0.971073367517337
ZCTA5 56224,116,2,114,0.017241379310344827,-0.971073367517337
ZCTA5 74850,116,2,114,0.017241379310344827,-0.971073367517337
ZCTA5 22134,1294,37,1257,0.0285935085007728,-0.9723726901035947
ZCTA5 63432,192,4,188,0.020833333333333332,-0.9725336533847421
ZCTA5 61447,404,10,394,0.024752475247524754,-0.9726612958210822
ZCTA5 12431,404,10,394,0.024752475247524754,-0.9726612958210822
ZCTA5 04476,540,14,526,0.025925925925925925,-0.9728778054318077
ZCTA5 43213,13919,445,13474,0.03197068754939292,-0.9733584590155632
ZCTA5 38646,1165,33,1132,0.02832618025751073,-0.9733745301099982
ZCTA5 14842,300,7,293,0.023333333333333334,-0.974863018712418
ZCTA5 18829,300,7,293,0.023333333333333334,-0.974863018712418
ZCTA5 66097,574,15,559,0.02613240418118467,-0.975527764611635
ZCTA5 90212,5934,185,5749,0.031176272328951805,-0.9758571699424456
ZCTA5 04261,155,3,152,0.01935483870967742,-0.9761801129093867
ZCTA5 16882,155,3,152,0.01935483870967742,-0.9761801129093867
ZCTA5 47951,938,26,912,0.02771855010660981,-0.9769018616131989
ZCTA5 23603,1295,37,1258,0.02857142857142857,-0.9771670532947399
ZCTA5 40037,1036,29,1007,0.027992277992277992,-0.9776703478400619
ZCTA5 54616,1036,29,1007,0.027992277992277992,-0.9776703478400619
ZCTA5 07403,2883,87,2796,0.030176899063475548,-0.9786070279417466
ZCTA5 58077,265,6,259,0.022641509433962263,-0.9788628381600927
ZCTA5 11746,20696,667,20029,0.03222844994201778,-0.9806764875060534
ZCTA5 85224,16856,541,16315,0.03209539629805411,-0.9810991583168311
ZCTA5 19401,16216,520,15696,0.03206709422792304,-0.9823359667834187
ZCTA5 92883,10403,330,10073,0.03172161876381813,-0.9827621541790512
ZCTA5 04091,336,8,328,0.023809523809523808,-0.9831565105558768
ZCTA5 15753,193,4,189,0.02072538860103627,-0.9834025662210419
ZCTA5 75784,301,7,294,0.023255813953488372,-0.9839656651727627
ZCTA5 77464,76,1,75,0.013157894736842105,-0.9839838843468698
ZCTA5 01264,76,1,75,0.013157894736842105,-0.9839838843468698
ZCTA5 51365,117,2,115,0.017094017094017096,-0.9841143010669895
ZCTA5 04490,117,2,115,0.017094017094017096,-0.9841143010669895
ZCTA5 16665,117,2,115,0.017094017094017096,-0.9841143010669895
ZCTA5 29375,28,0,28,0,-0.984449522264294
ZCTA5 40964,28,0,28,0,-0.984449522264294
ZCTA5 43711,28,0,28,0,-0.984449522264294
ZCTA5 43721,28,0,28,0,-0.984449522264294
ZCTA5 46786,28,0,28,0,-0.984449522264294
ZCTA5 49674,28,0,28,0,-0.984449522264294
ZCTA5 51578,28,0,28,0,-0.984449522264294
ZCTA5 57553,28,0,28,0,-0.984449522264294
ZCTA5 58355,28,0,28,0,-0.984449522264294
ZCTA5 63535,28,0,28,0,-0.984449522264294
ZCTA5 63743,28,0,28,0,-0.984449522264294
ZCTA5 67478,28,0,28,0,-0.984449522264294
ZCTA5 69041,28,0,28,0,-0.984449522264294
ZCTA5 56731,28,0,28,0,-0.984449522264294
ZCTA5 83802,28,0,28,0,-0.984449522264294
ZCTA5 79056,28,0,28,0,-0.984449522264294
ZCTA5 80938,28,0,28,0,-0.984449522264294
ZCTA5 07820,28,0,28,0,-0.984449522264294
ZCTA5 17729,28,0,28,0,-0.984449522264294
ZCTA5 19732,28,0,28,0,-0.984449522264294
ZCTA5 25203,28,0,28,0,-0.984449522264294
ZCTA5 89404,28,0,28,0,-0.984449522264294
ZCTA5 97837,28,0,28,0,-0.984449522264294
ZCTA5 95013,28,0,28,0,-0.984449522264294
ZCTA5 96085,28,0,28,0,-0.984449522264294
ZCTA5 64670,371,9,362,0.02425876010781671,-0.9849743993237444
ZCTA5 16656,474,12,462,0.02531645569620253,-0.9852784673407645
ZCTA5 38388,709,19,690,0.02679830747531735,-0.9855888590294433
ZCTA5 83810,440,11,429,0.025,-0.9861989558534541
ZCTA5 38865,1778,52,1726,0.02924634420697413,-0.9867223533556051
ZCTA5 64475,156,3,153,0.019230769230769232,-0.987941699171333
ZCTA5 84335,3607,110,3497,0.03049625727751594,-0.987946039088171
ZCTA5 62817,230,5,225,0.021739130434782608,-0.9880382701426327
ZCTA5 83546,230,5,225,0.021739130434782608,-0.9880382701426327
ZCTA5 52501,12063,384,11679,0.031832877393683165,-0.9903152540135202
ZCTA5 70344,2002,59,1943,0.029470529470529472,-0.9912517723425498
ZCTA5 94951,1811,53,1758,0.029265599116510214,-0.9912802862812989
ZCTA5 38631,475,12,463,0.02526315789473684,-0.9927770456284771
ZCTA5 27986,475,12,463,0.02526315789473684,-0.9927770456284771
ZCTA5 50268,441,11,430,0.024943310657596373,-0.993939394835655
ZCTA5 15056,543,14,529,0.02578268876611418,-0.994138244116883
ZCTA5 05477,1780,52,1728,0.029213483146067417,-0.994987165560129
ZCTA5 23882,843,23,820,0.027283511269276393,-0.9963548695718517
ZCTA5 42254,118,2,116,0.01694915254237288,-0.997062142741506
ZCTA5 45361,118,2,116,0.01694915254237288,-0.997062142741506
ZCTA5 74932,909,25,884,0.027502750275027504,-0.9978642403092542
ZCTA5 95543,267,6,261,0.02247191011235955,-0.9979611451422177
ZCTA5 67572,231,5,226,0.021645021645021644,-0.998138101433924
ZCTA5 30122,9275,293,8982,0.03159029649595688,-0.9982861136824188
ZCTA5 80535,1170,33,1137,0.028205128205128206,-0.9984875964104589
ZCTA5 77950,77,1,76,0.012987012987012988,-0.9987751190098364
ZCTA5 12164,77,1,76,0.012987012987012988,-0.9987751190098364
ZCTA5 80124,8568,270,8298,0.031512605042016806,-0.9994764151828587
ZCTA5 56186,157,3,154,0.01910828025477707,-0.9996382474882989
ZCTA5 72854,338,8,330,0.023668639053254437,-1.0004823095114388
ZCTA5 38046,29,0,29,0,-1.001874760399321
ZCTA5 39162,29,0,29,0,-1.001874760399321
ZCTA5 45301,29,0,29,0,-1.001874760399321
ZCTA5 45773,29,0,29,0,-1.001874760399321
ZCTA5 45156,29,0,29,0,-1.001874760399321
ZCTA5 49263,29,0,29,0,-1.001874760399321
ZCTA5 54127,29,0,29,0,-1.001874760399321
ZCTA5 52657,29,0,29,0,-1.001874760399321
ZCTA5 58338,29,0,29,0,-1.001874760399321
ZCTA5 59441,29,0,29,0,-1.001874760399321
ZCTA5 57358,29,0,29,0,-1.001874760399321
ZCTA5 64781,29,0,29,0,-1.001874760399321
ZCTA5 64420,29,0,29,0,-1.001874760399321
ZCTA5 68072,29,0,29,0,-1.001874760399321
ZCTA5 56436,29,0,29,0,-1.001874760399321
ZCTA5 72038,29,0,29,0,-1.001874760399321
ZCTA5 74549,29,0,29,0,-1.001874760399321
ZCTA5 79314,29,0,29,0,-1.001874760399321
ZCTA5 82934,29,0,29,0,-1.001874760399321
ZCTA5 88113,29,0,29,0,-1.001874760399321
ZCTA5 88254,29,0,29,0,-1.001874760399321
ZCTA5 87011,29,0,29,0,-1.001874760399321
ZCTA5 83215,29,0,29,0,-1.001874760399321
ZCTA5 82335,29,0,29,0,-1.001874760399321
ZCTA5 00694,29,0,29,0,-1.001874760399321
ZCTA5 04267,29,0,29,0,-1.001874760399321
ZCTA5 04431,29,0,29,0,-1.001874760399321
ZCTA5 12131,29,0,29,0,-1.001874760399321
ZCTA5 13696,29,0,29,0,-1.001874760399321
ZCTA5 13677,29,0,29,0,-1.001874760399321
ZCTA5 25857,29,0,29,0,-1.001874760399321
ZCTA5 89054,29,0,29,0,-1.001874760399321
ZCTA5 99927,29,0,29,0,-1.001874760399321
ZCTA5 38449,1008,28,980,0.027777777777777776,-1.0022403438230962
ZCTA5 68770,645,17,628,0.02635658914728682,-1.0024395861775612
ZCTA5 10930,2796,84,2712,0.030042918454935622,-1.003126211271191
ZCTA5 88116,195,4,191,0.020512820512820513,-1.0049921779635982
ZCTA5 16657,511,13,498,0.025440313111545987,-1.0074406722426197
ZCTA5 68842,268,6,262,0.022388059701492536,-1.0074619510964888
ZCTA5 85333,268,6,262,0.022388059701492536,-1.0074619510964888
ZCTA5 07822,268,6,262,0.022388059701492536,-1.0074619510964888
ZCTA5 57313,545,14,531,0.025688073394495414,-1.0082509142383402
ZCTA5 95943,339,8,331,0.02359882005899705,-1.009110076456096
ZCTA5 62815,119,2,117,0.01680672268907563,-1.0099185448618853
ZCTA5 99128,119,2,117,0.01680672268907563,-1.0099185448618853
ZCTA5 64746,579,15,564,0.025906735751295335,-1.0099650225573902
ZCTA5 43567,5018,155,4863,0.030888800318852133,-1.0106292573823406
ZCTA5 50168,304,7,297,0.023026315789473683,-1.0111095087554587
ZCTA5 59087,158,3,155,0.0189873417721519,-1.0112706379784535
ZCTA5 63747,158,3,155,0.0189873417721519,-1.0112706379784535
ZCTA5 60071,1399,40,1359,0.028591851322373123,-1.0113989797966392
ZCTA5 29591,2039,60,1979,0.029426189308484552,-1.0115042124839457
ZCTA5 47557,680,18,662,0.026470588235294117,-1.0127465224781174
ZCTA5 83612,780,21,759,0.026923076923076925,-1.014382149794435
ZCTA5 26710,780,21,759,0.026923076923076925,-1.014382149794435
ZCTA5 14422,912,25,887,0.027412280701754384,-1.014703209244885
ZCTA5 67016,196,4,192,0.02040816326530612,-1.0157139634026604
ZCTA5 84739,196,4,192,0.02040816326530612,-1.0157139634026604
ZCTA5 03849,580,15,565,0.02586206896551724,-1.0168190221684066
ZCTA5 29125,978,27,951,0.027607361963190184,-1.0168509624556217
ZCTA5 31041,269,6,263,0.022304832713754646,-1.0169308723705068
ZCTA5 31035,444,11,433,0.024774774774774775,-1.0170634975108277
ZCTA5 06103,1271,36,1235,0.02832415420928403,-1.017094584948038
ZCTA5 69151,340,8,332,0.023529411764705882,-1.0177146221890216
ZCTA5 68870,233,5,228,0.02145922746781116,-1.0182212406756892
ZCTA5 18632,233,5,228,0.02145922746781116,-1.0182212406756892
ZCTA5 28308,30,0,30,0,-1.019002065338435
ZCTA5 45350,30,0,30,0,-1.019002065338435
ZCTA5 46930,30,0,30,0,-1.019002065338435
ZCTA5 47160,30,0,30,0,-1.019002065338435
ZCTA5 55029,30,0,30,0,-1.019002065338435
ZCTA5 59020,30,0,30,0,-1.019002065338435
ZCTA5 59055,30,0,30,0,-1.019002065338435
ZCTA5 59530,30,0,30,0,-1.019002065338435
ZCTA5 59257,30,0,30,0,-1.019002065338435
ZCTA5 59863,30,0,30,0,-1.019002065338435
ZCTA5 57660,30,0,30,0,-1.019002065338435
ZCTA5 61471,30,0,30,0,-1.019002065338435
ZCTA5 62266,30,0,30,0,-1.019002065338435
ZCTA5 74082,30,0,30,0,-1.019002065338435
ZCTA5 72320,30,0,30,0,-1.019002065338435
ZCTA5 81045,30,0,30,0,-1.019002065338435
ZCTA5 78828,30,0,30,0,-1.019002065338435
ZCTA5 82714,30,0,30,0,-1.019002065338435
ZCTA5 81411,30,0,30,0,-1.019002065338435
ZCTA5 80475,30,0,30,0,-1.019002065338435
ZCTA5 04985,30,0,30,0,-1.019002065338435
ZCTA5 07851,30,0,30,0,-1.019002065338435
ZCTA5 06353,30,0,30,0,-1.019002065338435
ZCTA5 16631,30,0,30,0,-1.019002065338435
ZCTA5 16670,30,0,30,0,-1.019002065338435
ZCTA5 15737,30,0,30,0,-1.019002065338435
ZCTA5 15784,30,0,30,0,-1.019002065338435
ZCTA5 17507,30,0,30,0,-1.019002065338435
ZCTA5 23943,30,0,30,0,-1.019002065338435
ZCTA5 23691,30,0,30,0,-1.019002065338435
ZCTA5 95986,30,0,30,0,-1.019002065338435
ZCTA5 98263,30,0,30,0,-1.019002065338435
ZCTA5 98353,30,0,30,0,-1.019002065338435
ZCTA5 42746,681,18,663,0.02643171806167401,-1.0191318775900304
ZCTA5 84649,305,7,298,0.022950819672131147,-1.0201034095420325
ZCTA5 64084,648,17,631,0.026234567901234566,-1.0220418657109864
ZCTA5 53233,4431,136,4295,0.030692845858722635,-1.0222188662528806
ZCTA5 04640,979,27,952,0.027579162410623085,-1.0222774734943652
ZCTA5 43037,120,2,118,0.016666666666666666,-1.0226851153074756
ZCTA5 54120,120,2,118,0.016666666666666666,-1.0226851153074756
ZCTA5 60974,120,2,118,0.016666666666666666,-1.0226851153074756
ZCTA5 49840,270,6,264,0.022222222222222223,-1.026368165276516
ZCTA5 56089,79,1,78,0.012658227848101266,-1.0279144015360993
ZCTA5 78654,6978,218,6760,0.03124104327887647,-1.0281358030654928
ZCTA5 51041,2361,70,2291,0.02964845404489623,-1.0283869739155365
ZCTA5 58722,649,17,632,0.026194144838212634,-1.0285570098261492
ZCTA5 27957,548,14,534,0.025547445255474453,-1.0293294656564604
ZCTA5 40902,480,12,468,0.025,-1.030051215245556
ZCTA5 72938,480,12,468,0.025,-1.030051215245556
ZCTA5 90245,6639,207,6432,0.031179394487121554,-1.030785202747127
ZCTA5 30683,2552,76,2476,0.029780564263322883,-1.0320610966612405
ZCTA5 98665,9939,314,9625,0.031592715564946174,-1.0320611152760348
ZCTA5 17048,1468,42,1426,0.02861035422343324,-1.0320979299880404
ZCTA5 00717,6640,207,6433,0.031174698795180724,-1.032990709176976
ZCTA5 53128,3120,94,3026,0.03012820512820513,-1.0331620934561094
ZCTA5 73530,160,3,157,0.01875,-1.0343463765287726
ZCTA5 28039,31,0,31,0,-1.0358462158075379
ZCTA5 28424,31,0,31,0,-1.0358462158075379
ZCTA5 32681,31,0,31,0,-1.0358462158075379
ZCTA5 31556,31,0,31,0,-1.0358462158075379
ZCTA5 40376,31,0,31,0,-1.0358462158075379
ZCTA5 43505,31,0,31,0,-1.0358462158075379
ZCTA5 44861,31,0,31,0,-1.0358462158075379
ZCTA5 59545,31,0,31,0,-1.0358462158075379
ZCTA5 54458,31,0,31,0,-1.0358462158075379
ZCTA5 57061,31,0,31,0,-1.0358462158075379
ZCTA5 59867,31,0,31,0,-1.0358462158075379
ZCTA5 61433,31,0,31,0,-1.0358462158075379
ZCTA5 63387,31,0,31,0,-1.0358462158075379
ZCTA5 63738,31,0,31,0,-1.0358462158075379
ZCTA5 65443,31,0,31,0,-1.0358462158075379
ZCTA5 68821,31,0,31,0,-1.0358462158075379
ZCTA5 68444,31,0,31,0,-1.0358462158075379
ZCTA5 77473,31,0,31,0,-1.0358462158075379
ZCTA5 88422,31,0,31,0,-1.0358462158075379
ZCTA5 78060,31,0,31,0,-1.0358462158075379
ZCTA5 78885,31,0,31,0,-1.0358462158075379
ZCTA5 87736,31,0,31,0,-1.0358462158075379
ZCTA5 04646,31,0,31,0,-1.0358462158075379
ZCTA5 13674,31,0,31,0,-1.0358462158075379
ZCTA5 15730,31,0,31,0,-1.0358462158075379
ZCTA5 24898,31,0,31,0,-1.0358462158075379
ZCTA5 25811,31,0,31,0,-1.0358462158075379
ZCTA5 93558,31,0,31,0,-1.0358462158075379
ZCTA5 99039,31,0,31,0,-1.0358462158075379
ZCTA5 80482,515,13,502,0.02524271844660194,-1.0363128743627157
ZCTA5 21659,515,13,502,0.02524271844660194,-1.0363128743627157
ZCTA5 76557,1854,54,1800,0.02912621359223301,-1.0363557289896101
ZCTA5 67523,198,4,194,0.020202020202020204,-1.0370141425780819
ZCTA5 95558,198,4,194,0.020202020202020204,-1.0370141425780819
ZCTA5 20763,817,22,795,0.02692778457772338,-1.037414165481269
ZCTA5 79245,982,27,955,0.0274949083503055,-1.0385254127390375
ZCTA5 61740,617,16,601,0.02593192868719611,-1.039100543654961
ZCTA5 33859,4219,129,4090,0.030575965868689263,-1.0396842750261024
ZCTA5 80207,10220,323,9897,0.031604696673189825,-1.0398131379182576
ZCTA5 59215,447,11,436,0.024608501118568233,-1.040043449891026
ZCTA5 33129,6210,193,6017,0.03107890499194847,-1.040963559427239
ZCTA5 66521,651,17,634,0.026113671274961597,-1.0415590669329833
ZCTA5 60901,12677,403,12274,0.03178985564407983,-1.0421433403585072
ZCTA5 99322,80,1,79,0.0125,-1.0422700261642353
ZCTA5 46340,343,8,335,0.023323615160349854,-1.0433904104902527
ZCTA5 26815,343,8,335,0.023323615160349854,-1.0433904104902527
ZCTA5 40143,2302,68,2234,0.029539530842745437,-1.044519004378476
ZCTA5 66515,161,3,158,0.018633540372670808,-1.045791396839704
ZCTA5 26271,161,3,158,0.018633540372670808,-1.045791396839704
ZCTA5 77457,199,4,195,0.020100502512562814,-1.0475935699278234
ZCTA5 29453,448,11,437,0.024553571428571428,-1.047671766518461
ZCTA5 28722,2841,85,2756,0.029919042590637098,-1.0478849024496795
ZCTA5 54760,122,2,120,0.01639344262295082,-1.0479549798733476
ZCTA5 63655,652,17,635,0.02607361963190184,-1.0480460435133556
ZCTA5 03230,551,14,537,0.025408348457350273,-1.050300628885435
ZCTA5 97348,551,14,537,0.025408348457350273,-1.050300628885435
ZCTA5 81324,517,13,504,0.025145067698259187,-1.0506708235217839
ZCTA5 69347,585,15,570,0.02564102564102564,-1.0509240713824133
ZCTA5 18325,686,18,668,0.026239067055393587,-1.0509269117231925
ZCTA5 24077,344,8,336,0.023255813953488372,-1.0519035426930292
ZCTA5 38639,414,10,404,0.024154589371980676,-1.0522777505009373
ZCTA5 43759,32,0,32,0,-1.0524208076817925
ZCTA5 43951,32,0,32,0,-1.0524208076817925
ZCTA5 43962,32,0,32,0,-1.0524208076817925
ZCTA5 54565,32,0,32,0,-1.0524208076817925
ZCTA5 54645,32,0,32,0,-1.0524208076817925
ZCTA5 51244,32,0,32,0,-1.0524208076817925
ZCTA5 58833,32,0,32,0,-1.0524208076817925
ZCTA5 58343,32,0,32,0,-1.0524208076817925
ZCTA5 59424,32,0,32,0,-1.0524208076817925
ZCTA5 62965,32,0,32,0,-1.0524208076817925
ZCTA5 57584,32,0,32,0,-1.0524208076817925
ZCTA5 60144,32,0,32,0,-1.0524208076817925
ZCTA5 66522,32,0,32,0,-1.0524208076817925
ZCTA5 68749,32,0,32,0,-1.0524208076817925
ZCTA5 79243,32,0,32,0,-1.0524208076817925
ZCTA5 79540,32,0,32,0,-1.0524208076817925
ZCTA5 78607,32,0,32,0,-1.0524208076817925
ZCTA5 87525,32,0,32,0,-1.0524208076817925
ZCTA5 08039,32,0,32,0,-1.0524208076817925
ZCTA5 12736,32,0,32,0,-1.0524208076817925
ZCTA5 14788,32,0,32,0,-1.0524208076817925
ZCTA5 13352,32,0,32,0,-1.0524208076817925
ZCTA5 13641,32,0,32,0,-1.0524208076817925
ZCTA5 15929,32,0,32,0,-1.0524208076817925
ZCTA5 17039,32,0,32,0,-1.0524208076817925
ZCTA5 26152,32,0,32,0,-1.0524208076817925
ZCTA5 27201,32,0,32,0,-1.0524208076817925
ZCTA5 95550,32,0,32,0,-1.0524208076817925
ZCTA5 97626,32,0,32,0,-1.0524208076817925
ZCTA5 97033,32,0,32,0,-1.0524208076817925
ZCTA5 98333,1408,40,1368,0.028409090909090908,-1.0527840203951386
ZCTA5 36362,1246,35,1211,0.028089887640449437,-1.0530287352128846
ZCTA5 38115,16969,543,16426,0.03199952855206553,-1.0538308801203795
ZCTA5 61545,273,6,267,0.02197802197802198,-1.0544927907599067
ZCTA5 88002,273,6,267,0.02197802197802198,-1.0544927907599067
ZCTA5 04658,653,17,636,0.026033690658499236,-1.0545236942365113
ZCTA5 03245,787,21,766,0.026683608640406607,-1.0562829792811013
ZCTA5 76084,2337,69,2268,0.029525032092426188,-1.0563274034317203
ZCTA5 73838,162,3,159,0.018518518518518517,-1.0571756047462402
ZCTA5 73639,237,5,232,0.02109704641350211,-1.0579313801732553
ZCTA5 68632,1667,48,1619,0.028794241151769647,-1.0580778626165488
ZCTA5 04462,2306,68,2238,0.029488291413703384,-1.0591095951240705
ZCTA5 31712,484,12,472,0.024793388429752067,-1.0596120603998926
ZCTA5 30256,854,23,831,0.026932084309133488,-1.0599463092722359
ZCTA5 58222,123,2,121,0.016260162601626018,-1.0604612813912833
ZCTA5 53573,1345,38,1307,0.02825278810408922,-1.0608394376446197
ZCTA5 73014,654,17,637,0.02599388379204893,-1.0609920504969235
ZCTA5 29335,1764,51,1713,0.02891156462585034,-1.0610235767017233
ZCTA5 28445,2940,88,2852,0.029931972789115645,-1.0620874214274425
ZCTA5 98584,13456,428,13028,0.03180737217598097,-1.062386019763408
ZCTA5 64788,688,18,670,0.02616279069767442,-1.0635839717352362
ZCTA5 49129,310,7,303,0.02258064516129032,-1.064676122891558
ZCTA5 42442,1281,36,1245,0.02810304449648712,-1.0650973131371044
ZCTA5 85540,1020,28,992,0.027450980392156862,-1.0662303348206044
ZCTA5 62353,1508,43,1465,0.028514588859416445,-1.0667457431566634
ZCTA5 62410,416,10,406,0.02403846153846154,-1.0679882524578215
ZCTA5 04961,416,10,406,0.02403846153846154,-1.0679882524578215
ZCTA5 25033,789,21,768,0.026615969581749048,-1.0681900141290375
ZCTA5 98663,6098,189,5909,0.030993768448671695,-1.068505730941861
ZCTA5 38964,33,0,33,0,-1.0687383824306096
ZCTA5 42463,33,0,33,0,-1.0687383824306096
ZCTA5 47455,33,0,33,0,-1.0687383824306096
ZCTA5 51011,33,0,33,0,-1.0687383824306096
ZCTA5 55601,33,0,33,0,-1.0687383824306096
ZCTA5 59076,33,0,33,0,-1.0687383824306096
ZCTA5 61346,33,0,33,0,-1.0687383824306096
ZCTA5 67660,33,0,33,0,-1.0687383824306096
ZCTA5 64433,33,0,33,0,-1.0687383824306096
ZCTA5 64499,33,0,33,0,-1.0687383824306096
ZCTA5 66955,33,0,33,0,-1.0687383824306096
ZCTA5 65589,33,0,33,0,-1.0687383824306096
ZCTA5 56287,33,0,33,0,-1.0687383824306096
ZCTA5 75849,33,0,33,0,-1.0687383824306096
ZCTA5 74368,33,0,33,0,-1.0687383824306096
ZCTA5 83253,33,0,33,0,-1.0687383824306096
ZCTA5 87753,33,0,33,0,-1.0687383824306096
ZCTA5 83866,33,0,33,0,-1.0687383824306096
ZCTA5 16253,33,0,33,0,-1.0687383824306096
ZCTA5 19435,33,0,33,0,-1.0687383824306096
ZCTA5 19511,33,0,33,0,-1.0687383824306096
ZCTA5 18035,33,0,33,0,-1.0687383824306096
ZCTA5 22579,33,0,33,0,-1.0687383824306096
ZCTA5 25048,33,0,33,0,-1.0687383824306096
ZCTA5 24843,33,0,33,0,-1.0687383824306096
ZCTA5 95984,33,0,33,0,-1.0687383824306096
ZCTA5 98536,33,0,33,0,-1.0687383824306096
ZCTA5 48453,1990,58,1932,0.02914572864321608,-1.0688527282978586
ZCTA5 79565,82,1,81,0.012195121951219513,-1.0705710816995349
ZCTA5 58631,520,13,507,0.025,-1.0721112962427226
ZCTA5 25070,622,16,606,0.02572347266881029,-1.0722139855637793
ZCTA5 62836,275,6,269,0.02181818181818182,-1.073088961210128
ZCTA5 75948,2533,75,2458,0.029609159099881564,-1.0761858564967082
ZCTA5 77004,13036,414,12622,0.03175820803927585,-1.0768910057894734
ZCTA5 53952,1381,39,1342,0.028240405503258507,-1.077501805887493
ZCTA5 41773,623,16,607,0.025682182985553772,-1.0788067894360458
ZCTA5 60607,12823,407,12416,0.03173984247056071,-1.0796223571814356
ZCTA5 59015,164,3,161,0.018292682926829267,-1.0797647472173406
ZCTA5 47670,4796,147,4649,0.030650542118432027,-1.0797802919691013
ZCTA5 78152,657,17,640,0.0258751902587519,-1.080341664082059
ZCTA5 15338,657,17,640,0.0258751902587519,-1.080341664082059
ZCTA5 15461,1897,55,1842,0.028993147074327884,-1.0805353833005145
ZCTA5 95623,1479,42,1437,0.028397565922920892,-1.081466322855303
ZCTA5 84537,487,12,475,0.024640657084188913,-1.0816346298315582
ZCTA5 90036,18426,590,17836,0.03201997177900792,-1.0827093522060807
ZCTA5 38041,1056,29,1027,0.027462121212121212,-1.0828696914900946
ZCTA5 85264,418,10,408,0.023923444976076555,-1.08362956045867
ZCTA5 74538,1641,47,1594,0.028641072516758074,-1.0842994952955298
ZCTA5 61848,83,1,82,0.012048192771084338,-1.0845232391138402
ZCTA5 28367,34,0,34,0,-1.08481053816747
ZCTA5 35649,34,0,34,0,-1.08481053816747
ZCTA5 38677,34,0,34,0,-1.08481053816747
ZCTA5 40448,34,0,34,0,-1.08481053816747
ZCTA5 42037,34,0,34,0,-1.08481053816747
ZCTA5 43109,34,0,34,0,-1.08481053816747
ZCTA5 48434,34,0,34,0,-1.08481053816747
ZCTA5 48874,34,0,34,0,-1.08481053816747
ZCTA5 50041,34,0,34,0,-1.08481053816747
ZCTA5 51459,34,0,34,0,-1.08481053816747
ZCTA5 57457,34,0,34,0,-1.08481053816747
ZCTA5 59535,34,0,34,0,-1.08481053816747
ZCTA5 57455,34,0,34,0,-1.08481053816747
ZCTA5 63666,34,0,34,0,-1.08481053816747
ZCTA5 68964,34,0,34,0,-1.08481053816747
ZCTA5 67840,34,0,34,0,-1.08481053816747
ZCTA5 72328,34,0,34,0,-1.08481053816747
ZCTA5 72587,34,0,34,0,-1.08481053816747
ZCTA5 75779,34,0,34,0,-1.08481053816747
ZCTA5 78125,34,0,34,0,-1.08481053816747
ZCTA5 87933,34,0,34,0,-1.08481053816747
ZCTA5 84740,34,0,34,0,-1.08481053816747
ZCTA5 82944,34,0,34,0,-1.08481053816747
ZCTA5 00934,34,0,34,0,-1.08481053816747
ZCTA5 06264,34,0,34,0,-1.08481053816747
ZCTA5 12441,34,0,34,0,-1.08481053816747
ZCTA5 12977,34,0,34,0,-1.08481053816747
ZCTA5 13360,34,0,34,0,-1.08481053816747
ZCTA5 17077,34,0,34,0,-1.08481053816747
ZCTA5 18455,34,0,34,0,-1.08481053816747
ZCTA5 24433,34,0,34,0,-1.08481053816747
ZCTA5 97144,34,0,34,0,-1.08481053816747
ZCTA5 99730,34,0,34,0,-1.08481053816747
ZCTA5 76636,556,14,542,0.025179856115107913,-1.0850173922476256
ZCTA5 58494,125,2,123,0.016,-1.0852238502477898
ZCTA5 31016,624,16,608,0.02564102564102564,-1.0853897137580215
ZCTA5 64643,453,11,442,0.024282560706401765,-1.0855792947426168
ZCTA5 73570,453,11,442,0.024282560706401765,-1.0855792947426168
ZCTA5 05769,453,11,442,0.024282560706401765,-1.0855792947426168
ZCTA5 48885,348,8,340,0.022988505747126436,-1.085732555334364
ZCTA5 95975,658,17,641,0.025835866261398176,-1.0867731532910314
ZCTA5 63954,240,5,235,0.020833333333333332,-1.087325679687251
ZCTA5 77435,1545,44,1501,0.0284789644012945,-1.0875402728880499
ZCTA5 03240,488,12,476,0.02459016393442623,-1.0889476215915084
ZCTA5 99156,3610,109,3501,0.030193905817174516,-1.0893817896382976
ZCTA5 22535,203,4,199,0.019704433497536946,-1.0894518685923684
ZCTA5 70714,6883,214,6669,0.03109109399970943,-1.090295713713849
ZCTA5 08880,1578,45,1533,0.028517110266159697,-1.0906665873993093
ZCTA5 38952,165,3,162,0.01818181818181818,-1.0909712248406422
ZCTA5 57255,165,3,162,0.01818181818181818,-1.0909712248406422
ZCTA5 95564,165,3,162,0.01818181818181818,-1.0909712248406422
ZCTA5 64428,313,7,306,0.022364217252396165,-1.091108952694183
ZCTA5 65774,419,10,409,0.02386634844868735,-1.0914244923413923
ZCTA5 57221,277,6,271,0.021660649819494584,-1.0915645135475216
ZCTA5 30002,2791,83,2708,0.029738445001791472,-1.0916813834138246
ZCTA5 72020,1675,48,1627,0.028656716417910448,-1.0919142095140062
ZCTA5 75094,6140,190,5950,0.030944625407166124,-1.0935936558520725
ZCTA5 12993,693,18,675,0.025974025974025976,-1.095076178466086
ZCTA5 12545,1965,57,1908,0.02900763358778626,-1.096160196173003
ZCTA5 74640,126,2,124,0.015873015873015872,-1.097482897621793
ZCTA5 07934,558,14,544,0.025089605734767026,-1.0988228675616727
ZCTA5 75701,12129,384,11745,0.03165965866930497,-1.0991097331224233
ZCTA5 06794,385,9,376,0.023376623376623377,-1.0996430855591832
ZCTA5 54513,204,4,200,0.0196078431372549,-1.0998040115056953
ZCTA5 04453,314,7,307,0.022292993630573247,-1.0998691730855843
ZCTA5 28108,35,0,35,0,-1.100648026100077
ZCTA5 28102,35,0,35,0,-1.100648026100077
ZCTA5 29594,35,0,35,0,-1.100648026100077
ZCTA5 30807,35,0,35,0,-1.100648026100077
ZCTA5 37394,35,0,35,0,-1.100648026100077
ZCTA5 38772,35,0,35,0,-1.100648026100077
ZCTA5 43985,35,0,35,0,-1.100648026100077
ZCTA5 43974,35,0,35,0,-1.100648026100077
ZCTA5 50573,35,0,35,0,-1.100648026100077
ZCTA5 50239,35,0,35,0,-1.100648026100077
ZCTA5 51051,35,0,35,0,-1.100648026100077
ZCTA5 55772,35,0,35,0,-1.100648026100077
ZCTA5 59253,35,0,35,0,-1.100648026100077
ZCTA5 54654,35,0,35,0,-1.100648026100077
ZCTA5 61332,35,0,35,0,-1.100648026100077
ZCTA5 61043,35,0,35,0,-1.100648026100077
ZCTA5 62852,35,0,35,0,-1.100648026100077
ZCTA5 67674,35,0,35,0,-1.100648026100077
ZCTA5 68042,35,0,35,0,-1.100648026100077
ZCTA5 68452,35,0,35,0,-1.100648026100077
ZCTA5 69036,35,0,35,0,-1.100648026100077
ZCTA5 71406,35,0,35,0,-1.100648026100077
ZCTA5 56125,35,0,35,0,-1.100648026100077
ZCTA5 56146,35,0,35,0,-1.100648026100077
ZCTA5 88416,35,0,35,0,-1.100648026100077
ZCTA5 78843,35,0,35,0,-1.100648026100077
ZCTA5 08038,35,0,35,0,-1.100648026100077
ZCTA5 05485,35,0,35,0,-1.100648026100077
ZCTA5 14542,35,0,35,0,-1.100648026100077
ZCTA5 27340,35,0,35,0,-1.100648026100077
ZCTA5 69141,166,3,163,0.018072289156626505,-1.1021199769835919
ZCTA5 83436,166,3,163,0.018072289156626505,-1.1021199769835919
ZCTA5 79261,166,3,163,0.018072289156626505,-1.1021199769835919
ZCTA5 30631,593,15,578,0.025295109612141653,-1.1049302542051929
ZCTA5 81047,593,15,578,0.025295109612141653,-1.1049302542051929
ZCTA5 11411,6270,194,6076,0.03094098883572568,-1.1067115082896961
ZCTA5 59446,242,5,237,0.02066115702479339,-1.1067419313006663
ZCTA5 31602,13178,418,12760,0.03171953255425709,-1.107430505802877
ZCTA5 91350,11458,362,11096,0.0315936463606214,-1.1075702222523593
ZCTA5 69163,386,9,377,0.023316062176165803,-1.107687117098503
ZCTA5 38106,9241,290,8951,0.03138188507737258,-1.1078698135043372
ZCTA5 23169,456,11,445,0.02412280701754386,-1.1081392689848406
ZCTA5 05350,315,7,308,0.022222222222222223,-1.108604323376287
ZCTA5 32217,8377,262,8115,0.0312761131670049,-1.1086448267810562
ZCTA5 50027,127,2,125,0.015748031496062992,-1.1096622482815282
ZCTA5 59820,729,19,710,0.026063100137174212,-1.1097850789892278
ZCTA5 15411,279,6,273,0.021505376344086023,-1.109921321896693
ZCTA5 17086,896,24,872,0.026785714285714284,-1.110062908188902
ZCTA5 73532,205,4,201,0.01951219512195122,-1.1101121231634365
ZCTA5 15960,205,4,201,0.01951219512195122,-1.1101121231634365
ZCTA5 06850,7698,240,7458,0.03117692907248636,-1.1111590149331534
ZCTA5 56574,85,1,84,0.011764705882352941,-1.1120466881378124
ZCTA5 54140,3995,121,3874,0.030287859824780976,-1.1129762051936687
ZCTA5 56034,167,3,164,0.017964071856287425,-1.113211738090884
ZCTA5 74829,167,3,164,0.017964071856287425,-1.113211738090884
ZCTA5 92252,3901,118,3783,0.03024865419123302,-1.1134219946593442
ZCTA5 25671,526,13,513,0.024714828897338403,-1.1146503408038746
ZCTA5 40769,5994,185,5809,0.030864197530864196,-1.1151414782168243
ZCTA5 43738,36,0,36,0,-1.1162608346604284
ZCTA5 47654,36,0,36,0,-1.1162608346604284
ZCTA5 59252,36,0,36,0,-1.1162608346604284
ZCTA5 57741,36,0,36,0,-1.1162608346604284
ZCTA5 61276,36,0,36,0,-1.1162608346604284
ZCTA5 65557,36,0,36,0,-1.1162608346604284
ZCTA5 68734,36,0,36,0,-1.1162608346604284
ZCTA5 71279,36,0,36,0,-1.1162608346604284
ZCTA5 56294,36,0,36,0,-1.1162608346604284
ZCTA5 56389,36,0,36,0,-1.1162608346604284
ZCTA5 74761,36,0,36,0,-1.1162608346604284
ZCTA5 76869,36,0,36,0,-1.1162608346604284
ZCTA5 73855,36,0,36,0,-1.1162608346604284
ZCTA5 01003,36,0,36,0,-1.1162608346604284
ZCTA5 04575,36,0,36,0,-1.1162608346604284
ZCTA5 10915,36,0,36,0,-1.1162608346604284
ZCTA5 13087,36,0,36,0,-1.1162608346604284
ZCTA5 24020,36,0,36,0,-1.1162608346604284
ZCTA5 24411,36,0,36,0,-1.1162608346604284
ZCTA5 93429,36,0,36,0,-1.1162608346604284
ZCTA5 99583,36,0,36,0,-1.1162608346604284
ZCTA5 96136,36,0,36,0,-1.1162608346604284
ZCTA5 77977,243,5,238,0.0205761316872428,-1.1163970311706597
ZCTA5 57018,595,15,580,0.025210084033613446,-1.1183257429541686
ZCTA5 34448,4780,146,4634,0.030543933054393305,-1.118967020871342
ZCTA5 46070,831,22,809,0.026474127557160047,-1.118991170625562
ZCTA5 98323,280,6,274,0.02142857142857143,-1.1190557707662605
ZCTA5 31070,352,8,344,0.022727272727272728,-1.1192105962867123
ZCTA5 65609,352,8,344,0.022727272727272728,-1.1192105962867123
ZCTA5 12765,352,8,344,0.022727272727272728,-1.1192105962867123
ZCTA5 04363,1063,29,1034,0.027281279397930385,-1.1192418550470162
ZCTA5 39654,1971,57,1914,0.0289193302891933,-1.1196337976020763
ZCTA5 60652,13370,424,12946,0.03171278982797308,-1.119804569986274
ZCTA5 78949,206,4,202,0.019417475728155338,-1.1203766612762427
ZCTA5 50586,128,2,126,0.015625,-1.1217632059602403
ZCTA5 05058,128,2,126,0.015625,-1.1217632059602403
ZCTA5 55808,2610,77,2533,0.02950191570881226,-1.122889446369403
ZCTA5 05075,458,11,447,0.024017467248908297,-1.1231035848825575
ZCTA5 27233,1391,39,1352,0.028037383177570093,-1.1235045059603501
ZCTA5 24853,168,3,165,0.017857142857142856,-1.1242472284548701
ZCTA5 69343,1031,28,1003,0.027158098933074686,-1.1242621116822635
ZCTA5 63362,2356,69,2287,0.02928692699490662,-1.124884379948819
ZCTA5 83847,664,17,647,0.025602409638554216,-1.1251712127671842
ZCTA5 74553,493,12,481,0.02434077079107505,-1.1253063852124185
ZCTA5 60928,317,7,310,0.022082018927444796,-1.1260001002225304
ZCTA5 27964,317,7,310,0.022082018927444796,-1.1260001002225304
ZCTA5 18846,353,8,345,0.0226628895184136,-1.127526282739808
ZCTA5 62848,281,6,275,0.021352313167259787,-1.1281612167287427
ZCTA5 38771,1032,28,1004,0.027131782945736434,-1.1295085593673622
ZCTA5 96022,6218,192,6026,0.03087809585075587,-1.1296924938031712
ZCTA5 45002,5128,157,4971,0.03061622464898596,-1.1301948572968068
ZCTA5 42349,459,11,448,0.023965141612200435,-1.1305632590590025
ZCTA5 66514,459,11,448,0.023965141612200435,-1.1305632590590025
ZCTA5 38047,37,0,37,0,-1.1316582631853114
ZCTA5 41052,37,0,37,0,-1.1316582631853114
ZCTA5 44825,37,0,37,0,-1.1316582631853114
ZCTA5 45787,37,0,37,0,-1.1316582631853114
ZCTA5 47344,37,0,37,0,-1.1316582631853114
ZCTA5 50104,37,0,37,0,-1.1316582631853114
ZCTA5 50255,37,0,37,0,-1.1316582631853114
ZCTA5 52701,37,0,37,0,-1.1316582631853114
ZCTA5 52066,37,0,37,0,-1.1316582631853114
ZCTA5 57470,37,0,37,0,-1.1316582631853114
ZCTA5 58058,37,0,37,0,-1.1316582631853114
ZCTA5 59315,37,0,37,0,-1.1316582631853114
ZCTA5 59724,37,0,37,0,-1.1316582631853114
ZCTA5 62070,37,0,37,0,-1.1316582631853114
ZCTA5 62519,37,0,37,0,-1.1316582631853114
ZCTA5 63450,37,0,37,0,-1.1316582631853114
ZCTA5 61468,37,0,37,0,-1.1316582631853114
ZCTA5 62537,37,0,37,0,-1.1316582631853114
ZCTA5 65744,37,0,37,0,-1.1316582631853114
ZCTA5 65564,37,0,37,0,-1.1316582631853114
ZCTA5 67513,37,0,37,0,-1.1316582631853114
ZCTA5 69039,37,0,37,0,-1.1316582631853114
ZCTA5 56056,37,0,37,0,-1.1316582631853114
ZCTA5 71922,37,0,37,0,-1.1316582631853114
ZCTA5 72445,37,0,37,0,-1.1316582631853114
ZCTA5 76469,37,0,37,0,-1.1316582631853114
ZCTA5 77432,37,0,37,0,-1.1316582631853114
ZCTA5 76848,37,0,37,0,-1.1316582631853114
ZCTA5 88436,37,0,37,0,-1.1316582631853114
ZCTA5 79033,37,0,37,0,-1.1316582631853114
ZCTA5 83281,37,0,37,0,-1.1316582631853114
ZCTA5 83223,37,0,37,0,-1.1316582631853114
ZCTA5 84626,37,0,37,0,-1.1316582631853114
ZCTA5 82642,37,0,37,0,-1.1316582631853114
ZCTA5 04613,37,0,37,0,-1.1316582631853114
ZCTA5 14039,37,0,37,0,-1.1316582631853114
ZCTA5 95910,37,0,37,0,-1.1316582631853114
ZCTA5 95720,37,0,37,0,-1.1316582631853114
ZCTA5 97909,37,0,37,0,-1.1316582631853114
ZCTA5 47922,597,15,582,0.02512562814070352,-1.131679433876465
ZCTA5 71640,1295,36,1259,0.027799227799227798,-1.1317025538059158
ZCTA5 72951,389,9,380,0.02313624678663239,-1.1317058984597115
ZCTA5 74083,389,9,380,0.02313624678663239,-1.1317058984597115
ZCTA5 64019,900,24,876,0.02666666666666667,-1.132399151048125
ZCTA5 51638,563,14,549,0.02486678507992895,-1.133136653525777
ZCTA5 39439,1685,48,1637,0.028486646884272996,-1.1339918518075527
ZCTA5 13141,245,5,240,0.02040816326530612,-1.1356027339320411
ZCTA5 12207,934,25,909,0.02676659528907923,-1.1366071541788676
ZCTA5 31011,282,6,276,0.02127659574468085,-1.1372378819912798
ZCTA5 12860,282,6,276,0.02127659574468085,-1.1372378819912798
ZCTA5 81240,1524,43,1481,0.02821522309711286,-1.1373816194917525
ZCTA5 04410,460,11,449,0.02391304347826087,-1.138008038988341
ZCTA5 51035,801,21,780,0.026217228464419477,-1.1390406708735763
ZCTA5 91962,801,21,780,0.026217228464419477,-1.1390406708735763
ZCTA5 64743,87,1,86,0.011494252873563218,-1.1390821327498506
ZCTA5 74358,87,1,86,0.011494252873563218,-1.1390821327498506
ZCTA5 03605,390,9,381,0.023076923076923078,-1.1396747396266904
ZCTA5 98645,495,12,483,0.024242424242424242,-1.1397548024907205
ZCTA5 49639,868,23,845,0.026497695852534562,-1.1397697836982643
ZCTA5 66075,1100,30,1070,0.02727272727272727,-1.1401314210513263
ZCTA5 05860,1100,30,1070,0.02727272727272727,-1.1401314210513263
ZCTA5 01835,5257,161,5096,0.03062583222370173,-1.1404482792600876
ZCTA5 74901,768,20,748,0.026041666666666668,-1.1423871467077855
ZCTA5 40176,355,8,347,0.022535211267605635,-1.144093990851108
ZCTA5 32569,4915,150,4765,0.030518819938962362,-1.1444492788465563
ZCTA5 23950,1265,35,1230,0.02766798418972332,-1.1444761369930005
ZCTA5 85924,1134,31,1103,0.027336860670194002,-1.145607240341158
ZCTA5 68323,130,2,128,0.015384615384615385,-1.1457349960749865
ZCTA5 81221,130,2,128,0.015384615384615385,-1.1457349960749865
ZCTA5 69020,170,3,167,0.01764705882352941,-1.1461522095095702
ZCTA5 39771,38,0,38,0,-1.146848986691097
ZCTA5 41142,38,0,38,0,-1.146848986691097
ZCTA5 42758,38,0,38,0,-1.146848986691097
ZCTA5 42084,38,0,38,0,-1.146848986691097
ZCTA5 45166,38,0,38,0,-1.146848986691097
ZCTA5 50664,38,0,38,0,-1.146848986691097
ZCTA5 58755,38,0,38,0,-1.146848986691097
ZCTA5 59314,38,0,38,0,-1.146848986691097
ZCTA5 59642,38,0,38,0,-1.146848986691097
ZCTA5 58057,38,0,38,0,-1.146848986691097
ZCTA5 57537,38,0,38,0,-1.146848986691097
ZCTA5 63744,38,0,38,0,-1.146848986691097
ZCTA5 65461,38,0,38,0,-1.146848986691097
ZCTA5 68514,38,0,38,0,-1.146848986691097
ZCTA5 71410,38,0,38,0,-1.146848986691097
ZCTA5 56046,38,0,38,0,-1.146848986691097
ZCTA5 77969,38,0,38,0,-1.146848986691097
ZCTA5 78104,38,0,38,0,-1.146848986691097
ZCTA5 83812,38,0,38,0,-1.146848986691097
ZCTA5 84640,38,0,38,0,-1.146848986691097
ZCTA5 87573,38,0,38,0,-1.146848986691097
ZCTA5 04926,38,0,38,0,-1.146848986691097
ZCTA5 02669,38,0,38,0,-1.146848986691097
ZCTA5 14529,38,0,38,0,-1.146848986691097
ZCTA5 13472,38,0,38,0,-1.146848986691097
ZCTA5 16941,38,0,38,0,-1.146848986691097
ZCTA5 18356,38,0,38,0,-1.146848986691097
ZCTA5 18825,38,0,38,0,-1.146848986691097
ZCTA5 25862,38,0,38,0,-1.146848986691097
ZCTA5 25699,38,0,38,0,-1.146848986691097
ZCTA5 26638,38,0,38,0,-1.146848986691097
ZCTA5 94576,38,0,38,0,-1.146848986691097
ZCTA5 04051,391,9,382,0.023017902813299233,-1.1476250448361334
ZCTA5 97525,1818,52,1766,0.028602860286028604,-1.1503399211861232
ZCTA5 42518,1135,31,1104,0.027312775330396475,-1.150624711961103
ZCTA5 76233,1201,33,1168,0.027477102414654453,-1.151936616170731
ZCTA5 35554,462,11,451,0.023809523809523808,-1.1528531978710737
ZCTA5 68041,427,10,417,0.0234192037470726,-1.153178230561642
ZCTA5 54511,566,14,552,0.024734982332155476,-1.1535896226303313
ZCTA5 47451,497,12,485,0.02414486921529175,-1.1541496020253263
ZCTA5 58561,497,12,485,0.02414486921529175,-1.1541496020253263
ZCTA5 99371,171,3,168,0.017543859649122806,-1.1570230732075444
ZCTA5 44662,3570,107,3463,0.02997198879551821,-1.1570670302880244
ZCTA5 54128,635,16,619,0.025196850393700787,-1.157159640936957
ZCTA5 57641,131,2,129,0.015267175572519083,-1.1576082779065746
ZCTA5 77970,131,2,129,0.015267175572519083,-1.1576082779065746
ZCTA5 28349,1235,34,1201,0.027530364372469637,-1.1577192205293965
ZCTA5 47562,1626,46,1580,0.028290282902829027,-1.1579953882569871
ZCTA5 48654,938,25,913,0.026652452025586353,-1.158479234411946
ZCTA5 13646,905,24,881,0.026519337016574586,-1.1601881153345124
ZCTA5 55757,321,7,314,0.021806853582554516,-1.160498266805108
ZCTA5 25878,357,8,349,0.022408963585434174,-1.1605776741484755
ZCTA5 45884,39,0,39,0,-1.16184111302415
ZCTA5 58524,39,0,39,0,-1.16184111302415
ZCTA5 59338,39,0,39,0,-1.16184111302415
ZCTA5 58353,39,0,39,0,-1.16184111302415
ZCTA5 57379,39,0,39,0,-1.16184111302415
ZCTA5 63674,39,0,39,0,-1.16184111302415
ZCTA5 63566,39,0,39,0,-1.16184111302415
ZCTA5 68324,39,0,39,0,-1.16184111302415
ZCTA5 68001,39,0,39,0,-1.16184111302415
ZCTA5 67332,39,0,39,0,-1.16184111302415
ZCTA5 72441,39,0,39,0,-1.16184111302415
ZCTA5 72048,39,0,39,0,-1.16184111302415
ZCTA5 73437,39,0,39,0,-1.16184111302415
ZCTA5 77561,39,0,39,0,-1.16184111302415
ZCTA5 88421,39,0,39,0,-1.16184111302415
ZCTA5 78143,39,0,39,0,-1.16184111302415
ZCTA5 87524,39,0,39,0,-1.16184111302415
ZCTA5 87820,39,0,39,0,-1.16184111302415
ZCTA5 04642,39,0,39,0,-1.16184111302415
ZCTA5 12436,39,0,39,0,-1.16184111302415
ZCTA5 13436,39,0,39,0,-1.16184111302415
ZCTA5 13692,39,0,39,0,-1.16184111302415
ZCTA5 15460,39,0,39,0,-1.16184111302415
ZCTA5 16321,39,0,39,0,-1.16184111302415
ZCTA5 16322,39,0,39,0,-1.16184111302415
ZCTA5 17865,39,0,39,0,-1.16184111302415
ZCTA5 24888,39,0,39,0,-1.16184111302415
ZCTA5 26230,39,0,39,0,-1.16184111302415
ZCTA5 27881,39,0,39,0,-1.16184111302415
ZCTA5 95587,39,0,39,0,-1.16184111302415
ZCTA5 99825,39,0,39,0,-1.16184111302415
ZCTA5 11704,12568,397,12171,0.03158816040738383,-1.1633986971414458
ZCTA5 74572,248,5,243,0.020161290322580645,-1.1641545874868444
ZCTA5 45154,3320,99,3221,0.029819277108433736,-1.1647515257510395
ZCTA5 86326,10352,325,10027,0.031394899536321484,-1.165213221911496
ZCTA5 84736,89,1,88,0.011235955056179775,-1.1656518722810096
ZCTA5 76102,3542,106,3436,0.029926595143986448,-1.1675444755542739
ZCTA5 30734,1368,38,1330,0.027777777777777776,-1.1675746665920685
ZCTA5 96023,464,11,453,0.023706896551724137,-1.1676396200736954
ZCTA5 56081,2368,69,2299,0.029138513513513514,-1.167908583753867
ZCTA5 70129,3068,91,2977,0.029661016949152543,-1.168423482372609
ZCTA5 02807,429,10,419,0.023310023310023312,-1.1684515561387743
ZCTA5 22663,637,16,621,0.02511773940345369,-1.1700842571894572
ZCTA5 78113,1106,30,1076,0.027124773960216998,-1.1705997484360213
ZCTA5 45339,534,13,521,0.024344569288389514,-1.1706764997437038
ZCTA5 58261,534,13,521,0.024344569288389514,-1.1706764997437038
ZCTA5 73729,211,4,207,0.018957345971563982,-1.1710612736399197
ZCTA5 42716,603,15,588,0.024875621890547265,-1.171492767543015
ZCTA5 70373,2497,73,2424,0.02923508209851822,-1.1724630372024416
ZCTA5 51060,286,6,280,0.02097902097902098,-1.1732610912533972
ZCTA5 67454,286,6,280,0.02097902097902098,-1.1732610912533972
ZCTA5 65601,249,5,244,0.020080321285140562,-1.1736046019137134
ZCTA5 77331,2784,82,2702,0.029454022988505746,-1.1737681759182002
ZCTA5 06023,500,12,488,0.024,-1.1756422949755598
ZCTA5 50830,706,18,688,0.025495750708215296,-1.1759710877789216
ZCTA5 37733,40,0,40,0,-1.1766422334558604
ZCTA5 41861,40,0,40,0,-1.1766422334558604
ZCTA5 50454,40,0,40,0,-1.1766422334558604
ZCTA5 52548,40,0,40,0,-1.1766422334558604
ZCTA5 58569,40,0,40,0,-1.1766422334558604
ZCTA5 57041,40,0,40,0,-1.1766422334558604
ZCTA5 59736,40,0,40,0,-1.1766422334558604
ZCTA5 58564,40,0,40,0,-1.1766422334558604
ZCTA5 57420,40,0,40,0,-1.1766422334558604
ZCTA5 57429,40,0,40,0,-1.1766422334558604
ZCTA5 61751,40,0,40,0,-1.1766422334558604
ZCTA5 61027,40,0,40,0,-1.1766422334558604
ZCTA5 63439,40,0,40,0,-1.1766422334558604
ZCTA5 65586,40,0,40,0,-1.1766422334558604
ZCTA5 66838,40,0,40,0,-1.1766422334558604
ZCTA5 66932,40,0,40,0,-1.1766422334558604
ZCTA5 70787,40,0,40,0,-1.1766422334558604
ZCTA5 71952,40,0,40,0,-1.1766422334558604
ZCTA5 71455,40,0,40,0,-1.1766422334558604
ZCTA5 75573,40,0,40,0,-1.1766422334558604
ZCTA5 82711,40,0,40,0,-1.1766422334558604
ZCTA5 88424,40,0,40,0,-1.1766422334558604
ZCTA5 88115,40,0,40,0,-1.1766422334558604
ZCTA5 79534,40,0,40,0,-1.1766422334558604
ZCTA5 88342,40,0,40,0,-1.1766422334558604
ZCTA5 03291,40,0,40,0,-1.1766422334558604
ZCTA5 12924,40,0,40,0,-1.1766422334558604
ZCTA5 13784,40,0,40,0,-1.1766422334558604
ZCTA5 13020,40,0,40,0,-1.1766422334558604
ZCTA5 15316,40,0,40,0,-1.1766422334558604
ZCTA5 17778,40,0,40,0,-1.1766422334558604
ZCTA5 16035,40,0,40,0,-1.1766422334558604
ZCTA5 18913,40,0,40,0,-1.1766422334558604
ZCTA5 21641,40,0,40,0,-1.1766422334558604
ZCTA5 24724,40,0,40,0,-1.1766422334558604
ZCTA5 25876,40,0,40,0,-1.1766422334558604
ZCTA5 23426,40,0,40,0,-1.1766422334558604
ZCTA5 89823,40,0,40,0,-1.1766422334558604
ZCTA5 98616,40,0,40,0,-1.1766422334558604
ZCTA5 98222,40,0,40,0,-1.1766422334558604
ZCTA5 81039,740,19,721,0.025675675675675677,-1.1767358282704794
ZCTA5 82635,90,1,89,0.011111111111111112,-1.1787686433469247
ZCTA5 41749,1305,36,1269,0.027586206896551724,-1.1788584216306113
ZCTA5 40336,4866,148,4718,0.030415125359638306,-1.1789560585302126
ZCTA5 72751,2531,74,2457,0.029237455551165546,-1.179754342366914
ZCTA5 15432,212,4,208,0.018867924528301886,-1.18107359011522
ZCTA5 23966,842,22,820,0.026128266033254157,-1.1821841122782712
ZCTA5 69120,501,12,489,0.023952095808383235,-1.182780222575515
ZCTA5 73009,501,12,489,0.023952095808383235,-1.182780222575515
ZCTA5 16114,250,5,245,0.02,-1.1830214631290534
ZCTA5 79372,431,10,421,0.02320185614849188,-1.183660176768042
ZCTA5 65237,360,8,352,0.022222222222222223,-1.1851478730201175
ZCTA5 18109,6803,210,6593,0.030868734381890344,-1.1859337791722417
ZCTA5 53081,17983,573,17410,0.031863426569537896,-1.1863587048063144
ZCTA5 16843,396,9,387,0.022727272727272728,-1.1871021033152607
ZCTA5 39203,1892,54,1838,0.02854122621564482,-1.1884270343400685
ZCTA5 76571,2693,79,2614,0.029335313776457483,-1.1886837429493426
ZCTA5 03855,977,26,951,0.02661207778915046,-1.1893355180017633
ZCTA5 28644,502,12,490,0.02390438247011952,-1.189905093896343
ZCTA5 34668,19363,618,18745,0.031916541858183135,-1.189934895582861
ZCTA5 45003,213,4,209,0.018779342723004695,-1.19104534384681
ZCTA5 84013,288,6,282,0.020833333333333332,-1.191105604238688
ZCTA5 61441,432,10,422,0.023148148148148147,-1.1912404267232137
ZCTA5 38768,41,0,41,0,-1.191259467618535
ZCTA5 36564,41,0,41,0,-1.191259467618535
ZCTA5 38054,41,0,41,0,-1.191259467618535
ZCTA5 38723,41,0,41,0,-1.191259467618535
ZCTA5 40481,41,0,41,0,-1.191259467618535
ZCTA5 41317,41,0,41,0,-1.191259467618535
ZCTA5 45636,41,0,41,0,-1.191259467618535
ZCTA5 49864,41,0,41,0,-1.191259467618535
ZCTA5 60932,41,0,41,0,-1.191259467618535
ZCTA5 58321,41,0,41,0,-1.191259467618535
ZCTA5 57346,41,0,41,0,-1.191259467618535
ZCTA5 61236,41,0,41,0,-1.191259467618535
ZCTA5 68861,41,0,41,0,-1.191259467618535
ZCTA5 71345,41,0,41,0,-1.191259467618535
ZCTA5 69340,41,0,41,0,-1.191259467618535
ZCTA5 76565,41,0,41,0,-1.191259467618535
ZCTA5 73758,41,0,41,0,-1.191259467618535
ZCTA5 88121,41,0,41,0,-1.191259467618535
ZCTA5 79053,41,0,41,0,-1.191259467618535
ZCTA5 82434,41,0,41,0,-1.191259467618535
ZCTA5 84018,41,0,41,0,-1.191259467618535
ZCTA5 01244,41,0,41,0,-1.191259467618535
ZCTA5 07608,41,0,41,0,-1.191259467618535
ZCTA5 06022,41,0,41,0,-1.191259467618535
ZCTA5 12973,41,0,41,0,-1.191259467618535
ZCTA5 15691,41,0,41,0,-1.191259467618535
ZCTA5 89834,41,0,41,0,-1.191259467618535
ZCTA5 97758,41,0,41,0,-1.191259467618535
ZCTA5 97751,41,0,41,0,-1.191259467618535
ZCTA5 99605,41,0,41,0,-1.191259467618535
ZCTA5 33031,1925,55,1870,0.02857142857142857,-1.1913772379223364
ZCTA5 47345,537,13,524,0.024208566108007448,-1.1914869790144893
ZCTA5 55924,537,13,524,0.024208566108007448,-1.1914869790144893
ZCTA5 21640,537,13,524,0.024208566108007448,-1.1914869790144893
ZCTA5 47982,91,1,90,0.01098901098901099,-1.191776655959361
ZCTA5 67632,91,1,90,0.01098901098901099,-1.191776655959361
ZCTA5 97350,91,1,90,0.01098901098901099,-1.191776655959361
ZCTA5 59485,251,5,246,0.0199203187250996,-1.1924054546075749
ZCTA5 64161,134,2,132,0.014925373134328358,-1.192791749549705
ZCTA5 94574,3614,108,3506,0.029883785279468732,-1.1936634300403788
ZCTA5 75440,2567,75,2492,0.0292169848071679,-1.193882704381263
ZCTA5 29512,6122,188,5934,0.03070891865403463,-1.1945503947273708
ZCTA5 74333,397,9,388,0.022670025188916875,-1.194943324049899
ZCTA5 04605,6029,185,5844,0.030685022391773096,-1.195760877487909
ZCTA5 45312,503,12,491,0.02385685884691849,-1.197016965624861
ZCTA5 35575,433,10,423,0.023094688221709007,-1.1988047440003833
ZCTA5 38457,289,6,283,0.020761245674740483,-1.1999868158375788
ZCTA5 67450,289,6,283,0.020761245674740483,-1.1999868158375788
ZCTA5 49870,1636,46,1590,0.028117359413202935,-1.200447146064517
ZCTA5 47957,744,19,725,0.025537634408602152,-1.2008510352446504
ZCTA5 79225,362,8,354,0.022099447513812154,-1.2014259050303848
ZCTA5 36278,1863,53,1810,0.02844873859366613,-1.2014839504229564
ZCTA5 78615,398,9,389,0.022613065326633167,-1.2027667114565668
ZCTA5 65566,326,7,319,0.02147239263803681,-1.2030843267576503
ZCTA5 80860,326,7,319,0.02147239263803681,-1.2030843267576503
ZCTA5 76531,1928,55,1873,0.028526970954356846,-1.203161047639323
ZCTA5 75132,504,12,492,0.023809523809523808,-1.2041158940785608
ZCTA5 51645,135,2,133,0.014814814814814815,-1.2043778635512512
ZCTA5 60933,135,2,133,0.014814814814814815,-1.2043778635512512
ZCTA5 74001,135,2,133,0.014814814814814815,-1.2043778635512512
ZCTA5 58778,92,1,91,0.010869565217391304,-1.2046782847569872
ZCTA5 63853,92,1,91,0.010869565217391304,-1.2046782847569872
ZCTA5 80476,92,1,91,0.010869565217391304,-1.2046782847569872
ZCTA5 31623,42,0,42,0,-1.205699503537094
ZCTA5 34661,42,0,42,0,-1.205699503537094
ZCTA5 38943,42,0,42,0,-1.205699503537094
ZCTA5 38738,42,0,42,0,-1.205699503537094
ZCTA5 43927,42,0,42,0,-1.205699503537094
ZCTA5 46595,42,0,42,0,-1.205699503537094
ZCTA5 50520,42,0,42,0,-1.205699503537094
ZCTA5 52312,42,0,42,0,-1.205699503537094
ZCTA5 55036,42,0,42,0,-1.205699503537094
ZCTA5 61426,42,0,42,0,-1.205699503537094
ZCTA5 61424,42,0,42,0,-1.205699503537094
ZCTA5 56020,42,0,42,0,-1.205699503537094
ZCTA5 56668,42,0,42,0,-1.205699503537094
ZCTA5 73050,42,0,42,0,-1.205699503537094
ZCTA5 76930,42,0,42,0,-1.205699503537094
ZCTA5 74535,42,0,42,0,-1.205699503537094
ZCTA5 82081,42,0,42,0,-1.205699503537094
ZCTA5 87824,42,0,42,0,-1.205699503537094
ZCTA5 81138,42,0,42,0,-1.205699503537094
ZCTA5 84313,42,0,42,0,-1.205699503537094
ZCTA5 04992,42,0,42,0,-1.205699503537094
ZCTA5 12504,42,0,42,0,-1.205699503537094
ZCTA5 15476,42,0,42,0,-1.205699503537094
ZCTA5 16217,42,0,42,0,-1.205699503537094
ZCTA5 15781,42,0,42,0,-1.205699503537094
ZCTA5 22538,42,0,42,0,-1.205699503537094
ZCTA5 21790,42,0,42,0,-1.205699503537094
ZCTA5 26296,42,0,42,0,-1.205699503537094
ZCTA5 23163,42,0,42,0,-1.205699503537094
ZCTA5 25180,42,0,42,0,-1.205699503537094
ZCTA5 92332,42,0,42,0,-1.205699503537094
ZCTA5 97736,42,0,42,0,-1.205699503537094
ZCTA5 97732,42,0,42,0,-1.205699503537094
ZCTA5 97903,42,0,42,0,-1.205699503537094
ZCTA5 96108,42,0,42,0,-1.205699503537094
ZCTA5 99566,42,0,42,0,-1.205699503537094
ZCTA5 82721,1080,29,1051,0.026851851851851852,-1.206637151078536
ZCTA5 56661,363,8,355,0.02203856749311295,-1.2095346570305683
ZCTA5 50540,399,9,390,0.022556390977443608,-1.2105723626250295
ZCTA5 60912,215,4,211,0.018604651162790697,-1.2108687736799102
ZCTA5 68925,215,4,211,0.018604651162790697,-1.2108687736799102
ZCTA5 71049,1279,35,1244,0.027365129007036748,-1.2110246328071095
ZCTA5 78160,1671,47,1624,0.028126870137642132,-1.2110581149108062
ZCTA5 82442,327,7,320,0.021406727828746176,-1.211531567250964
ZCTA5 62379,712,18,694,0.025280898876404494,-1.21283931387565
ZCTA5 49683,780,20,760,0.02564102564102564,-1.2135025910209876
ZCTA5 51240,780,20,760,0.02564102564102564,-1.2135025910209876
ZCTA5 43442,435,10,425,0.022988505747126436,-1.2138858995560948
ZCTA5 13820,7687,238,7449,0.030961363340705088,-1.2154693399143734
ZCTA5 67073,136,2,134,0.014705882352941176,-1.2158949303974833
ZCTA5 68717,93,1,92,0.010752688172043012,-1.2174758242914863
ZCTA5 26722,364,8,356,0.02197802197802198,-1.2176233932075036
ZCTA5 43557,949,25,924,0.026343519494204427,-1.218177105902315
ZCTA5 80821,400,9,391,0.0225,-1.2183603738502102
ZCTA5 56271,471,11,460,0.02335456475583864,-1.2189374273047549
ZCTA5 58759,328,7,321,0.021341463414634148,-1.2199558428311443
ZCTA5 40058,43,0,43,0,-1.2199686333952995
ZCTA5 42731,43,0,43,0,-1.2199686333952995
ZCTA5 42102,43,0,43,0,-1.2199686333952995
ZCTA5 48139,43,0,43,0,-1.2199686333952995
ZCTA5 47123,43,0,43,0,-1.2199686333952995
ZCTA5 50467,43,0,43,0,-1.2199686333952995
ZCTA5 53928,43,0,43,0,-1.2199686333952995
ZCTA5 58844,43,0,43,0,-1.2199686333952995
ZCTA5 58029,43,0,43,0,-1.2199686333952995
ZCTA5 64090,43,0,43,0,-1.2199686333952995
ZCTA5 65457,43,0,43,0,-1.2199686333952995
ZCTA5 68747,43,0,43,0,-1.2199686333952995
ZCTA5 69142,43,0,43,0,-1.2199686333952995
ZCTA5 56371,43,0,43,0,-1.2199686333952995
ZCTA5 56755,43,0,43,0,-1.2199686333952995
ZCTA5 70375,43,0,43,0,-1.2199686333952995
ZCTA5 77976,43,0,43,0,-1.2199686333952995
ZCTA5 79091,43,0,43,0,-1.2199686333952995
ZCTA5 78144,43,0,43,0,-1.2199686333952995
ZCTA5 83285,43,0,43,0,-1.2199686333952995
ZCTA5 01229,43,0,43,0,-1.2199686333952995
ZCTA5 82833,43,0,43,0,-1.2199686333952995
ZCTA5 08528,43,0,43,0,-1.2199686333952995
ZCTA5 05031,43,0,43,0,-1.2199686333952995
ZCTA5 12812,43,0,43,0,-1.2199686333952995
ZCTA5 13301,43,0,43,0,-1.2199686333952995
ZCTA5 18230,43,0,43,0,-1.2199686333952995
ZCTA5 17254,43,0,43,0,-1.2199686333952995
ZCTA5 23358,43,0,43,0,-1.2199686333952995
ZCTA5 97722,43,0,43,0,-1.2199686333952995
ZCTA5 93522,43,0,43,0,-1.2199686333952995
ZCTA5 75977,254,5,249,0.01968503937007874,-1.2203629908329587
ZCTA5 49806,216,4,212,0.018518518518518517,-1.2207212399618945
ZCTA5 63852,436,10,426,0.022935779816513763,-1.2214028958528425
ZCTA5 12564,2671,78,2593,0.02920254586297267,-1.2219770816464623
ZCTA5 03745,611,15,596,0.024549918166939442,-1.224010256677022
ZCTA5 95377,9025,281,8744,0.03113573407202216,-1.2248889445789934
ZCTA5 33540,3846,115,3731,0.029901196047841912,-1.2253763952100292
ZCTA5 96047,365,8,357,0.021917808219178082,-1.2256922323505406
ZCTA5 38001,1707,48,1659,0.028119507908611598,-1.2257256751014687
ZCTA5 59639,542,13,529,0.023985239852398525,-1.225934713782571
ZCTA5 45306,917,24,893,0.026172300981461286,-1.2262962791415075
ZCTA5 72135,984,26,958,0.026422764227642278,-1.2266135525178996
ZCTA5 51247,1837,52,1785,0.028307022318998367,-1.226848820865127
ZCTA5 83332,1084,29,1055,0.026752767527675275,-1.2270114979466853
ZCTA5 28103,4036,121,3915,0.02998017839444995,-1.2273753887970433
ZCTA5 97117,255,5,250,0.0196078431372549,-1.2296182658268477
ZCTA5 61842,1217,33,1184,0.027115858668857847,-1.229666781043416
ZCTA5 46016,7010,216,6794,0.030813124108416547,-1.2297339197104535
ZCTA5 98036,14517,459,14058,0.03161810291382517,-1.2302939831749256
ZCTA5 59450,217,4,213,0.018433179723502304,-1.2305347241010753
ZCTA5 76878,681,17,664,0.024963289280469897,-1.232234891186729
ZCTA5 47462,1546,43,1503,0.0278137128072445,-1.2333555980599737
ZCTA5 84746,366,8,358,0.02185792349726776,-1.233741292187746
ZCTA5 43439,44,0,44,0,-1.2340727855791953
ZCTA5 46045,44,0,44,0,-1.2340727855791953
ZCTA5 49320,44,0,44,0,-1.2340727855791953
ZCTA5 61324,44,0,44,0,-1.2340727855791953
ZCTA5 60536,44,0,44,0,-1.2340727855791953
ZCTA5 63783,44,0,44,0,-1.2340727855791953
ZCTA5 65286,44,0,44,0,-1.2340727855791953
ZCTA5 65766,44,0,44,0,-1.2340727855791953
ZCTA5 71425,44,0,44,0,-1.2340727855791953
ZCTA5 72165,44,0,44,0,-1.2340727855791953
ZCTA5 72670,44,0,44,0,-1.2340727855791953
ZCTA5 81330,44,0,44,0,-1.2340727855791953
ZCTA5 85942,44,0,44,0,-1.2340727855791953
ZCTA5 07842,44,0,44,0,-1.2340727855791953
ZCTA5 05657,44,0,44,0,-1.2340727855791953
ZCTA5 21540,44,0,44,0,-1.2340727855791953
ZCTA5 24581,44,0,44,0,-1.2340727855791953
ZCTA5 25160,44,0,44,0,-1.2340727855791953
ZCTA5 27972,44,0,44,0,-1.2340727855791953
ZCTA5 97735,44,0,44,0,-1.2340727855791953
ZCTA5 96751,44,0,44,0,-1.2340727855791953
ZCTA5 99667,44,0,44,0,-1.2340727855791953
ZCTA5 73459,330,7,323,0.021212121212121213,-1.236736100829026
ZCTA5 56088,784,20,764,0.025510204081632654,-1.2369806014028175
ZCTA5 97322,13969,441,13528,0.03156990478917603,-1.2385288422327183
ZCTA5 13155,256,5,251,0.01953125,-1.2388420347765003
ZCTA5 16420,256,5,251,0.01953125,-1.2388420347765003
ZCTA5 76548,10363,324,10039,0.031265077680208433,-1.2393264422612429
ZCTA5 72111,509,12,497,0.023575638506876228,-1.2394183328809758
ZCTA5 13621,218,4,214,0.01834862385321101,-1.2403096066024009
ZCTA5 54519,648,16,632,0.024691358024691357,-1.2405037344672853
ZCTA5 50238,474,11,463,0.023206751054852322,-1.2407096866209344
ZCTA5 76082,6392,196,6196,0.030663329161451813,-1.240877608590983
ZCTA5 85936,1087,29,1058,0.02667893284268629,-1.2422457151021176
ZCTA5 38846,920,24,896,0.02608695652173913,-1.2426962653685787
ZCTA5 51520,95,1,94,0.010526315789473684,-1.2427674346855568
ZCTA5 75252,12402,390,12012,0.031446540880503145,-1.2433965618055662
ZCTA5 51053,439,10,429,0.022779043280182234,-1.2438604945312017
ZCTA5 70638,294,6,288,0.02040816326530612,-1.2439904674782325
ZCTA5 43773,1352,37,1315,0.027366863905325445,-1.2447504579433815
ZCTA5 57028,1352,37,1315,0.027366863905325445,-1.2447504579433815
ZCTA5 02110,1385,38,1347,0.027436823104693142,-1.2453711765306277
ZCTA5 04664,510,12,498,0.023529411764705882,-1.246440764066233
ZCTA5 32445,475,11,464,0.023157894736842106,-1.247939248278685
ZCTA5 38962,45,0,45,0,-1.2480175534606854
ZCTA5 41739,45,0,45,0,-1.2480175534606854
ZCTA5 45630,45,0,45,0,-1.2480175534606854
ZCTA5 45316,45,0,45,0,-1.2480175534606854
ZCTA5 49848,45,0,45,0,-1.2480175534606854
ZCTA5 47997,45,0,45,0,-1.2480175534606854
ZCTA5 50551,45,0,45,0,-1.2480175534606854
ZCTA5 50835,45,0,45,0,-1.2480175534606854
ZCTA5 50652,45,0,45,0,-1.2480175534606854
ZCTA5 49027,45,0,45,0,-1.2480175534606854
ZCTA5 58229,45,0,45,0,-1.2480175534606854
ZCTA5 59343,45,0,45,0,-1.2480175534606854
ZCTA5 59256,45,0,45,0,-1.2480175534606854
ZCTA5 58311,45,0,45,0,-1.2480175534606854
ZCTA5 58007,45,0,45,0,-1.2480175534606854
ZCTA5 61941,45,0,45,0,-1.2480175534606854
ZCTA5 67659,45,0,45,0,-1.2480175534606854
ZCTA5 66862,45,0,45,0,-1.2480175534606854
ZCTA5 67857,45,0,45,0,-1.2480175534606854
ZCTA5 67743,45,0,45,0,-1.2480175534606854
ZCTA5 68375,45,0,45,0,-1.2480175534606854
ZCTA5 68753,45,0,45,0,-1.2480175534606854
ZCTA5 68923,45,0,45,0,-1.2480175534606854
ZCTA5 70575,45,0,45,0,-1.2480175534606854
ZCTA5 76490,45,0,45,0,-1.2480175534606854
ZCTA5 81239,45,0,45,0,-1.2480175534606854
ZCTA5 78142,45,0,45,0,-1.2480175534606854
ZCTA5 78598,45,0,45,0,-1.2480175534606854
ZCTA5 78564,45,0,45,0,-1.2480175534606854
ZCTA5 82243,45,0,45,0,-1.2480175534606854
ZCTA5 87827,45,0,45,0,-1.2480175534606854
ZCTA5 04851,45,0,45,0,-1.2480175534606854
ZCTA5 14756,45,0,45,0,-1.2480175534606854
ZCTA5 15484,45,0,45,0,-1.2480175534606854
ZCTA5 16155,45,0,45,0,-1.2480175534606854
ZCTA5 15621,45,0,45,0,-1.2480175534606854
ZCTA5 25132,45,0,45,0,-1.2480175534606854
ZCTA5 93287,45,0,45,0,-1.2480175534606854
ZCTA5 95736,45,0,45,0,-1.2480175534606854
ZCTA5 68815,257,5,252,0.019455252918287938,-1.2480345601030527
ZCTA5 72956,13329,420,12909,0.031510240828269184,-1.2481307872362746
ZCTA5 97498,752,19,733,0.02526595744680851,-1.2487209097765917
ZCTA5 65802,18918,602,18316,0.03182154561793001,-1.248843862064849
ZCTA5 06118,10245,320,9925,0.031234748657881894,-1.249322074588159
ZCTA5 46035,404,9,395,0.022277227722772276,-1.249337917874504
ZCTA5 76250,404,9,395,0.022277227722772276,-1.249337917874504
ZCTA5 23432,615,15,600,0.024390243902439025,-1.250031229496914
ZCTA5 60113,139,2,137,0.014388489208633094,-1.2500421940750903
ZCTA5 56239,219,4,215,0.0182648401826484,-1.2500462623425106
ZCTA5 18405,1022,27,995,0.026418786692759294,-1.2507809482744903
ZCTA5 64080,4769,144,4625,0.03019500943594045,-1.2516794985855821
ZCTA5 57259,180,3,177,0.016666666666666666,-1.2525283500213467
ZCTA5 56291,180,3,177,0.016666666666666666,-1.2525283500213467
ZCTA5 64832,295,6,289,0.020338983050847456,-1.2527120889393197
ZCTA5 12930,295,6,289,0.020338983050847456,-1.2527120889393197
ZCTA5 59538,1255,34,1221,0.027091633466135457,-1.2534895439388052
ZCTA5 01344,581,14,567,0.024096385542168676,-1.254376571226324
ZCTA5 61857,96,1,95,0.010416666666666666,-1.2552657255440085
ZCTA5 52535,405,9,396,0.022222222222222223,-1.2570391465820077
ZCTA5 12485,685,17,668,0.024817518248175182,-1.2570652802436972
ZCTA5 38348,369,8,361,0.02168021680216802,-1.257770957487197
ZCTA5 47454,2969,87,2882,0.029302795554058604,-1.2579647015256872
ZCTA5 35543,441,10,431,0.022675736961451247,-1.2587551699698227
ZCTA5 81526,2265,65,2200,0.02869757174392936,-1.2589282171508402
ZCTA5 62689,220,4,216,0.01818181818181818,-1.2597450606797609
ZCTA5 91506,7460,230,7230,0.030831099195710455,-1.2599569672529118
ZCTA5 49410,822,21,801,0.025547445255474453,-1.2606659840349945
ZCTA5 65669,822,21,801,0.025547445255474453,-1.2606659840349945
ZCTA5 91765,14937,472,14465,0.03159938407980183,-1.260686806486951
ZCTA5 57656,296,6,290,0.02027027027027027,-1.2614077881644423
ZCTA5 05079,296,6,290,0.02027027027027027,-1.2614077881644423
ZCTA5 56168,333,7,326,0.021021021021021023,-1.261737972083456
ZCTA5 29368,46,0,46,0,-1.2618082213176434
ZCTA5 32356,46,0,46,0,-1.2618082213176434
ZCTA5 30149,46,0,46,0,-1.2618082213176434
ZCTA5 38745,46,0,46,0,-1.2618082213176434
ZCTA5 43805,46,0,46,0,-1.2618082213176434
ZCTA5 48177,46,0,46,0,-1.2618082213176434
ZCTA5 49075,46,0,46,0,-1.2618082213176434
ZCTA5 57256,46,0,46,0,-1.2618082213176434
ZCTA5 58440,46,0,46,0,-1.2618082213176434
ZCTA5 57634,46,0,46,0,-1.2618082213176434
ZCTA5 57755,46,0,46,0,-1.2618082213176434
ZCTA5 57475,46,0,46,0,-1.2618082213176434
ZCTA5 68445,46,0,46,0,-1.2618082213176434
ZCTA5 68667,46,0,46,0,-1.2618082213176434
ZCTA5 56583,46,0,46,0,-1.2618082213176434
ZCTA5 56685,46,0,46,0,-1.2618082213176434
ZCTA5 72108,46,0,46,0,-1.2618082213176434
ZCTA5 72061,46,0,46,0,-1.2618082213176434
ZCTA5 79326,46,0,46,0,-1.2618082213176434
ZCTA5 77326,46,0,46,0,-1.2618082213176434
ZCTA5 81243,46,0,46,0,-1.2618082213176434
ZCTA5 88347,46,0,46,0,-1.2618082213176434
ZCTA5 12720,46,0,46,0,-1.2618082213176434
ZCTA5 14549,46,0,46,0,-1.2618082213176434
ZCTA5 15353,46,0,46,0,-1.2618082213176434
ZCTA5 16213,46,0,46,0,-1.2618082213176434
ZCTA5 15945,46,0,46,0,-1.2618082213176434
ZCTA5 17075,46,0,46,0,-1.2618082213176434
ZCTA5 17933,46,0,46,0,-1.2618082213176434
ZCTA5 26056,46,0,46,0,-1.2618082213176434
ZCTA5 24595,46,0,46,0,-1.2618082213176434
ZCTA5 86343,46,0,46,0,-1.2618082213176434
ZCTA5 98950,46,0,46,0,-1.2618082213176434
ZCTA5 56461,1323,36,1287,0.027210884353741496,-1.2628791543215045
ZCTA5 72626,617,15,602,0.024311183144246355,-1.262983258844519
ZCTA5 55704,406,9,397,0.022167487684729065,-1.2647232968967317
ZCTA5 60511,652,16,636,0.024539877300613498,-1.265836752868628
ZCTA5 42170,583,14,569,0.024013722126929673,-1.2676334001718867
ZCTA5 77984,1587,44,1543,0.027725267800882167,-1.2691969924942075
ZCTA5 05733,2589,75,2514,0.028968713789107765,-1.2692392001101331
ZCTA5 71676,221,4,217,0.01809954751131222,-1.2694063655615924
ZCTA5 99040,297,6,291,0.020202020202020204,-1.270077752683052
ZCTA5 36701,8832,274,8558,0.03102355072463768,-1.270351173469671
ZCTA5 29047,1522,42,1480,0.02759526938239159,-1.2711373701359105
ZCTA5 08070,4934,149,4785,0.030198621807863802,-1.2717373720947907
ZCTA5 04988,790,20,770,0.02531645569620253,-1.2719890317958498
ZCTA5 88047,824,21,803,0.025485436893203883,-1.2720973830361864
ZCTA5 56357,407,9,398,0.022113022113022112,-1.2723904597836915
ZCTA5 45808,141,2,139,0.014184397163120567,-1.2724803570699734
ZCTA5 62976,141,2,139,0.014184397163120567,-1.2724803570699734
ZCTA5 57529,141,2,139,0.014184397163120567,-1.2724803570699734
ZCTA5 56255,141,2,139,0.014184397163120567,-1.2724803570699734
ZCTA5 30667,371,8,363,0.0215633423180593,-1.2736939495396487
ZCTA5 75127,584,14,570,0.023972602739726026,-1.2742461662728546
ZCTA5 66840,260,5,255,0.019230769230769232,-1.27542724930481
ZCTA5 29659,47,0,47,0,-1.2754497877312125
ZCTA5 41517,47,0,47,0,-1.2754497877312125
ZCTA5 43330,47,0,47,0,-1.2754497877312125
ZCTA5 43433,47,0,47,0,-1.2754497877312125
ZCTA5 43446,47,0,47,0,-1.2754497877312125
ZCTA5 42163,47,0,47,0,-1.2754497877312125
ZCTA5 43972,47,0,47,0,-1.2754497877312125
ZCTA5 49952,47,0,47,0,-1.2754497877312125
ZCTA5 47596,47,0,47,0,-1.2754497877312125
ZCTA5 59085,47,0,47,0,-1.2754497877312125
ZCTA5 59217,47,0,47,0,-1.2754497877312125
ZCTA5 59318,47,0,47,0,-1.2754497877312125
ZCTA5 63962,47,0,47,0,-1.2754497877312125
ZCTA5 68315,47,0,47,0,-1.2754497877312125
ZCTA5 68440,47,0,47,0,-1.2754497877312125
ZCTA5 68364,47,0,47,0,-1.2754497877312125
ZCTA5 73743,47,0,47,0,-1.2754497877312125
ZCTA5 74755,47,0,47,0,-1.2754497877312125
ZCTA5 81128,47,0,47,0,-1.2754497877312125
ZCTA5 81081,47,0,47,0,-1.2754497877312125
ZCTA5 01350,47,0,47,0,-1.2754497877312125
ZCTA5 04625,47,0,47,0,-1.2754497877312125
ZCTA5 16730,47,0,47,0,-1.2754497877312125
ZCTA5 15555,47,0,47,0,-1.2754497877312125
ZCTA5 22732,47,0,47,0,-1.2754497877312125
ZCTA5 21653,47,0,47,0,-1.2754497877312125
ZCTA5 25115,47,0,47,0,-1.2754497877312125
ZCTA5 26348,47,0,47,0,-1.2754497877312125
ZCTA5 95325,47,0,47,0,-1.2754497877312125
ZCTA5 93208,47,0,47,0,-1.2754497877312125
ZCTA5 96742,47,0,47,0,-1.2754497877312125
ZCTA5 98364,47,0,47,0,-1.2754497877312125
ZCTA5 41164,4747,143,4604,0.030124289024647144,-1.2758858543660083
ZCTA5 97070,9858,307,9551,0.031142219517143438,-1.2765886770964925
ZCTA5 87553,479,11,468,0.022964509394572025,-1.2767198951548782
ZCTA5 30182,1027,27,1000,0.02629016553067186,-1.2767592930125804
ZCTA5 12979,1027,27,1000,0.02629016553067186,-1.2767592930125804
ZCTA5 14781,791,20,771,0.025284450063211124,-1.2777996832886054
ZCTA5 38339,298,6,292,0.020134228187919462,-1.2787221679756624
ZCTA5 54006,298,6,292,0.020134228187919462,-1.2787221679756624
ZCTA5 69043,222,4,218,0.018018018018018018,-1.2790305356293137
ZCTA5 52257,98,1,97,0.01020408163265306,-1.2799773223555113
ZCTA5 14054,585,14,571,0.023931623931623933,-1.280848552069027
ZCTA5 74562,372,8,364,0.021505376344086023,-1.281626747952722
ZCTA5 31548,7595,234,7361,0.030809743252139567,-1.2816563966095107
ZCTA5 46794,689,17,672,0.02467343976777939,-1.281761780270168
ZCTA5 71259,620,15,605,0.024193548387096774,-1.282339005882681
ZCTA5 58454,183,3,180,0.01639344262295082,-1.2834774870491583
ZCTA5 68367,142,2,140,0.014084507042253521,-1.283604297606482
ZCTA5 47637,480,11,469,0.022916666666666665,-1.2838809690879052
ZCTA5 76649,261,5,256,0.019157088122605363,-1.2844973590624549
ZCTA5 86440,3105,91,3014,0.02930756843800322,-1.2849746715792876
ZCTA5 29322,3201,94,3107,0.02936582318025617,-1.2863588655779137
ZCTA5 41339,4310,129,4181,0.029930394431554524,-1.28652965758085
ZCTA5 54653,336,7,329,0.020833333333333332,-1.2865410942485587
ZCTA5 07927,1624,45,1579,0.02770935960591133,-1.2874721933065831
ZCTA5 56235,223,4,219,0.017937219730941704,-1.2886179243203773
ZCTA5 49411,621,15,606,0.024154589371980676,-1.288771778205501
ZCTA5 29634,48,0,48,0,-1.288946986754069
ZCTA5 32683,48,0,48,0,-1.288946986754069
ZCTA5 47034,48,0,48,0,-1.288946986754069
ZCTA5 48411,48,0,48,0,-1.288946986754069
ZCTA5 50102,48,0,48,0,-1.288946986754069
ZCTA5 49458,48,0,48,0,-1.288946986754069
ZCTA5 52774,48,0,48,0,-1.288946986754069
ZCTA5 87746,48,0,48,0,-1.288946986754069
ZCTA5 59419,48,0,48,0,-1.288946986754069
ZCTA5 58430,48,0,48,0,-1.288946986754069
ZCTA5 61057,48,0,48,0,-1.288946986754069
ZCTA5 67482,48,0,48,0,-1.288946986754069
ZCTA5 76884,48,0,48,0,-1.288946986754069
ZCTA5 79503,48,0,48,0,-1.288946986754069
ZCTA5 81084,48,0,48,0,-1.288946986754069
ZCTA5 04683,48,0,48,0,-1.288946986754069
ZCTA5 08858,48,0,48,0,-1.288946986754069
ZCTA5 14169,48,0,48,0,-1.288946986754069
ZCTA5 14134,48,0,48,0,-1.288946986754069
ZCTA5 12742,48,0,48,0,-1.288946986754069
ZCTA5 15379,48,0,48,0,-1.288946986754069
ZCTA5 15532,48,0,48,0,-1.288946986754069
ZCTA5 15921,48,0,48,0,-1.288946986754069
ZCTA5 24826,48,0,48,0,-1.288946986754069
ZCTA5 97911,48,0,48,0,-1.288946986754069
ZCTA5 55970,373,8,365,0.021447721179624665,-1.2895405624685992
ZCTA5 38921,1592,44,1548,0.02763819095477387,-1.2905161309522997
ZCTA5 55321,1853,52,1801,0.028062601187263895,-1.2906913550549166
ZCTA5 97344,481,11,470,0.02286902286902287,-1.2910285312781191
ZCTA5 85708,1230,33,1197,0.026829268292682926,-1.2921125477026296
ZCTA5 59727,99,1,98,0.010101010101010102,-1.292194455386054
ZCTA5 67459,99,1,98,0.010101010101010102,-1.292194455386054
ZCTA5 17080,99,1,98,0.010101010101010102,-1.292194455386054
ZCTA5 58601,10548,329,10219,0.03119074706105423,-1.2927934590654135
ZCTA5 68522,4407,132,4275,0.029952348536419333,-1.2928213449426287
ZCTA5 61358,143,2,141,0.013986013986013986,-1.2946660334951485
ZCTA5 79229,143,2,141,0.013986013986013986,-1.2946660334951485
ZCTA5 39641,1396,38,1358,0.027220630372492838,-1.295227657628304
ZCTA5 43778,410,9,401,0.02195121951219512,-1.295290922634818
ZCTA5 16353,1131,30,1101,0.026525198938992044,-1.2958900962353979
ZCTA5 03457,300,6,294,0.02,-1.2959350827370972
ZCTA5 38774,760,19,741,0.025,-1.296119355825564
ZCTA5 95678,16437,520,15917,0.031635943298655475,-1.2964071250459954
ZCTA5 74956,657,16,641,0.0243531202435312,-1.2973020589034077
ZCTA5 16161,374,8,366,0.0213903743315508,-1.2974355027604456
ZCTA5 12592,482,11,471,0.022821576763485476,-1.2981626426772903
ZCTA5 60942,2437,70,2367,0.028723840787853918,-1.2986423575948514
ZCTA5 17052,623,15,608,0.024077046548956663,-1.3016088094245266
ZCTA5 30449,49,0,49,0,-1.302304307103833
ZCTA5 33924,49,0,49,0,-1.302304307103833
ZCTA5 50847,49,0,49,0,-1.302304307103833
ZCTA5 55968,49,0,49,0,-1.302304307103833
ZCTA5 59432,49,0,49,0,-1.302304307103833
ZCTA5 59013,49,0,49,0,-1.302304307103833
ZCTA5 54207,49,0,49,0,-1.302304307103833
ZCTA5 58620,49,0,49,0,-1.302304307103833
ZCTA5 58281,49,0,49,0,-1.302304307103833
ZCTA5 58372,49,0,49,0,-1.302304307103833
ZCTA5 68380,49,0,49,0,-1.302304307103833
ZCTA5 67049,49,0,49,0,-1.302304307103833
ZCTA5 72339,49,0,49,0,-1.302304307103833
ZCTA5 72838,49,0,49,0,-1.302304307103833
ZCTA5 73851,49,0,49,0,-1.302304307103833
ZCTA5 88338,49,0,49,0,-1.302304307103833
ZCTA5 88040,49,0,49,0,-1.302304307103833
ZCTA5 81059,49,0,49,0,-1.302304307103833
ZCTA5 05825,49,0,49,0,-1.302304307103833
ZCTA5 10932,49,0,49,0,-1.302304307103833
ZCTA5 10953,49,0,49,0,-1.302304307103833
ZCTA5 17727,49,0,49,0,-1.302304307103833
ZCTA5 26720,49,0,49,0,-1.302304307103833
ZCTA5 93592,49,0,49,0,-1.302304307103833
ZCTA5 54667,1856,52,1804,0.028017241379310345,-1.3026030868660852
ZCTA5 71432,447,10,437,0.02237136465324385,-1.3030759335269761
ZCTA5 49701,483,11,472,0.022774327122153208,-1.3052833638237604
ZCTA5 73951,375,8,367,0.021333333333333333,-1.3053116775464124
ZCTA5 76484,375,8,367,0.021333333333333333,-1.3053116775464124
ZCTA5 58061,144,2,142,0.013888888888888888,-1.3056664563512699
ZCTA5 62556,144,2,142,0.013888888888888888,-1.3056664563512699
ZCTA5 74556,144,2,142,0.013888888888888888,-1.3056664563512699
ZCTA5 04634,830,21,809,0.02530120481927711,-1.3062370801910181
ZCTA5 29541,3303,97,3206,0.029367241901301848,-1.3062396535139291
ZCTA5 57533,864,22,842,0.02546296296296296,-1.3062813113167286
ZCTA5 83211,2052,58,1994,0.028265107212475632,-1.3072161128861177
ZCTA5 55702,225,4,221,0.017777777777777778,-1.307683745899732
ZCTA5 47161,1167,31,1136,0.026563838903170524,-1.3090121212065533
ZCTA5 37338,1333,36,1297,0.02700675168792198,-1.3090897289305974
ZCTA5 82836,448,10,438,0.022321428571428572,-1.3104105231128895
ZCTA5 84044,8076,249,7827,0.030832095096582468,-1.3104472354825003
ZCTA5 44003,1695,47,1648,0.027728613569321534,-1.3109064999790174
ZCTA5 01378,339,7,332,0.02064896755162242,-1.3111492673391063
ZCTA5 87083,264,5,259,0.01893939393939394,-1.3115287788282026
ZCTA5 07645,2858,83,2775,0.029041287613715886,-1.3119715619245267
ZCTA5 75482,9413,292,9121,0.031020928503133965,-1.3128845987413404
ZCTA5 36110,4320,129,4191,0.029861111111111113,-1.3133453688402277
ZCTA5 50103,186,3,183,0.016129032258064516,-1.3140088935009075
ZCTA5 66608,2151,61,2090,0.028358902835890282,-1.3141867269178837
ZCTA5 28552,50,0,50,0,-1.3155260096022408
ZCTA5 33503,50,0,50,0,-1.3155260096022408
ZCTA5 36559,50,0,50,0,-1.3155260096022408
ZCTA5 38077,50,0,50,0,-1.3155260096022408
ZCTA5 43914,50,0,50,0,-1.3155260096022408
ZCTA5 44659,50,0,50,0,-1.3155260096022408
ZCTA5 46047,50,0,50,0,-1.3155260096022408
ZCTA5 49873,50,0,50,0,-1.3155260096022408
ZCTA5 49883,50,0,50,0,-1.3155260096022408
ZCTA5 50038,50,0,50,0,-1.3155260096022408
ZCTA5 49775,50,0,50,0,-1.3155260096022408
ZCTA5 52166,50,0,50,0,-1.3155260096022408
ZCTA5 59214,50,0,50,0,-1.3155260096022408
ZCTA5 59546,50,0,50,0,-1.3155260096022408
ZCTA5 58566,50,0,50,0,-1.3155260096022408
ZCTA5 62261,50,0,50,0,-1.3155260096022408
ZCTA5 68952,50,0,50,0,-1.3155260096022408
ZCTA5 72311,50,0,50,0,-1.3155260096022408
ZCTA5 74459,50,0,50,0,-1.3155260096022408
ZCTA5 83283,50,0,50,0,-1.3155260096022408
ZCTA5 81638,50,0,50,0,-1.3155260096022408
ZCTA5 84113,50,0,50,0,-1.3155260096022408
ZCTA5 01338,50,0,50,0,-1.3155260096022408
ZCTA5 02663,50,0,50,0,-1.3155260096022408
ZCTA5 03233,50,0,50,0,-1.3155260096022408
ZCTA5 16837,50,0,50,0,-1.3155260096022408
ZCTA5 14722,50,0,50,0,-1.3155260096022408
ZCTA5 13341,50,0,50,0,-1.3155260096022408
ZCTA5 25902,50,0,50,0,-1.3155260096022408
ZCTA5 24737,50,0,50,0,-1.3155260096022408
ZCTA5 25908,50,0,50,0,-1.3155260096022408
ZCTA5 89426,50,0,50,0,-1.3155260096022408
ZCTA5 95559,50,0,50,0,-1.3155260096022408
ZCTA5 65622,3370,99,3271,0.02937685459940653,-1.316318112806935
ZCTA5 84522,101,1,100,0.009900990099009901,-1.3163605140708057
ZCTA5 56231,145,2,143,0.013793103448275862,-1.3166064382021998
ZCTA5 27872,226,4,222,0.017699115044247787,-1.317162860530428
ZCTA5 20707,12109,379,11730,0.03129903377652985,-1.3188882639417723
ZCTA5 29516,340,7,333,0.020588235294117647,-1.3193093107106724
ZCTA5 46346,485,11,474,0.02268041237113402,-1.3194848754669837
ZCTA5 75973,1069,28,1041,0.026192703461178673,-1.3203257283024585
ZCTA5 29130,2411,69,2342,0.02861883036084612,-1.320370656890612
ZCTA5 48619,265,5,260,0.018867924528301886,-1.320480416963678
ZCTA5 72055,377,8,369,0.021220159151193633,-1.321008160763932
ZCTA5 06053,13345,419,12926,0.03139752716373174,-1.3212897609660668
ZCTA5 24566,521,12,509,0.023032629558541268,-1.3228702017644882
ZCTA5 73526,901,23,878,0.025527192008879023,-1.3232367153048161
ZCTA5 97435,901,23,878,0.025527192008879023,-1.3232367153048161
ZCTA5 98531,10163,316,9847,0.031093181147299025,-1.32367888992397
ZCTA5 83687,11463,358,11105,0.03123091686295036,-1.3237827197270473
ZCTA5 54462,187,3,184,0.016042780748663103,-1.3240956371959711
ZCTA5 54632,450,10,440,0.022222222222222223,-1.325035603731136
ZCTA5 75650,3373,99,3274,0.029350726356359325,-1.3253426968879372
ZCTA5 99361,765,19,746,0.02483660130718954,-1.3255088076024324
ZCTA5 48613,414,9,405,0.021739130434782608,-1.3255924418461367
ZCTA5 83451,341,7,334,0.020527859237536656,-1.3274482381440624
ZCTA5 13739,341,7,334,0.020527859237536656,-1.3274482381440624
ZCTA5 35452,1104,29,1075,0.026268115942028984,-1.327831476689492
ZCTA5 62663,102,1,101,0.00980392156862745,-1.32831292160202
ZCTA5 67423,102,1,101,0.00980392156862745,-1.32831292160202
ZCTA5 28757,51,0,51,0,-1.3286161430521588
ZCTA5 28109,51,0,51,0,-1.3286161430521588
ZCTA5 43836,51,0,51,0,-1.3286161430521588
ZCTA5 48743,51,0,51,0,-1.3286161430521588
ZCTA5 53192,51,0,51,0,-1.3286161430521588
ZCTA5 52044,51,0,51,0,-1.3286161430521588
ZCTA5 54980,51,0,51,0,-1.3286161430521588
ZCTA5 58744,51,0,51,0,-1.3286161430521588
ZCTA5 62076,51,0,51,0,-1.3286161430521588
ZCTA5 57477,51,0,51,0,-1.3286161430521588
ZCTA5 67953,51,0,51,0,-1.3286161430521588
ZCTA5 67628,51,0,51,0,-1.3286161430521588
ZCTA5 69161,51,0,51,0,-1.3286161430521588
ZCTA5 71276,51,0,51,0,-1.3286161430521588
ZCTA5 80740,51,0,51,0,-1.3286161430521588
ZCTA5 75978,51,0,51,0,-1.3286161430521588
ZCTA5 88051,51,0,51,0,-1.3286161430521588
ZCTA5 83548,51,0,51,0,-1.3286161430521588
ZCTA5 78565,51,0,51,0,-1.3286161430521588
ZCTA5 78670,51,0,51,0,-1.3286161430521588
ZCTA5 80488,51,0,51,0,-1.3286161430521588
ZCTA5 81129,51,0,51,0,-1.3286161430521588
ZCTA5 04109,51,0,51,0,-1.3286161430521588
ZCTA5 14537,51,0,51,0,-1.3286161430521588
ZCTA5 13695,51,0,51,0,-1.3286161430521588
ZCTA5 15053,51,0,51,0,-1.3286161430521588
ZCTA5 21824,51,0,51,0,-1.3286161430521588
ZCTA5 89017,51,0,51,0,-1.3286161430521588
ZCTA5 26298,51,0,51,0,-1.3286161430521588
ZCTA5 97637,51,0,51,0,-1.3286161430521588
ZCTA5 96133,51,0,51,0,-1.3286161430521588
ZCTA5 98939,51,0,51,0,-1.3286161430521588
ZCTA5 03455,936,24,912,0.02564102564102564,-1.3293254853863217
ZCTA5 46058,800,20,780,0.025,-1.3297904007955836
ZCTA5 54870,697,17,680,0.024390243902439025,-1.3307598648942047
ZCTA5 08026,766,19,747,0.024804177545691905,-1.3313653343078904
ZCTA5 74425,487,11,476,0.022587268993839837,-1.3336335423855183
ZCTA5 95421,732,18,714,0.02459016393442623,-1.3336830147582686
ZCTA5 15773,188,3,185,0.015957446808510637,-1.3341380256261328
ZCTA5 96041,1239,33,1206,0.026634382566585957,-1.3349797928059104
ZCTA5 56744,228,4,224,0.017543859649122806,-1.3360151655499677
ZCTA5 72565,267,5,262,0.018726591760299626,-1.338296852337644
ZCTA5 32187,733,18,715,0.02455661664392906,-1.33964463386233
ZCTA5 94947,10358,322,10036,0.031087082448349103,-1.339769172499851
ZCTA5 00693,18405,583,17822,0.03167617495245857,-1.3414700690173338
ZCTA5 30573,52,0,52,0,-1.3415785587201348
ZCTA5 47969,52,0,52,0,-1.3415785587201348
ZCTA5 47457,52,0,52,0,-1.3415785587201348
ZCTA5 52660,52,0,52,0,-1.3415785587201348
ZCTA5 58216,52,0,52,0,-1.3415785587201348
ZCTA5 59467,52,0,52,0,-1.3415785587201348
ZCTA5 87046,52,0,52,0,-1.3415785587201348
ZCTA5 58641,52,0,52,0,-1.3415785587201348
ZCTA5 58363,52,0,52,0,-1.3415785587201348
ZCTA5 57421,52,0,52,0,-1.3415785587201348
ZCTA5 57344,52,0,52,0,-1.3415785587201348
ZCTA5 63849,52,0,52,0,-1.3415785587201348
ZCTA5 63847,52,0,52,0,-1.3415785587201348
ZCTA5 67363,52,0,52,0,-1.3415785587201348
ZCTA5 66946,52,0,52,0,-1.3415785587201348
ZCTA5 68438,52,0,52,0,-1.3415785587201348
ZCTA5 67673,52,0,52,0,-1.3415785587201348
ZCTA5 67018,52,0,52,0,-1.3415785587201348
ZCTA5 67055,52,0,52,0,-1.3415785587201348
ZCTA5 80426,52,0,52,0,-1.3415785587201348
ZCTA5 79021,52,0,52,0,-1.3415785587201348
ZCTA5 79093,52,0,52,0,-1.3415785587201348
ZCTA5 04234,52,0,52,0,-1.3415785587201348
ZCTA5 06091,52,0,52,0,-1.3415785587201348
ZCTA5 08246,52,0,52,0,-1.3415785587201348
ZCTA5 16727,52,0,52,0,-1.3415785587201348
ZCTA5 14732,52,0,52,0,-1.3415785587201348
ZCTA5 15492,52,0,52,0,-1.3415785587201348
ZCTA5 15087,52,0,52,0,-1.3415785587201348
ZCTA5 15334,52,0,52,0,-1.3415785587201348
ZCTA5 15544,52,0,52,0,-1.3415785587201348
ZCTA5 16151,52,0,52,0,-1.3415785587201348
ZCTA5 89311,52,0,52,0,-1.3415785587201348
ZCTA5 75760,1006,26,980,0.02584493041749503,-1.342171228987344
ZCTA5 83334,768,19,749,0.024739583333333332,-1.3430571867232106
ZCTA5 99012,343,7,336,0.02040816326530612,-1.3436632751695998
ZCTA5 54564,189,3,186,0.015873015873015872,-1.3441365503022713
ZCTA5 62357,189,3,186,0.015873015873015872,-1.3441365503022713
ZCTA5 16218,380,8,372,0.021052631578947368,-1.3444148085422283
ZCTA5 28671,229,4,225,0.017467248908296942,-1.3453890090385374
ZCTA5 56651,229,4,225,0.017467248908296942,-1.3453890090385374
ZCTA5 72577,268,5,263,0.018656716417910446,-1.3471621101982068
ZCTA5 49508,14996,472,14524,0.031475060016004267,-1.3478395793530857
ZCTA5 35061,417,9,408,0.02158273381294964,-1.348147280737236
ZCTA5 54827,148,2,146,0.013513513513513514,-1.349072176025275
ZCTA5 56236,148,2,146,0.013513513513513514,-1.349072176025275
ZCTA5 60633,4682,140,4542,0.0299017513882956,-1.3518007701865657
ZCTA5 49768,190,3,187,0.015789473684210527,-1.3540916944278787
ZCTA5 34679,53,0,53,0,-1.3544169235713182
ZCTA5 35477,53,0,53,0,-1.3544169235713182
ZCTA5 40020,53,0,53,0,-1.3544169235713182
ZCTA5 48190,53,0,53,0,-1.3544169235713182
ZCTA5 53702,53,0,53,0,-1.3544169235713182
ZCTA5 59731,53,0,53,0,-1.3544169235713182
ZCTA5 61541,53,0,53,0,-1.3544169235713182
ZCTA5 57547,53,0,53,0,-1.3544169235713182
ZCTA5 67836,53,0,53,0,-1.3544169235713182
ZCTA5 68309,53,0,53,0,-1.3544169235713182
ZCTA5 71452,53,0,53,0,-1.3544169235713182
ZCTA5 76940,53,0,53,0,-1.3544169235713182
ZCTA5 74842,53,0,53,0,-1.3544169235713182
ZCTA5 76263,53,0,53,0,-1.3544169235713182
ZCTA5 78145,53,0,53,0,-1.3544169235713182
ZCTA5 84712,53,0,53,0,-1.3544169235713182
ZCTA5 17730,53,0,53,0,-1.3544169235713182
ZCTA5 15047,53,0,53,0,-1.3544169235713182
ZCTA5 17071,53,0,53,0,-1.3544169235713182
ZCTA5 17251,53,0,53,0,-1.3544169235713182
ZCTA5 23976,53,0,53,0,-1.3544169235713182
ZCTA5 23408,53,0,53,0,-1.3544169235713182
ZCTA5 95604,53,0,53,0,-1.3544169235713182
ZCTA5 96068,53,0,53,0,-1.3544169235713182
ZCTA5 51549,230,4,226,0.017391304347826087,-1.354728407600976
ZCTA5 59934,230,4,226,0.017391304347826087,-1.354728407600976
ZCTA5 15849,490,11,479,0.022448979591836733,-1.3547584848645724
ZCTA5 33827,907,23,884,0.025358324145534728,-1.3559175379643686
ZCTA5 71921,1310,35,1275,0.026717557251908396,-1.3559556763452603
ZCTA5 19547,1739,48,1691,0.027602070155261643,-1.357158447362367
ZCTA5 53933,1277,34,1243,0.02662490211433046,-1.3571810617663396
ZCTA5 55718,1277,34,1243,0.02662490211433046,-1.3571810617663396
ZCTA5 77662,9748,302,9446,0.03098071399261387,-1.358122769613996
ZCTA5 69150,149,2,147,0.013422818791946308,-1.3597787419276495
ZCTA5 67646,345,7,338,0.020289855072463767,-1.3597954258431346
ZCTA5 17214,455,10,445,0.02197802197802198,-1.3613443391029667
ZCTA5 37811,1510,41,1469,0.027152317880794703,-1.361837525848708
ZCTA5 40145,191,3,188,0.015706806282722512,-1.3640039330850946
ZCTA5 68318,191,3,188,0.015706806282722512,-1.3640039330850946
ZCTA5 84535,909,23,886,0.025302530253025302,-1.36676640304715
ZCTA5 28375,54,0,54,0,-1.367134732385654
ZCTA5 41526,54,0,54,0,-1.367134732385654
ZCTA5 49074,54,0,54,0,-1.367134732385654
ZCTA5 58069,54,0,54,0,-1.367134732385654
ZCTA5 61079,54,0,54,0,-1.367134732385654
ZCTA5 63061,54,0,54,0,-1.367134732385654
ZCTA5 62065,54,0,54,0,-1.367134732385654
ZCTA5 65657,54,0,54,0,-1.367134732385654
ZCTA5 66970,54,0,54,0,-1.367134732385654
ZCTA5 67345,54,0,54,0,-1.367134732385654
ZCTA5 70463,54,0,54,0,-1.367134732385654
ZCTA5 76481,54,0,54,0,-1.367134732385654
ZCTA5 76650,54,0,54,0,-1.367134732385654
ZCTA5 88430,54,0,54,0,-1.367134732385654
ZCTA5 88265,54,0,54,0,-1.367134732385654
ZCTA5 79369,54,0,54,0,-1.367134732385654
ZCTA5 80622,54,0,54,0,-1.367134732385654
ZCTA5 02647,54,0,54,0,-1.367134732385654
ZCTA5 10985,54,0,54,0,-1.367134732385654
ZCTA5 15930,54,0,54,0,-1.367134732385654
ZCTA5 19544,54,0,54,0,-1.367134732385654
ZCTA5 19113,54,0,54,0,-1.367134732385654
ZCTA5 18427,54,0,54,0,-1.367134732385654
ZCTA5 26291,54,0,54,0,-1.367134732385654
ZCTA5 67505,1179,31,1148,0.026293469041560644,-1.3673522189964322
ZCTA5 63536,383,8,375,0.020887728459530026,-1.367658257196564
ZCTA5 15747,841,21,820,0.02497027348394768,-1.3682346031288082
ZCTA5 50611,150,2,148,0.013333333333333334,-1.370428952423775
ZCTA5 04657,150,2,148,0.013333333333333334,-1.370428952423775
ZCTA5 12980,528,12,516,0.022727272727272728,-1.3707474378092732
ZCTA5 04250,1808,50,1758,0.02765486725663717,-1.3713366522438886
ZCTA5 37852,978,25,953,0.02556237218813906,-1.3725017015484302
ZCTA5 17565,978,25,953,0.02556237218813906,-1.3725017015484302
ZCTA5 64635,232,4,228,0.017241379310344827,-1.3733051264023308
ZCTA5 45389,192,3,189,0.015625,-1.373873733415591
ZCTA5 73931,192,3,189,0.015625,-1.373873733415591
ZCTA5 79738,106,1,105,0.009433962264150943,-1.3752899635365075
ZCTA5 84316,106,1,105,0.009433962264150943,-1.3752899635365075
ZCTA5 78341,808,20,788,0.024752475247524754,-1.3755507961455637
ZCTA5 02124,18953,600,18353,0.03165725742626497,-1.3757776634893821
ZCTA5 24870,1181,31,1150,0.026248941574936496,-1.377021219403703
ZCTA5 98201,12763,399,12364,0.03126224241949385,-1.3771506616277727
ZCTA5 55338,421,9,412,0.021377672209026127,-1.3779963114747908
ZCTA5 13603,3167,92,3075,0.02904957372908115,-1.3784820323867666
ZCTA5 13464,600,14,586,0.023333333333333334,-1.3786645025190778
ZCTA5 75630,1148,30,1118,0.02613240418118467,-1.3796045951852824
ZCTA5 10021,24996,797,24199,0.0318851016162586,-1.3796287612398268
ZCTA5 31051,55,0,55,0,-1.3797353188688015
ZCTA5 35766,55,0,55,0,-1.3797353188688015
ZCTA5 44661,55,0,55,0,-1.3797353188688015
ZCTA5 53501,55,0,55,0,-1.3797353188688015
ZCTA5 59258,55,0,55,0,-1.3797353188688015
ZCTA5 57758,55,0,55,0,-1.3797353188688015
ZCTA5 58244,55,0,55,0,-1.3797353188688015
ZCTA5 65727,55,0,55,0,-1.3797353188688015
ZCTA5 69135,55,0,55,0,-1.3797353188688015
ZCTA5 68719,55,0,55,0,-1.3797353188688015
ZCTA5 70550,55,0,55,0,-1.3797353188688015
ZCTA5 72169,55,0,55,0,-1.3797353188688015
ZCTA5 75848,55,0,55,0,-1.3797353188688015
ZCTA5 75475,55,0,55,0,-1.3797353188688015
ZCTA5 73556,55,0,55,0,-1.3797353188688015
ZCTA5 80448,55,0,55,0,-1.3797353188688015
ZCTA5 84621,55,0,55,0,-1.3797353188688015
ZCTA5 04492,55,0,55,0,-1.3797353188688015
ZCTA5 08073,55,0,55,0,-1.3797353188688015
ZCTA5 12725,55,0,55,0,-1.3797353188688015
ZCTA5 14041,55,0,55,0,-1.3797353188688015
ZCTA5 17069,55,0,55,0,-1.3797353188688015
ZCTA5 23115,55,0,55,0,-1.3797353188688015
ZCTA5 23091,55,0,55,0,-1.3797353188688015
ZCTA5 21675,55,0,55,0,-1.3797353188688015
ZCTA5 21714,55,0,55,0,-1.3797353188688015
ZCTA5 26203,55,0,55,0,-1.3797353188688015
ZCTA5 89405,55,0,55,0,-1.3797353188688015
ZCTA5 96126,55,0,55,0,-1.3797353188688015
ZCTA5 99571,55,0,55,0,-1.3797353188688015
ZCTA5 02134,8205,252,7953,0.030712979890310785,-1.3808743667372687
ZCTA5 68980,151,2,149,0.013245033112582781,-1.3810235733128686
ZCTA5 67361,740,18,722,0.024324324324324326,-1.3811670798122124
ZCTA5 47963,809,20,789,0.024721878862793572,-1.381241318422714
ZCTA5 63558,272,5,267,0.01838235294117647,-1.382341988395168
ZCTA5 81643,272,5,267,0.01838235294117647,-1.382341988395168
ZCTA5 56145,233,4,229,0.017167381974248927,-1.382543063986386
ZCTA5 25009,458,10,448,0.021834061135371178,-1.3829581843383711
ZCTA5 40211,8829,272,8557,0.030807565975761696,-1.382995908166589
ZCTA5 62093,193,3,190,0.015544041450777202,-1.3837015547964686
ZCTA5 66540,193,3,190,0.015544041450777202,-1.3837015547964686
ZCTA5 84767,193,3,190,0.015544041450777202,-1.3837015547964686
ZCTA5 44817,530,12,518,0.022641509433962263,-1.384321101429023
ZCTA5 04969,530,12,518,0.022641509433962263,-1.384321101429023
ZCTA5 62067,1149,30,1119,0.02610966057441253,-1.3844926239043325
ZCTA5 69218,107,1,106,0.009345794392523364,-1.3868337902859342
ZCTA5 12582,1350,36,1314,0.02666666666666667,-1.3869000526143804
ZCTA5 45663,2430,69,2361,0.028395061728395062,-1.3869061368805564
ZCTA5 54819,1116,29,1087,0.025985663082437275,-1.3875020914909197
ZCTA5 28742,1049,27,1022,0.025738798856053385,-1.3896715944611306
ZCTA5 35216,15117,475,14642,0.031421578355493814,-1.3898343594367977
ZCTA5 39201,273,5,268,0.018315018315018316,-1.3910677669719869
ZCTA5 56170,273,5,268,0.018315018315018316,-1.3910677669719869
ZCTA5 51562,152,2,150,0.013157894736842105,-1.3915633543999024
ZCTA5 71972,152,2,150,0.013157894736842105,-1.3915633543999024
ZCTA5 04497,152,2,150,0.013157894736842105,-1.3915633543999024
ZCTA5 79255,234,4,230,0.017094017094017096,-1.3917477914942558
ZCTA5 32321,1616,44,1572,0.027227722772277228,-1.3919693475353216
ZCTA5 29062,56,0,56,0,-1.3922218658578789
ZCTA5 43142,56,0,56,0,-1.3922218658578789
ZCTA5 43905,56,0,56,0,-1.3922218658578789
ZCTA5 47853,56,0,56,0,-1.3922218658578789
ZCTA5 49903,56,0,56,0,-1.3922218658578789
ZCTA5 54842,56,0,56,0,-1.3922218658578789
ZCTA5 55784,56,0,56,0,-1.3922218658578789
ZCTA5 58478,56,0,56,0,-1.3922218658578789
ZCTA5 57520,56,0,56,0,-1.3922218658578789
ZCTA5 61855,56,0,56,0,-1.3922218658578789
ZCTA5 63458,56,0,56,0,-1.3922218658578789
ZCTA5 64645,56,0,56,0,-1.3922218658578789
ZCTA5 65278,56,0,56,0,-1.3922218658578789
ZCTA5 68934,56,0,56,0,-1.3922218658578789
ZCTA5 67418,56,0,56,0,-1.3922218658578789
ZCTA5 69037,56,0,56,0,-1.3922218658578789
ZCTA5 74943,56,0,56,0,-1.3922218658578789
ZCTA5 77960,56,0,56,0,-1.3922218658578789
ZCTA5 74567,56,0,56,0,-1.3922218658578789
ZCTA5 80801,56,0,56,0,-1.3922218658578789
ZCTA5 80823,56,0,56,0,-1.3922218658578789
ZCTA5 88427,56,0,56,0,-1.3922218658578789
ZCTA5 81426,56,0,56,0,-1.3922218658578789
ZCTA5 81087,56,0,56,0,-1.3922218658578789
ZCTA5 87543,56,0,56,0,-1.3922218658578789
ZCTA5 87064,56,0,56,0,-1.3922218658578789
ZCTA5 84731,56,0,56,0,-1.3922218658578789
ZCTA5 05640,56,0,56,0,-1.3922218658578789
ZCTA5 03890,56,0,56,0,-1.3922218658578789
ZCTA5 07970,56,0,56,0,-1.3922218658578789
ZCTA5 17750,56,0,56,0,-1.3922218658578789
ZCTA5 16211,56,0,56,0,-1.3922218658578789
ZCTA5 15760,56,0,56,0,-1.3922218658578789
ZCTA5 26421,56,0,56,0,-1.3922218658578789
ZCTA5 92259,56,0,56,0,-1.3922218658578789
ZCTA5 26138,56,0,56,0,-1.3922218658578789
ZCTA5 95486,56,0,56,0,-1.3922218658578789
ZCTA5 93554,56,0,56,0,-1.3922218658578789
ZCTA5 49653,811,20,791,0.02466091245376079,-1.392602873353955
ZCTA5 67455,811,20,791,0.02466091245376079,-1.392602873353955
ZCTA5 68649,811,20,791,0.02466091245376079,-1.392602873353955
ZCTA5 76626,423,9,414,0.02127659574468085,-1.3928262635210529
ZCTA5 55782,194,3,191,0.015463917525773196,-1.393487849011332
ZCTA5 04236,1617,44,1573,0.027210884353741496,-1.3961654368152547
ZCTA5 17038,3237,94,3143,0.02903923385851097,-1.3969045402165354
ZCTA5 41348,460,10,450,0.021739130434782608,-1.3972971217793628
ZCTA5 50477,108,1,107,0.009259259259259259,-1.398300373423305
ZCTA5 62077,108,1,107,0.009259259259259259,-1.398300373423305
ZCTA5 61452,108,1,107,0.009259259259259259,-1.398300373423305
ZCTA5 74027,387,8,379,0.020671834625323,-1.3984003820549582
ZCTA5 72411,949,24,925,0.02528977871443625,-1.398699066273073
ZCTA5 35574,743,18,725,0.024226110363391656,-1.3988517197795811
ZCTA5 26574,274,5,269,0.01824817518248175,-1.399766299008617
ZCTA5 61865,568,13,555,0.022887323943661973,-1.4005091703666872
ZCTA5 65653,2434,69,2365,0.028348397699260477,-1.400849974912382
ZCTA5 35634,3972,117,3855,0.02945619335347432,-1.4012532725312876
ZCTA5 46105,709,17,692,0.023977433004231313,-1.4032941970908168
ZCTA5 17830,813,20,793,0.024600246002460024,-1.4039385588308546
ZCTA5 79520,916,23,893,0.025109170305676855,-1.4045633722930355
ZCTA5 36581,57,0,57,0,-1.4045974147105615
ZCTA5 38731,57,0,57,0,-1.4045974147105615
ZCTA5 39177,57,0,57,0,-1.4045974147105615
ZCTA5 43030,57,0,57,0,-1.4045974147105615
ZCTA5 47869,57,0,57,0,-1.4045974147105615
ZCTA5 51451,57,0,57,0,-1.4045974147105615
ZCTA5 49119,57,0,57,0,-1.4045974147105615
ZCTA5 58856,57,0,57,0,-1.4045974147105615
ZCTA5 59851,57,0,57,0,-1.4045974147105615
ZCTA5 58016,57,0,57,0,-1.4045974147105615
ZCTA5 62532,57,0,57,0,-1.4045974147105615
ZCTA5 67159,57,0,57,0,-1.4045974147105615
ZCTA5 56047,57,0,57,0,-1.4045974147105615
ZCTA5 72005,57,0,57,0,-1.4045974147105615
ZCTA5 73555,57,0,57,0,-1.4045974147105615
ZCTA5 79854,57,0,57,0,-1.4045974147105615
ZCTA5 77993,57,0,57,0,-1.4045974147105615
ZCTA5 88112,57,0,57,0,-1.4045974147105615
ZCTA5 83212,57,0,57,0,-1.4045974147105615
ZCTA5 80544,57,0,57,0,-1.4045974147105615
ZCTA5 87939,57,0,57,0,-1.4045974147105615
ZCTA5 05071,57,0,57,0,-1.4045974147105615
ZCTA5 16616,57,0,57,0,-1.4045974147105615
ZCTA5 13362,57,0,57,0,-1.4045974147105615
ZCTA5 15378,57,0,57,0,-1.4045974147105615
ZCTA5 15783,57,0,57,0,-1.4045974147105615
ZCTA5 17944,57,0,57,0,-1.4045974147105615
ZCTA5 16048,57,0,57,0,-1.4045974147105615
ZCTA5 16427,57,0,57,0,-1.4045974147105615
ZCTA5 21626,57,0,57,0,-1.4045974147105615
ZCTA5 96010,57,0,57,0,-1.4045974147105615
ZCTA5 98817,57,0,57,0,-1.4045974147105615
ZCTA5 98583,57,0,57,0,-1.4045974147105615
ZCTA5 33714,7999,245,7754,0.030628828603575447,-1.4052840778611408
ZCTA5 62628,313,6,307,0.019169329073482427,-1.4054426772300275
ZCTA5 25652,569,13,556,0.022847100175746926,-1.407077301366854
ZCTA5 67118,275,5,270,0.01818181818181818,-1.4084377949997715
ZCTA5 29819,675,16,659,0.023703703703703703,-1.4087825173978472
ZCTA5 63369,710,17,693,0.023943661971830985,-1.4092877006299025
ZCTA5 58580,109,1,108,0.009174311926605505,-1.4096911049452878
ZCTA5 66039,236,4,232,0.01694915254237288,-1.4100588047938165
ZCTA5 97843,236,4,232,0.01694915254237288,-1.4100588047938165
ZCTA5 31803,2112,59,2053,0.02793560606060606,-1.4104004168250126
ZCTA5 24579,498,11,487,0.02208835341365462,-1.4105272936074786
ZCTA5 33315,6029,182,5847,0.03018742743406867,-1.4106239392574942
ZCTA5 44621,1818,50,1768,0.027502750275027504,-1.4111931420524726
ZCTA5 39633,462,10,452,0.021645021645021644,-1.4115804401691874
ZCTA5 54840,1982,55,1927,0.027749747729566093,-1.412318605075201
ZCTA5 29923,154,2,152,0.012987012987012988,-1.4124813190645125
ZCTA5 13411,1289,34,1255,0.026377036462373934,-1.4130315724656228
ZCTA5 26764,1720,47,1673,0.02732558139534884,-1.4134923525782601
ZCTA5 72003,314,6,308,0.01910828025477707,-1.4137019670648245
ZCTA5 03456,314,6,308,0.01910828025477707,-1.4137019670648245
ZCTA5 00650,5149,154,4995,0.02990872013983298,-1.4148345643317006
ZCTA5 28637,711,17,694,0.02390998593530239,-1.4152734669726257
ZCTA5 31821,58,0,58,0,-1.4168648739560146
ZCTA5 36568,58,0,58,0,-1.4168648739560146
ZCTA5 41713,58,0,58,0,-1.4168648739560146
ZCTA5 39737,58,0,58,0,-1.4168648739560146
ZCTA5 40844,58,0,58,0,-1.4168648739560146
ZCTA5 54430,58,0,58,0,-1.4168648739560146
ZCTA5 58712,58,0,58,0,-1.4168648739560146
ZCTA5 59484,58,0,58,0,-1.4168648739560146
ZCTA5 58331,58,0,58,0,-1.4168648739560146
ZCTA5 57245,58,0,58,0,-1.4168648739560146
ZCTA5 61374,58,0,58,0,-1.4168648739560146
ZCTA5 63880,58,0,58,0,-1.4168648739560146
ZCTA5 65282,58,0,58,0,-1.4168648739560146
ZCTA5 64165,58,0,58,0,-1.4168648739560146
ZCTA5 66782,58,0,58,0,-1.4168648739560146
ZCTA5 79755,58,0,58,0,-1.4168648739560146
ZCTA5 81248,58,0,58,0,-1.4168648739560146
ZCTA5 08042,58,0,58,0,-1.4168648739560146
ZCTA5 05050,58,0,58,0,-1.4168648739560146
ZCTA5 16328,58,0,58,0,-1.4168648739560146
ZCTA5 16724,58,0,58,0,-1.4168648739560146
ZCTA5 15777,58,0,58,0,-1.4168648739560146
ZCTA5 15467,58,0,58,0,-1.4168648739560146
ZCTA5 17861,58,0,58,0,-1.4168648739560146
ZCTA5 22211,58,0,58,0,-1.4168648739560146
ZCTA5 95978,58,0,58,0,-1.4168648739560146
ZCTA5 93623,58,0,58,0,-1.4168648739560146
ZCTA5 93220,58,0,58,0,-1.4168648739560146
ZCTA5 96074,58,0,58,0,-1.4168648739560146
ZCTA5 98235,58,0,58,0,-1.4168648739560146
ZCTA5 77426,781,19,762,0.024327784891165175,-1.4183755332822718
ZCTA5 83822,781,19,762,0.024327784891165175,-1.4183755332822718
ZCTA5 92587,5593,168,5425,0.030037546933667083,-1.4209955304945927
ZCTA5 27866,390,8,382,0.020512820512820513,-1.4212735681549955
ZCTA5 67354,315,6,309,0.01904761904761905,-1.4219385740797075
ZCTA5 82420,315,6,309,0.01904761904761905,-1.4219385740797075
ZCTA5 95046,1755,48,1707,0.02735042735042735,-1.4220130040783767
ZCTA5 74902,1524,41,1483,0.02690288713910761,-1.422287005495719
ZCTA5 64017,197,3,194,0.015228426395939087,-1.4226019760566324
ZCTA5 60482,4107,121,3986,0.02946189432675919,-1.422835371532926
ZCTA5 01535,1821,50,1771,0.027457440966501923,-1.4231094164076363
ZCTA5 29729,782,19,763,0.024296675191815855,-1.4241212544352306
ZCTA5 01464,2441,69,2372,0.0282671036460467,-1.4251989192788967
ZCTA5 13211,2441,69,2372,0.0282671036460467,-1.4251989192788967
ZCTA5 84066,3917,115,3802,0.02935920347204493,-1.4252751226574651
ZCTA5 83327,277,5,272,0.018050541516245487,-1.4257005085220504
ZCTA5 94610,15327,481,14846,0.031382527565733676,-1.4263403196095326
ZCTA5 38079,1225,32,1193,0.026122448979591838,-1.4270586529431462
ZCTA5 54732,1225,32,1193,0.026122448979591838,-1.4270586529431462
ZCTA5 93651,713,17,696,0.023842917251051893,-1.427221882864447
ZCTA5 14898,643,15,628,0.02332814930015552,-1.4279429213186396
ZCTA5 35545,59,0,59,0,-1.4290270272773686
ZCTA5 37396,59,0,59,0,-1.4290270272773686
ZCTA5 43117,59,0,59,0,-1.4290270272773686
ZCTA5 44610,59,0,59,0,-1.4290270272773686
ZCTA5 43940,59,0,59,0,-1.4290270272773686
ZCTA5 45809,59,0,59,0,-1.4290270272773686
ZCTA5 52334,59,0,59,0,-1.4290270272773686
ZCTA5 54517,59,0,59,0,-1.4290270272773686
ZCTA5 59466,59,0,59,0,-1.4290270272773686
ZCTA5 59463,59,0,59,0,-1.4290270272773686
ZCTA5 61112,59,0,59,0,-1.4290270272773686
ZCTA5 67105,59,0,59,0,-1.4290270272773686
ZCTA5 66518,59,0,59,0,-1.4290270272773686
ZCTA5 56274,59,0,59,0,-1.4290270272773686
ZCTA5 73441,59,0,59,0,-1.4290270272773686
ZCTA5 73901,59,0,59,0,-1.4290270272773686
ZCTA5 78075,59,0,59,0,-1.4290270272773686
ZCTA5 12767,59,0,59,0,-1.4290270272773686
ZCTA5 12964,59,0,59,0,-1.4290270272773686
ZCTA5 15821,59,0,59,0,-1.4290270272773686
ZCTA5 18950,59,0,59,0,-1.4290270272773686
ZCTA5 23441,59,0,59,0,-1.4290270272773686
ZCTA5 25008,59,0,59,0,-1.4290270272773686
ZCTA5 95625,59,0,59,0,-1.4290270272773686
ZCTA5 59829,1023,26,997,0.02541544477028348,-1.4298564390731998
ZCTA5 54849,783,19,764,0.024265644955300127,-1.4298602146406567
ZCTA5 80654,989,25,964,0.025278058645096056,-1.42992186074072
ZCTA5 71073,1057,27,1030,0.02554399243140965,-1.4301817447039462
ZCTA5 66061,21637,686,20951,0.03170494985441605,-1.4309545537914574
ZCTA5 05149,921,23,898,0.0249728555917481,-1.4313972837180877
ZCTA5 66050,818,20,798,0.02444987775061125,-1.4321655035056042
ZCTA5 62362,156,2,154,0.01282051282051282,-1.4331885414636554
ZCTA5 98822,749,18,731,0.02403204272363151,-1.43402485971806
ZCTA5 91040,7263,221,7042,0.030428197714443068,-1.4341596647931663
ZCTA5 83654,644,15,629,0.023291925465838508,-1.4341649791029478
ZCTA5 28401,10350,320,10030,0.030917874396135265,-1.4349830736718965
ZCTA5 97443,784,19,765,0.02423469387755102,-1.4355924327534435
ZCTA5 00682,11902,370,11532,0.031087212233238112,-1.4360785271943266
ZCTA5 19939,2703,77,2626,0.028486866444691086,-1.4361963169144931
ZCTA5 74471,538,12,526,0.022304832713754646,-1.4381574317022736
ZCTA5 56225,317,6,311,0.01892744479495268,-1.4383443508187368
ZCTA5 81073,854,21,833,0.02459016393442623,-1.4405422987532002
ZCTA5 28720,60,0,60,0,-1.44108654088781
ZCTA5 46508,60,0,60,0,-1.44108654088781
ZCTA5 50165,60,0,60,0,-1.44108654088781
ZCTA5 57767,60,0,60,0,-1.44108654088781
ZCTA5 58386,60,0,60,0,-1.44108654088781
ZCTA5 58431,60,0,60,0,-1.44108654088781
ZCTA5 57439,60,0,60,0,-1.44108654088781
ZCTA5 61552,60,0,60,0,-1.44108654088781
ZCTA5 61372,60,0,60,0,-1.44108654088781
ZCTA5 57574,60,0,60,0,-1.44108654088781
ZCTA5 72329,60,0,60,0,-1.44108654088781
ZCTA5 72852,60,0,60,0,-1.44108654088781
ZCTA5 76364,60,0,60,0,-1.44108654088781
ZCTA5 83542,60,0,60,0,-1.44108654088781
ZCTA5 14539,60,0,60,0,-1.44108654088781
ZCTA5 13675,60,0,60,0,-1.44108654088781
ZCTA5 15778,60,0,60,0,-1.44108654088781
ZCTA5 16685,60,0,60,0,-1.44108654088781
ZCTA5 18357,60,0,60,0,-1.44108654088781
ZCTA5 17943,60,0,60,0,-1.44108654088781
ZCTA5 17250,60,0,60,0,-1.44108654088781
ZCTA5 22730,60,0,60,0,-1.44108654088781
ZCTA5 24861,60,0,60,0,-1.44108654088781
ZCTA5 24093,60,0,60,0,-1.44108654088781
ZCTA5 68841,199,3,196,0.01507537688442211,-1.4418117140707065
ZCTA5 74644,199,3,196,0.01507537688442211,-1.4418117140707065
ZCTA5 05072,199,3,196,0.01507537688442211,-1.4418117140707065
ZCTA5 38701,9047,278,8769,0.03072841826019675,-1.4418310812425699
ZCTA5 95668,279,5,274,0.017921146953405017,-1.44285754281768
ZCTA5 50008,393,8,385,0.020356234096692113,-1.4439924229587098
ZCTA5 44864,1396,37,1359,0.02650429799426934,-1.4440679238499825
ZCTA5 77505,8300,254,8046,0.030602409638554217,-1.4448651161449193
ZCTA5 53404,5572,167,5405,0.029971284996410625,-1.4458316619036378
ZCTA5 69147,240,4,236,0.016666666666666666,-1.4462951601049245
ZCTA5 88352,1827,50,1777,0.02736726874657909,-1.4468860814776716
ZCTA5 42629,2122,59,2063,0.027803958529688973,-1.4474602255967517
ZCTA5 73049,2090,58,2032,0.027751196172248804,-1.4499189019478997
ZCTA5 40409,1364,36,1328,0.026392961876832845,-1.4502879047458115
ZCTA5 76259,1861,51,1810,0.027404621171413217,-1.45132613804347
ZCTA5 62908,200,3,197,0.015,-1.4513579279204678
ZCTA5 81244,200,3,197,0.015,-1.4513579279204678
ZCTA5 56683,280,5,275,0.017857142857142856,-1.4513969309418524
ZCTA5 62474,394,8,386,0.02030456852791878,-1.4515315157836963
ZCTA5 37724,1163,30,1133,0.025795356835769563,-1.45250949271972
ZCTA5 51002,1163,30,1133,0.025795356835769563,-1.45250949271972
ZCTA5 58579,576,13,563,0.022569444444444444,-1.4527638964905565
ZCTA5 49050,647,15,632,0.023183925811437404,-1.4527785292873074
ZCTA5 43070,61,0,61,0,-1.4530459703556502
ZCTA5 45336,61,0,61,0,-1.4530459703556502
ZCTA5 45172,61,0,61,0,-1.4530459703556502
ZCTA5 51008,61,0,61,0,-1.4530459703556502
ZCTA5 53195,61,0,61,0,-1.4530459703556502
ZCTA5 53571,61,0,61,0,-1.4530459703556502
ZCTA5 55758,61,0,61,0,-1.4530459703556502
ZCTA5 59733,61,0,61,0,-1.4530459703556502
ZCTA5 57531,61,0,61,0,-1.4530459703556502
ZCTA5 57792,61,0,61,0,-1.4530459703556502
ZCTA5 59542,61,0,61,0,-1.4530459703556502
ZCTA5 62820,61,0,61,0,-1.4530459703556502
ZCTA5 62610,61,0,61,0,-1.4530459703556502
ZCTA5 67521,61,0,61,0,-1.4530459703556502
ZCTA5 64458,61,0,61,0,-1.4530459703556502
ZCTA5 64858,61,0,61,0,-1.4530459703556502
ZCTA5 66741,61,0,61,0,-1.4530459703556502
ZCTA5 68789,61,0,61,0,-1.4530459703556502
ZCTA5 68332,61,0,61,0,-1.4530459703556502
ZCTA5 69132,61,0,61,0,-1.4530459703556502
ZCTA5 70352,61,0,61,0,-1.4530459703556502
ZCTA5 73744,61,0,61,0,-1.4530459703556502
ZCTA5 77458,61,0,61,0,-1.4530459703556502
ZCTA5 78879,61,0,61,0,-1.4530459703556502
ZCTA5 88419,61,0,61,0,-1.4530459703556502
ZCTA5 87831,61,0,61,0,-1.4530459703556502
ZCTA5 15028,61,0,61,0,-1.4530459703556502
ZCTA5 16694,61,0,61,0,-1.4530459703556502
ZCTA5 15934,61,0,61,0,-1.4530459703556502
ZCTA5 24322,61,0,61,0,-1.4530459703556502
ZCTA5 96111,61,0,61,0,-1.4530459703556502
ZCTA5 62355,319,6,313,0.018808777429467086,-1.4546612142363304
ZCTA5 29661,2124,59,2065,0.027777777777777776,-1.4548521856730183
ZCTA5 62949,357,7,350,0.0196078431372549,-1.4549039526776446
ZCTA5 49946,1598,43,1555,0.02690863579474343,-1.455130341306412
ZCTA5 83555,241,4,237,0.016597510373443983,-1.4552755421538222
ZCTA5 46553,1096,28,1068,0.025547445255474453,-1.455691690481617
ZCTA5 13775,718,17,701,0.023676880222841225,-1.4569591691904458
ZCTA5 04757,1265,33,1232,0.02608695652173913,-1.4571905369396252
ZCTA5 64489,753,18,735,0.02390438247011952,-1.457330161192273
ZCTA5 74369,753,18,735,0.02390438247011952,-1.457330161192273
ZCTA5 26134,432,9,423,0.020833333333333332,-1.4588004800771133
ZCTA5 68110,3097,89,3008,0.02873748789150791,-1.4597472415468264
ZCTA5 72364,5641,169,5472,0.029959227087395852,-1.4597925528961453
ZCTA5 54642,823,20,803,0.024301336573511544,-1.4602337726480408
ZCTA5 56065,1063,27,1036,0.02539981185324553,-1.4603770364640798
ZCTA5 74720,201,3,198,0.014925373134328358,-1.4608655778992017
ZCTA5 27873,201,3,198,0.014925373134328358,-1.4608655778992017
ZCTA5 76135,8152,249,7903,0.030544651619234545,-1.460925879101602
ZCTA5 23517,2354,66,2288,0.028037383177570093,-1.4615527109126794
ZCTA5 71950,358,7,351,0.019553072625698324,-1.4627032459951117
ZCTA5 41558,320,6,314,0.01875,-1.4627866738784583
ZCTA5 84501,4884,145,4739,0.029688779688779688,-1.463423847463684
ZCTA5 52765,159,2,157,0.012578616352201259,-1.4638661306046654
ZCTA5 74843,159,2,157,0.012578616352201259,-1.4638661306046654
ZCTA5 61721,242,4,238,0.01652892561983471,-1.4642249892655188
ZCTA5 04923,242,4,238,0.01652892561983471,-1.4642249892655188
ZCTA5 70788,1434,38,1396,0.026499302649930265,-1.4646421528830622
ZCTA5 35033,1233,32,1201,0.025952960259529603,-1.4648076136051638
ZCTA5 28169,62,0,62,0,-1.464907766927868
ZCTA5 36543,62,0,62,0,-1.464907766927868
ZCTA5 44670,62,0,62,0,-1.464907766927868
ZCTA5 45353,62,0,62,0,-1.464907766927868
ZCTA5 45899,62,0,62,0,-1.464907766927868
ZCTA5 50117,62,0,62,0,-1.464907766927868
ZCTA5 58345,62,0,62,0,-1.464907766927868
ZCTA5 64438,62,0,62,0,-1.464907766927868
ZCTA5 65048,62,0,62,0,-1.464907766927868
ZCTA5 66438,62,0,62,0,-1.464907766927868
ZCTA5 70050,62,0,62,0,-1.464907766927868
ZCTA5 67122,62,0,62,0,-1.464907766927868
ZCTA5 71377,62,0,62,0,-1.464907766927868
ZCTA5 72340,62,0,62,0,-1.464907766927868
ZCTA5 76127,62,0,62,0,-1.464907766927868
ZCTA5 76865,62,0,62,0,-1.464907766927868
ZCTA5 83808,62,0,62,0,-1.464907766927868
ZCTA5 82938,62,0,62,0,-1.464907766927868
ZCTA5 13331,62,0,62,0,-1.464907766927868
ZCTA5 14585,62,0,62,0,-1.464907766927868
ZCTA5 18816,62,0,62,0,-1.464907766927868
ZCTA5 21522,62,0,62,0,-1.464907766927868
ZCTA5 25102,62,0,62,0,-1.464907766927868
ZCTA5 25025,62,0,62,0,-1.464907766927868
ZCTA5 26543,62,0,62,0,-1.464907766927868
ZCTA5 89422,62,0,62,0,-1.464907766927868
ZCTA5 97710,62,0,62,0,-1.464907766927868
ZCTA5 99151,62,0,62,0,-1.464907766927868
ZCTA5 98602,62,0,62,0,-1.464907766927868
ZCTA5 42053,2127,59,2068,0.02773859896567936,-1.4659276898411582
ZCTA5 18417,433,9,424,0.020785219399538105,-1.4660556579635253
ZCTA5 62428,1132,29,1103,0.02561837455830389,-1.46613461907242
ZCTA5 45844,1267,33,1234,0.026045777426992895,-1.4664933370336621
ZCTA5 59032,202,3,199,0.01485148514851485,-1.4703350606718295
ZCTA5 78728,9997,308,9689,0.03080924277283185,-1.470702226371044
ZCTA5 14825,321,6,315,0.018691588785046728,-1.470890346710971
ZCTA5 59872,825,20,805,0.024242424242424242,-1.4714171229354946
ZCTA5 62214,507,11,496,0.021696252465483234,-1.472314088280362
ZCTA5 08015,6968,211,6757,0.030281285878300805,-1.472930620856222
ZCTA5 62365,243,4,239,0.01646090534979424,-1.4731437689758589
ZCTA5 28768,3037,87,2950,0.0286466908133026,-1.473364237877588
ZCTA5 40379,1336,35,1301,0.02619760479041916,-1.4750346678842776
ZCTA5 79511,471,10,461,0.021231422505307854,-1.4751808305718
ZCTA5 12967,471,10,461,0.021231422505307854,-1.4751808305718
ZCTA5 49728,115,1,114,0.008695652173913044,-1.476515809262747
ZCTA5 58015,115,1,114,0.008695652173913044,-1.476515809262747
ZCTA5 28616,63,0,63,0,-1.476674283396441
ZCTA5 41135,63,0,63,0,-1.476674283396441
ZCTA5 42631,63,0,63,0,-1.476674283396441
ZCTA5 48870,63,0,63,0,-1.476674283396441
ZCTA5 59848,63,0,63,0,-1.476674283396441
ZCTA5 59071,63,0,63,0,-1.476674283396441
ZCTA5 59469,63,0,63,0,-1.476674283396441
ZCTA5 58043,63,0,63,0,-1.476674283396441
ZCTA5 57473,63,0,63,0,-1.476674283396441
ZCTA5 61831,63,0,63,0,-1.476674283396441
ZCTA5 64022,63,0,63,0,-1.476674283396441
ZCTA5 68403,63,0,63,0,-1.476674283396441
ZCTA5 69355,63,0,63,0,-1.476674283396441
ZCTA5 56363,63,0,63,0,-1.476674283396441
ZCTA5 72321,63,0,63,0,-1.476674283396441
ZCTA5 76955,63,0,63,0,-1.476674283396441
ZCTA5 73731,63,0,63,0,-1.476674283396441
ZCTA5 82215,63,0,63,0,-1.476674283396441
ZCTA5 88268,63,0,63,0,-1.476674283396441
ZCTA5 81646,63,0,63,0,-1.476674283396441
ZCTA5 82731,63,0,63,0,-1.476674283396441
ZCTA5 03883,63,0,63,0,-1.476674283396441
ZCTA5 12722,63,0,63,0,-1.476674283396441
ZCTA5 14588,63,0,63,0,-1.476674283396441
ZCTA5 12858,63,0,63,0,-1.476674283396441
ZCTA5 14545,63,0,63,0,-1.476674283396441
ZCTA5 17256,63,0,63,0,-1.476674283396441
ZCTA5 23409,63,0,63,0,-1.476674283396441
ZCTA5 21718,63,0,63,0,-1.476674283396441
ZCTA5 25204,63,0,63,0,-1.476674283396441
ZCTA5 25047,63,0,63,0,-1.476674283396441
ZCTA5 92060,63,0,63,0,-1.476674283396441
ZCTA5 95930,63,0,63,0,-1.476674283396441
ZCTA5 94950,63,0,63,0,-1.476674283396441
ZCTA5 36376,826,20,806,0.024213075060532687,-1.4769994451680248
ZCTA5 28092,15609,489,15120,0.03132807995387277,-1.4772314683653784
ZCTA5 38925,1303,34,1269,0.026093630084420567,-1.477575594976567
ZCTA5 04758,544,12,532,0.022058823529411766,-1.4780637148575095
ZCTA5 57735,580,13,567,0.022413793103448276,-1.4786458376644045
ZCTA5 97009,2942,84,2858,0.028552005438477225,-1.4786977001585158
ZCTA5 65720,322,6,316,0.018633540372670808,-1.4789723768238128
ZCTA5 28421,508,11,497,0.021653543307086614,-1.479118590699717
ZCTA5 35549,1438,38,1400,0.02642559109874826,-1.4822280165038633
ZCTA5 46784,827,20,807,0.02418379685610641,-1.482575554103205
ZCTA5 66434,1902,52,1850,0.027339642481598318,-1.4829856324467423
ZCTA5 98662,12272,381,11891,0.031046284224250327,-1.4834435124961614
ZCTA5 75163,1237,32,1205,0.025869037995149554,-1.4835961023037274
ZCTA5 64668,652,15,637,0.023006134969325152,-1.483627462223901
ZCTA5 55717,161,2,159,0.012422360248447204,-1.4840699398906774
ZCTA5 83320,284,5,279,0.017605633802816902,-1.4852981764293784
ZCTA5 13354,1439,38,1401,0.02640722724113968,-1.4866172860167004
ZCTA5 97306,12274,381,11893,0.03104122535440769,-1.4866811934887185
ZCTA5 97327,1305,34,1271,0.026053639846743294,-1.4867429652946103
ZCTA5 87022,323,6,317,0.018575851393188854,-1.4870329068614607
ZCTA5 59528,116,1,115,0.008620689655172414,-1.4874114441579893
ZCTA5 64096,436,9,427,0.020642201834862386,-1.487732781525798
ZCTA5 29074,64,0,64,0,-1.4883477795472375
ZCTA5 29844,64,0,64,0,-1.4883477795472375
ZCTA5 46381,64,0,64,0,-1.4883477795472375
ZCTA5 59010,64,0,64,0,-1.4883477795472375
ZCTA5 61419,64,0,64,0,-1.4883477795472375
ZCTA5 65335,64,0,64,0,-1.4883477795472375
ZCTA5 68960,64,0,64,0,-1.4883477795472375
ZCTA5 68724,64,0,64,0,-1.4883477795472375
ZCTA5 72572,64,0,64,0,-1.4883477795472375
ZCTA5 79548,64,0,64,0,-1.4883477795472375
ZCTA5 04227,64,0,64,0,-1.4883477795472375
ZCTA5 12089,64,0,64,0,-1.4883477795472375
ZCTA5 12512,64,0,64,0,-1.4883477795472375
ZCTA5 13441,64,0,64,0,-1.4883477795472375
ZCTA5 15450,64,0,64,0,-1.4883477795472375
ZCTA5 15744,64,0,64,0,-1.4883477795472375
ZCTA5 17767,64,0,64,0,-1.4883477795472375
ZCTA5 17041,64,0,64,0,-1.4883477795472375
ZCTA5 86029,64,0,64,0,-1.4883477795472375
ZCTA5 95601,64,0,64,0,-1.4883477795472375
ZCTA5 95429,64,0,64,0,-1.4883477795472375
ZCTA5 93621,64,0,64,0,-1.4883477795472375
ZCTA5 63877,1339,35,1304,0.026138909634055265,-1.488634003427349
ZCTA5 94703,8729,267,8462,0.030587696185130027,-1.489379579721765
ZCTA5 00723,6253,188,6065,0.030065568527106987,-1.4901775856455588
ZCTA5 78410,9479,291,9188,0.03069944086929001,-1.4915431448665128
ZCTA5 40744,6663,201,6462,0.030166591625393965,-1.4923979756316628
ZCTA5 28134,4356,128,4228,0.02938475665748393,-1.4936448848913388
ZCTA5 57626,362,7,355,0.019337016574585635,-1.4937124758349773
ZCTA5 63874,162,2,160,0.012345679012345678,-1.4940993422588378
ZCTA5 42286,437,9,428,0.020594965675057208,-1.4949292613954956
ZCTA5 54137,474,10,464,0.02109704641350211,-1.4961409059011046
ZCTA5 50590,400,8,392,0.02,-1.496416937741086
ZCTA5 84088,11287,349,10938,0.03092052804110924,-1.4969636473141368
ZCTA5 16655,583,13,570,0.022298456260720412,-1.4979519248162896
ZCTA5 58733,117,1,116,0.008547008547008548,-1.4982410695735957
ZCTA5 68058,117,1,116,0.008547008547008548,-1.4982410695735957
ZCTA5 74522,117,1,116,0.008547008547008548,-1.4982410695735957
ZCTA5 73528,205,3,202,0.014634146341463415,-1.498518379481391
ZCTA5 17221,246,4,242,0.016260162601626018,-1.499718726515104
ZCTA5 32463,65,0,65,0,-1.4999304272272072
ZCTA5 30623,65,0,65,0,-1.4999304272272072
ZCTA5 43553,65,0,65,0,-1.4999304272272072
ZCTA5 51647,65,0,65,0,-1.4999304272272072
ZCTA5 87032,65,0,65,0,-1.4999304272272072
ZCTA5 61750,65,0,65,0,-1.4999304272272072
ZCTA5 62348,65,0,65,0,-1.4999304272272072
ZCTA5 63763,65,0,65,0,-1.4999304272272072
ZCTA5 66830,65,0,65,0,-1.4999304272272072
ZCTA5 68837,65,0,65,0,-1.4999304272272072
ZCTA5 72383,65,0,65,0,-1.4999304272272072
ZCTA5 72074,65,0,65,0,-1.4999304272272072
ZCTA5 81522,65,0,65,0,-1.4999304272272072
ZCTA5 83468,65,0,65,0,-1.4999304272272072
ZCTA5 04226,65,0,65,0,-1.4999304272272072
ZCTA5 12115,65,0,65,0,-1.4999304272272072
ZCTA5 12427,65,0,65,0,-1.4999304272272072
ZCTA5 13404,65,0,65,0,-1.4999304272272072
ZCTA5 15472,65,0,65,0,-1.4999304272272072
ZCTA5 15635,65,0,65,0,-1.4999304272272072
ZCTA5 17210,65,0,65,0,-1.4999304272272072
ZCTA5 22723,65,0,65,0,-1.4999304272272072
ZCTA5 21762,65,0,65,0,-1.4999304272272072
ZCTA5 26615,65,0,65,0,-1.4999304272272072
ZCTA5 26339,65,0,65,0,-1.4999304272272072
ZCTA5 28711,5753,172,5581,0.029897444811402746,-1.500273140014587
ZCTA5 28119,1173,30,1143,0.02557544757033248,-1.5006255195239153
ZCTA5 37857,8047,245,7802,0.030446128992170994,-1.5006359864027548
ZCTA5 18851,286,5,281,0.017482517482517484,-1.502097677283008
ZCTA5 28160,1241,32,1209,0.0257856567284448,-1.5023278059106693
ZCTA5 02601,6353,191,6162,0.030064536439477412,-1.502503500904934
ZCTA5 46570,401,8,393,0.0199501246882793,-1.5038404841671222
ZCTA5 68337,163,2,161,0.012269938650306749,-1.5040812138554052
ZCTA5 73753,163,2,161,0.012269938650306749,-1.5040812138554052
ZCTA5 15550,726,17,709,0.023415977961432508,-1.5041473763861815
ZCTA5 62561,2072,57,2015,0.02750965250965251,-1.5048057056877944
ZCTA5 33948,6826,206,6620,0.030178728391444476,-1.5049659429832292
ZCTA5 42031,1140,29,1111,0.02543859649122807,-1.505062286971575
ZCTA5 71030,691,16,675,0.023154848046309694,-1.5056157571933586
ZCTA5 61375,512,11,501,0.021484375,-1.506217604867972
ZCTA5 79080,206,3,203,0.014563106796116505,-1.5078390370827621
ZCTA5 38754,549,12,537,0.02185792349726776,-1.511018320230974
ZCTA5 28662,66,0,66,0,-1.5114243150620519
ZCTA5 35469,66,0,66,0,-1.5114243150620519
ZCTA5 45870,66,0,66,0,-1.5114243150620519
ZCTA5 53003,66,0,66,0,-1.5114243150620519
ZCTA5 58013,66,0,66,0,-1.5114243150620519
ZCTA5 57337,66,0,66,0,-1.5114243150620519
ZCTA5 61553,66,0,66,0,-1.5114243150620519
ZCTA5 67635,66,0,66,0,-1.5114243150620519
ZCTA5 68975,66,0,66,0,-1.5114243150620519
ZCTA5 69219,66,0,66,0,-1.5114243150620519
ZCTA5 69354,66,0,66,0,-1.5114243150620519
ZCTA5 73764,66,0,66,0,-1.5114243150620519
ZCTA5 75441,66,0,66,0,-1.5114243150620519
ZCTA5 75105,66,0,66,0,-1.5114243150620519
ZCTA5 76888,66,0,66,0,-1.5114243150620519
ZCTA5 02047,66,0,66,0,-1.5114243150620519
ZCTA5 04686,66,0,66,0,-1.5114243150620519
ZCTA5 05664,66,0,66,0,-1.5114243150620519
ZCTA5 06061,66,0,66,0,-1.5114243150620519
ZCTA5 12040,66,0,66,0,-1.5114243150620519
ZCTA5 14130,66,0,66,0,-1.5114243150620519
ZCTA5 12856,66,0,66,0,-1.5114243150620519
ZCTA5 15761,66,0,66,0,-1.5114243150620519
ZCTA5 17010,66,0,66,0,-1.5114243150620519
ZCTA5 25119,66,0,66,0,-1.5114243150620519
ZCTA5 24606,66,0,66,0,-1.5114243150620519
ZCTA5 25942,66,0,66,0,-1.5114243150620519
ZCTA5 97842,66,0,66,0,-1.5114243150620519
ZCTA5 28384,4012,117,3895,0.029162512462612162,-1.5117385868546267
ZCTA5 13111,621,14,607,0.02254428341384863,-1.511932289206173
ZCTA5 95018,2856,81,2775,0.028361344537815126,-1.5135884607866974
ZCTA5 69029,164,2,162,0.012195121951219513,-1.514016143223917
ZCTA5 28693,798,19,779,0.023809523809523808,-1.515145940195191
ZCTA5 97017,1074,27,1047,0.025139664804469275,-1.5153251864439945
ZCTA5 97495,728,17,711,0.023351648351648352,-1.515870278559554
ZCTA5 98241,833,20,813,0.024009603841536616,-1.515902642387142
ZCTA5 65017,440,9,431,0.020454545454545454,-1.5164320185817084
ZCTA5 50108,207,3,204,0.014492753623188406,-1.517123419663333
ZCTA5 72479,550,12,538,0.02181818181818182,-1.5175769625762192
ZCTA5 48213,8087,246,7841,0.03041919129467046,-1.5178325840894555
ZCTA5 46987,403,8,395,0.019851116625310174,-1.518639199685124
ZCTA5 13780,403,8,395,0.019851116625310174,-1.518639199685124
ZCTA5 63534,288,5,283,0.017361111111111112,-1.5187984073731362
ZCTA5 25515,903,22,881,0.024363233665559248,-1.5192156638861851
ZCTA5 33170,3823,111,3712,0.029034789432382944,-1.5196182332834425
ZCTA5 97411,3374,97,3277,0.02874925903971547,-1.5198279250263365
ZCTA5 22427,1245,32,1213,0.02570281124497992,-1.521003126031614
ZCTA5 11954,1380,36,1344,0.02608695652173913,-1.521985877707648
ZCTA5 28350,67,0,67,0,-1.5228314528533984
ZCTA5 29932,67,0,67,0,-1.5228314528533984
ZCTA5 38376,67,0,67,0,-1.5228314528533984
ZCTA5 45147,67,0,67,0,-1.5228314528533984
ZCTA5 53817,67,0,67,0,-1.5228314528533984
ZCTA5 58835,67,0,67,0,-1.5228314528533984
ZCTA5 62809,67,0,67,0,-1.5228314528533984
ZCTA5 64681,67,0,67,0,-1.5228314528533984
ZCTA5 68972,67,0,67,0,-1.5228314528533984
ZCTA5 71414,67,0,67,0,-1.5228314528533984
ZCTA5 72841,67,0,67,0,-1.5228314528533984
ZCTA5 76958,67,0,67,0,-1.5228314528533984
ZCTA5 77367,67,0,67,0,-1.5228314528533984
ZCTA5 82450,67,0,67,0,-1.5228314528533984
ZCTA5 83463,67,0,67,0,-1.5228314528533984
ZCTA5 84516,67,0,67,0,-1.5228314528533984
ZCTA5 07833,67,0,67,0,-1.5228314528533984
ZCTA5 13364,67,0,67,0,-1.5228314528533984
ZCTA5 16416,67,0,67,0,-1.5228314528533984
ZCTA5 19731,67,0,67,0,-1.5228314528533984
ZCTA5 25088,67,0,67,0,-1.5228314528533984
ZCTA5 24831,67,0,67,0,-1.5228314528533984
ZCTA5 26266,67,0,67,0,-1.5228314528533984
ZCTA5 27556,67,0,67,0,-1.5228314528533984
ZCTA5 99121,67,0,67,0,-1.5228314528533984
ZCTA5 77030,4876,144,4732,0.029532403609515995,-1.5229495022478494
ZCTA5 19940,2077,57,2020,0.0274434280211844,-1.5234044309569577
ZCTA5 50544,165,2,163,0.012121212121212121,-1.523904707653098
ZCTA5 59750,165,2,163,0.012121212121212121,-1.523904707653098
ZCTA5 67764,165,2,163,0.012121212121212121,-1.523904707653098
ZCTA5 79713,165,2,163,0.012121212121212121,-1.523904707653098
ZCTA5 92257,551,12,539,0.021778584392014518,-1.524124943996754
ZCTA5 53951,904,22,882,0.024336283185840708,-1.52456287108116
ZCTA5 60919,208,3,205,0.014423076923076924,-1.5263718883004054
ZCTA5 71474,208,3,205,0.014423076923076924,-1.5263718883004054
ZCTA5 30291,8342,254,8088,0.030448333732917766,-1.5267749472170271
ZCTA5 85251,20456,645,19811,0.03153109112240907,-1.5296375009321748
ZCTA5 08904,5608,167,5441,0.029778887303851642,-1.5306196207412497
ZCTA5 49679,479,10,469,0.020876826722338204,-1.5308144688437346
ZCTA5 52235,367,7,360,0.01907356948228883,-1.5320593791601698
ZCTA5 54836,405,8,397,0.019753086419753086,-1.53337398144868
ZCTA5 54756,405,8,397,0.019753086419753086,-1.53337398144868
ZCTA5 61470,166,2,164,0.012048192771084338,-1.5337474734635916
ZCTA5 63882,166,2,164,0.012048192771084338,-1.5337474734635916
ZCTA5 38455,68,0,68,0,-1.5341537756816923
ZCTA5 41201,68,0,68,0,-1.5341537756816923
ZCTA5 47337,68,0,68,0,-1.5341537756816923
ZCTA5 58439,68,0,68,0,-1.5341537756816923
ZCTA5 66930,68,0,68,0,-1.5341537756816923
ZCTA5 70747,68,0,68,0,-1.5341537756816923
ZCTA5 67667,68,0,68,0,-1.5341537756816923
ZCTA5 71677,68,0,68,0,-1.5341537756816923
ZCTA5 71339,68,0,68,0,-1.5341537756816923
ZCTA5 72322,68,0,68,0,-1.5341537756816923
ZCTA5 75934,68,0,68,0,-1.5341537756816923
ZCTA5 77368,68,0,68,0,-1.5341537756816923
ZCTA5 76953,68,0,68,0,-1.5341537756816923
ZCTA5 80310,68,0,68,0,-1.5341537756816923
ZCTA5 82440,68,0,68,0,-1.5341537756816923
ZCTA5 82423,68,0,68,0,-1.5341537756816923
ZCTA5 02637,68,0,68,0,-1.5341537756816923
ZCTA5 04491,68,0,68,0,-1.5341537756816923
ZCTA5 12841,68,0,68,0,-1.5341537756816923
ZCTA5 15861,68,0,68,0,-1.5341537756816923
ZCTA5 16672,68,0,68,0,-1.5341537756816923
ZCTA5 15075,68,0,68,0,-1.5341537756816923
ZCTA5 22948,68,0,68,0,-1.5341537756816923
ZCTA5 23389,68,0,68,0,-1.5341537756816923
ZCTA5 25005,68,0,68,0,-1.5341537756816923
ZCTA5 24848,68,0,68,0,-1.5341537756816923
ZCTA5 97634,68,0,68,0,-1.5341537756816923
ZCTA5 98833,68,0,68,0,-1.5341537756816923
ZCTA5 98832,68,0,68,0,-1.5341537756816923
ZCTA5 98330,68,0,68,0,-1.5341537756816923
ZCTA5 80224,8252,251,8001,0.030416868637905964,-1.5344120057289476
ZCTA5 65068,250,4,246,0.016,-1.534738287231173
ZCTA5 31716,975,24,951,0.024615384615384615,-1.5348358791144558
ZCTA5 60962,290,5,285,0.017241379310344827,-1.5354018082422765
ZCTA5 49927,209,3,206,0.014354066985645933,-1.5355847985594044
ZCTA5 63825,1684,45,1639,0.02672209026128266,-1.536344327537973
ZCTA5 40854,443,9,434,0.020316027088036117,-1.5378062267771786
ZCTA5 43727,443,9,434,0.020316027088036117,-1.5378062267771786
ZCTA5 27946,443,9,434,0.020316027088036117,-1.5378062267771786
ZCTA5 14167,661,15,646,0.0226928895612708,-1.5386187787076329
ZCTA5 98826,3058,87,2971,0.028449967298888164,-1.538947014081703
ZCTA5 27888,872,21,851,0.02408256880733945,-1.5390008722448778
ZCTA5 55031,732,17,715,0.023224043715846996,-1.5392283413149428
ZCTA5 89085,1113,28,1085,0.025157232704402517,-1.5393333937459008
ZCTA5 53801,368,7,361,0.019021739130434784,-1.5396745470975306
ZCTA5 74041,976,24,952,0.02459016393442623,-1.540004495168636
ZCTA5 12594,1585,42,1543,0.026498422712933754,-1.540020599369069
ZCTA5 58365,121,1,120,0.008264462809917356,-1.54092080798495
ZCTA5 68720,121,1,120,0.008264462809917356,-1.54092080798495
ZCTA5 72856,121,1,120,0.008264462809917356,-1.54092080798495
ZCTA5 19549,121,1,120,0.008264462809917356,-1.54092080798495
ZCTA5 50858,330,6,324,0.01818181818181818,-1.5428663023284235
ZCTA5 62919,330,6,324,0.01818181818181818,-1.5428663023284235
ZCTA5 93510,2703,76,2627,0.028116907140214576,-1.5431609299687439
ZCTA5 51333,251,4,247,0.01593625498007968,-1.5434209483526302
ZCTA5 55931,167,2,165,0.011976047904191617,-1.5435449962856287
ZCTA5 72431,167,2,165,0.011976047904191617,-1.5435449962856287
ZCTA5 83232,167,2,165,0.011976047904191617,-1.5435449962856287
ZCTA5 80805,167,2,165,0.011976047904191617,-1.5435449962856287
ZCTA5 72443,1216,31,1185,0.02549342105263158,-1.5437898875417768
ZCTA5 70065,19359,609,18750,0.03145823647915698,-1.5444289895057393
ZCTA5 75063,15903,497,15406,0.03125196503804314,-1.5444578560404414
ZCTA5 54537,210,3,207,0.014285714285714285,-1.5447625006056684
ZCTA5 43968,2671,75,2596,0.028079371022089104,-1.5447874370747343
ZCTA5 98635,733,17,716,0.023192360163710776,-1.5450497042944802
ZCTA5 60084,6183,185,5998,0.029920750444767913,-1.5451396309520722
ZCTA5 28707,69,0,69,0,-1.5453931477385268
ZCTA5 37682,69,0,69,0,-1.5453931477385268
ZCTA5 41621,69,0,69,0,-1.5453931477385268
ZCTA5 44607,69,0,69,0,-1.5453931477385268
ZCTA5 47683,69,0,69,0,-1.5453931477385268
ZCTA5 50673,69,0,69,0,-1.5453931477385268
ZCTA5 49666,69,0,69,0,-1.5453931477385268
ZCTA5 57271,69,0,69,0,-1.5453931477385268
ZCTA5 57738,69,0,69,0,-1.5453931477385268
ZCTA5 57371,69,0,69,0,-1.5453931477385268
ZCTA5 62517,69,0,69,0,-1.5453931477385268
ZCTA5 63330,69,0,69,0,-1.5453931477385268
ZCTA5 67631,69,0,69,0,-1.5453931477385268
ZCTA5 72166,69,0,69,0,-1.5453931477385268
ZCTA5 87583,69,0,69,0,-1.5453931477385268
ZCTA5 82942,69,0,69,0,-1.5453931477385268
ZCTA5 83220,69,0,69,0,-1.5453931477385268
ZCTA5 82332,69,0,69,0,-1.5453931477385268
ZCTA5 12407,69,0,69,0,-1.5453931477385268
ZCTA5 15560,69,0,69,0,-1.5453931477385268
ZCTA5 17576,69,0,69,0,-1.5453931477385268
ZCTA5 15502,69,0,69,0,-1.5453931477385268
ZCTA5 15680,69,0,69,0,-1.5453931477385268
ZCTA5 23313,69,0,69,0,-1.5453931477385268
ZCTA5 26617,69,0,69,0,-1.5453931477385268
ZCTA5 95698,69,0,69,0,-1.5453931477385268
ZCTA5 96110,69,0,69,0,-1.5453931477385268
ZCTA5 96015,69,0,69,0,-1.5453931477385268
ZCTA5 39630,369,7,362,0.018970189701897018,-1.547271888158248
ZCTA5 43046,1487,39,1448,0.026227303295225286,-1.5497921065028055
ZCTA5 91208,5806,173,5633,0.029796761970375472,-1.5498315565360328
ZCTA5 54101,1081,27,1054,0.02497687326549491,-1.550020509400598
ZCTA5 15521,663,15,648,0.02262443438914027,-1.550746993459098
ZCTA5 30821,331,6,325,0.01812688821752266,-1.5507597996986018
ZCTA5 60951,331,6,325,0.01812688821752266,-1.5507597996986018
ZCTA5 76624,734,17,717,0.02316076294277929,-1.5508638492723272
ZCTA5 73938,292,5,287,0.017123287671232876,-1.5519092895365423
ZCTA5 70767,5997,179,5818,0.029848257462064366,-1.5529408609777204
ZCTA5 49631,2413,67,2346,0.027766266058847907,-1.5538179002813914
ZCTA5 58782,211,3,208,0.014218009478672985,-1.5539053393134303
ZCTA5 59643,211,3,208,0.014218009478672985,-1.5539053393134303
ZCTA5 55918,370,7,363,0.01891891891891892,-1.5548515050932863
ZCTA5 68131,5650,168,5482,0.029734513274336283,-1.5548893827441854
ZCTA5 74727,770,18,752,0.023376623376623377,-1.5551301653675949
ZCTA5 06060,875,21,854,0.024,-1.5552285716372858
ZCTA5 53137,628,14,614,0.022292993630573247,-1.5554499014137146
ZCTA5 92242,628,14,614,0.022292993630573247,-1.5554499014137146
ZCTA5 51501,13899,432,13467,0.03108137276063026,-1.5557151342827362
ZCTA5 41766,70,0,70,0,-1.5565513659099053
ZCTA5 52593,70,0,70,0,-1.5565513659099053
ZCTA5 67475,70,0,70,0,-1.5565513659099053
ZCTA5 65501,70,0,70,0,-1.5565513659099053
ZCTA5 67442,70,0,70,0,-1.5565513659099053
ZCTA5 70644,70,0,70,0,-1.5565513659099053
ZCTA5 71865,70,0,70,0,-1.5565513659099053
ZCTA5 75764,70,0,70,0,-1.5565513659099053
ZCTA5 76842,70,0,70,0,-1.5565513659099053
ZCTA5 76887,70,0,70,0,-1.5565513659099053
ZCTA5 77350,70,0,70,0,-1.5565513659099053
ZCTA5 78836,70,0,70,0,-1.5565513659099053
ZCTA5 79003,70,0,70,0,-1.5565513659099053
ZCTA5 80477,70,0,70,0,-1.5565513659099053
ZCTA5 84733,70,0,70,0,-1.5565513659099053
ZCTA5 04964,70,0,70,0,-1.5565513659099053
ZCTA5 06444,70,0,70,0,-1.5565513659099053
ZCTA5 16645,70,0,70,0,-1.5565513659099053
ZCTA5 13774,70,0,70,0,-1.5565513659099053
ZCTA5 16622,70,0,70,0,-1.5565513659099053
ZCTA5 16624,70,0,70,0,-1.5565513659099053
ZCTA5 19564,70,0,70,0,-1.5565513659099053
ZCTA5 18912,70,0,70,0,-1.5565513659099053
ZCTA5 95717,70,0,70,0,-1.5565513659099053
ZCTA5 35973,1185,30,1155,0.02531645569620253,-1.5578620431583199
ZCTA5 70589,1219,31,1188,0.02543068088597211,-1.5578748381583183
ZCTA5 23846,446,9,437,0.020179372197309416,-1.5590537472951698
ZCTA5 90211,3805,110,3695,0.02890932982917214,-1.5590738070813153
ZCTA5 84518,293,5,288,0.017064846416382253,-1.560127492365828
ZCTA5 59468,253,4,249,0.015810276679841896,-1.560701271924105
ZCTA5 56257,253,4,249,0.015810276679841896,-1.560701271924105
ZCTA5 53032,1856,50,1806,0.02693965517241379,-1.560772125186412
ZCTA5 88118,123,1,122,0.008130081300813009,-1.5618916021520186
ZCTA5 17253,123,1,122,0.008130081300813009,-1.5618916021520186
ZCTA5 55363,1657,44,1613,0.026554013277006638,-1.562026332099427
ZCTA5 55367,371,7,364,0.018867924528301886,-1.5624134997555534
ZCTA5 64674,169,2,167,0.011834319526627219,-1.563006483638489
ZCTA5 53578,2644,74,2570,0.02798789712556732,-1.5631169944402608
ZCTA5 32336,557,12,545,0.02154398563734291,-1.5631912755331099
ZCTA5 97603,11639,359,11280,0.03084457427614056,-1.5656959170673077
ZCTA5 65611,877,21,856,0.02394526795895097,-1.5660186921121033
ZCTA5 80751,6603,198,6405,0.029986369831894594,-1.5671039193618483
ZCTA5 29826,71,0,71,0,-1.5676301631299365
ZCTA5 28666,71,0,71,0,-1.5676301631299365
ZCTA5 28342,71,0,71,0,-1.5676301631299365
ZCTA5 30756,71,0,71,0,-1.5676301631299365
ZCTA5 43547,71,0,71,0,-1.5676301631299365
ZCTA5 44690,71,0,71,0,-1.5676301631299365
ZCTA5 58838,71,0,71,0,-1.5676301631299365
ZCTA5 62011,71,0,71,0,-1.5676301631299365
ZCTA5 63758,71,0,71,0,-1.5676301631299365
ZCTA5 65468,71,0,71,0,-1.5676301631299365
ZCTA5 66843,71,0,71,0,-1.5676301631299365
ZCTA5 65660,71,0,71,0,-1.5676301631299365
ZCTA5 69148,71,0,71,0,-1.5676301631299365
ZCTA5 69128,71,0,71,0,-1.5676301631299365
ZCTA5 70391,71,0,71,0,-1.5676301631299365
ZCTA5 71029,71,0,71,0,-1.5676301631299365
ZCTA5 72686,71,0,71,0,-1.5676301631299365
ZCTA5 74463,71,0,71,0,-1.5676301631299365
ZCTA5 75788,71,0,71,0,-1.5676301631299365
ZCTA5 77448,71,0,71,0,-1.5676301631299365
ZCTA5 85343,71,0,71,0,-1.5676301631299365
ZCTA5 12195,71,0,71,0,-1.5676301631299365
ZCTA5 13845,71,0,71,0,-1.5676301631299365
ZCTA5 13834,71,0,71,0,-1.5676301631299365
ZCTA5 15780,71,0,71,0,-1.5676301631299365
ZCTA5 15361,71,0,71,0,-1.5676301631299365
ZCTA5 22946,71,0,71,0,-1.5676301631299365
ZCTA5 25211,71,0,71,0,-1.5676301631299365
ZCTA5 97920,71,0,71,0,-1.5676301631299365
ZCTA5 99176,71,0,71,0,-1.5676301631299365
ZCTA5 63133,3132,89,3043,0.028416347381864625,-1.5679194099355305
ZCTA5 45363,594,13,581,0.021885521885521887,-1.567985202939927
ZCTA5 14138,737,17,720,0.023066485753052916,-1.5682631894491779
ZCTA5 74571,1357,35,1322,0.025792188651436992,-1.5696349465094652
ZCTA5 68651,558,12,546,0.021505376344086023,-1.569665786593377
ZCTA5 42445,4449,130,4319,0.02922004944931445,-1.5706004152120183
ZCTA5 14847,1051,26,1025,0.024738344433872503,-1.5713646871882998
ZCTA5 49884,124,1,123,0.008064516129032258,-1.5722881002335958
ZCTA5 66716,124,1,123,0.008064516129032258,-1.5722881002335958
ZCTA5 55982,170,2,168,0.011764705882352941,-1.5726715083565779
ZCTA5 63781,522,11,511,0.0210727969348659,-1.5731494824335968
ZCTA5 68824,522,11,511,0.0210727969348659,-1.5731494824335968
ZCTA5 84043,16202,506,15696,0.031230712257745957,-1.5739532912232779
ZCTA5 85325,631,14,617,0.022187004754358162,-1.5739667341512307
ZCTA5 54490,373,7,366,0.01876675603217158,-1.5774850252452852
ZCTA5 66939,255,4,251,0.01568627450980392,-1.5778698150351205
ZCTA5 79087,255,4,251,0.01568627450980392,-1.5778698150351205
ZCTA5 05070,255,4,251,0.01568627450980392,-1.5778698150351205
ZCTA5 12878,255,4,251,0.01568627450980392,-1.5778698150351205
ZCTA5 61951,3297,94,3203,0.02851076736427055,-1.5785399474726196
ZCTA5 29331,72,0,72,0,-1.5786312115226886
ZCTA5 38844,72,0,72,0,-1.5786312115226886
ZCTA5 45070,72,0,72,0,-1.5786312115226886
ZCTA5 59440,72,0,72,0,-1.5786312115226886
ZCTA5 55607,72,0,72,0,-1.5786312115226886
ZCTA5 57645,72,0,72,0,-1.5786312115226886
ZCTA5 62514,72,0,72,0,-1.5786312115226886
ZCTA5 67545,72,0,72,0,-1.5786312115226886
ZCTA5 68773,72,0,72,0,-1.5786312115226886
ZCTA5 56328,72,0,72,0,-1.5786312115226886
ZCTA5 70654,72,0,72,0,-1.5786312115226886
ZCTA5 73520,72,0,72,0,-1.5786312115226886
ZCTA5 73658,72,0,72,0,-1.5786312115226886
ZCTA5 83637,72,0,72,0,-1.5786312115226886
ZCTA5 04558,72,0,72,0,-1.5786312115226886
ZCTA5 15454,72,0,72,0,-1.5786312115226886
ZCTA5 17763,72,0,72,0,-1.5786312115226886
ZCTA5 18457,72,0,72,0,-1.5786312115226886
ZCTA5 18323,72,0,72,0,-1.5786312115226886
ZCTA5 26435,72,0,72,0,-1.5786312115226886
ZCTA5 72631,1894,51,1843,0.02692713833157339,-1.5796982400715125
ZCTA5 61327,523,11,512,0.021032504780114723,-1.5797799088805153
ZCTA5 89509,16670,521,16149,0.03125374925014997,-1.5799827305128997
ZCTA5 79543,449,9,440,0.0200445434298441,-1.5801764009007389
ZCTA5 04435,449,9,440,0.0200445434298441,-1.5801764009007389
ZCTA5 64072,214,3,211,0.014018691588785047,-1.5811280469943791
ZCTA5 62997,214,3,211,0.014018691588785047,-1.5811280469943791
ZCTA5 80653,335,6,329,0.01791044776119403,-1.5821322923295198
ZCTA5 62325,171,2,169,0.011695906432748537,-1.5822934109578914
ZCTA5 47611,560,12,548,0.02142857142857143,-1.582583848069523
ZCTA5 68928,125,1,124,0.008,-1.5826265530077994
ZCTA5 81049,125,1,124,0.008,-1.5826265530077994
ZCTA5 58576,412,8,404,0.019417475728155338,-1.5844518693431497
ZCTA5 17765,412,8,404,0.019417475728155338,-1.5844518693431497
ZCTA5 61070,524,11,513,0.02099236641221374,-1.5863991122550865
ZCTA5 13157,256,4,252,0.015625,-1.5864127396400953
ZCTA5 54488,450,9,441,0.02,-1.5871898462386946
ZCTA5 57523,450,9,441,0.02,-1.5871898462386946
ZCTA5 43750,73,0,73,0,-1.5895561253483286
ZCTA5 42321,73,0,73,0,-1.5895561253483286
ZCTA5 53947,73,0,73,0,-1.5895561253483286
ZCTA5 52758,73,0,73,0,-1.5895561253483286
ZCTA5 58737,73,0,73,0,-1.5895561253483286
ZCTA5 58627,73,0,73,0,-1.5895561253483286
ZCTA5 58415,73,0,73,0,-1.5895561253483286
ZCTA5 68834,73,0,73,0,-1.5895561253483286
ZCTA5 56663,73,0,73,0,-1.5895561253483286
ZCTA5 78021,73,0,73,0,-1.5895561253483286
ZCTA5 78391,73,0,73,0,-1.5895561253483286
ZCTA5 83643,73,0,73,0,-1.5895561253483286
ZCTA5 02564,73,0,73,0,-1.5895561253483286
ZCTA5 06390,73,0,73,0,-1.5895561253483286
ZCTA5 15359,73,0,73,0,-1.5895561253483286
ZCTA5 17836,73,0,73,0,-1.5895561253483286
ZCTA5 16835,73,0,73,0,-1.5895561253483286
ZCTA5 18622,73,0,73,0,-1.5895561253483286
ZCTA5 23045,73,0,73,0,-1.5895561253483286
ZCTA5 93603,73,0,73,0,-1.5895561253483286
ZCTA5 10001,12431,384,12047,0.030890515646367953,-1.5896045365502265
ZCTA5 52335,336,6,330,0.017857142857142856,-1.5899256779412405
ZCTA5 52750,215,3,212,0.013953488372093023,-1.590134778932285
ZCTA5 55946,1328,34,1294,0.025602409638554216,-1.5912323890871354
ZCTA5 32011,4999,147,4852,0.029405881176235247,-1.5917861359931944
ZCTA5 63547,172,2,170,0.011627906976744186,-1.5918726974914965
ZCTA5 56726,634,14,620,0.022082018927444796,-1.5924046129681668
ZCTA5 04983,634,14,620,0.022082018927444796,-1.5924046129681668
ZCTA5 84652,297,5,292,0.016835016835016835,-1.5927673184511817
ZCTA5 98925,297,5,292,0.016835016835016835,-1.5927673184511817
ZCTA5 50042,126,1,125,0.007936507936507936,-1.5929078482043055
ZCTA5 56114,126,1,125,0.007936507936507936,-1.5929078482043055
ZCTA5 48157,598,13,585,0.021739130434782608,-1.593163839814587
ZCTA5 83245,812,19,793,0.023399014778325122,-1.5934313900884904
ZCTA5 35098,451,9,442,0.019955654101995565,-1.594189680744361
ZCTA5 71450,451,9,442,0.019955654101995565,-1.594189680744361
ZCTA5 99518,4139,120,4019,0.02899251026818072,-1.5963018986123099
ZCTA5 83467,2752,77,2675,0.0279796511627907,-1.5971275876585334
ZCTA5 32438,1397,36,1361,0.025769506084466716,-1.5973155274536266
ZCTA5 17889,918,22,896,0.023965141612200435,-1.5988578940819682
ZCTA5 58380,216,3,213,0.013888888888888888,-1.5991082961642478
ZCTA5 74731,599,13,586,0.021702838063439065,-1.5994349615734136
ZCTA5 30442,2948,83,2865,0.028154681139755767,-1.600174603037767
ZCTA5 85004,2753,77,2676,0.027969487831456592,-1.600383267205112
ZCTA5 28589,74,0,74,0,-1.600406463768249
ZCTA5 41271,74,0,74,0,-1.600406463768249
ZCTA5 45622,74,0,74,0,-1.600406463768249
ZCTA5 47247,74,0,74,0,-1.600406463768249
ZCTA5 49628,74,0,74,0,-1.600406463768249
ZCTA5 54413,74,0,74,0,-1.600406463768249
ZCTA5 87943,74,0,74,0,-1.600406463768249
ZCTA5 58772,74,0,74,0,-1.600406463768249
ZCTA5 63567,74,0,74,0,-1.600406463768249
ZCTA5 67065,74,0,74,0,-1.600406463768249
ZCTA5 67452,74,0,74,0,-1.600406463768249
ZCTA5 67512,74,0,74,0,-1.600406463768249
ZCTA5 67658,74,0,74,0,-1.600406463768249
ZCTA5 71079,74,0,74,0,-1.600406463768249
ZCTA5 72555,74,0,74,0,-1.600406463768249
ZCTA5 88263,74,0,74,0,-1.600406463768249
ZCTA5 85927,74,0,74,0,-1.600406463768249
ZCTA5 04936,74,0,74,0,-1.600406463768249
ZCTA5 05850,74,0,74,0,-1.600406463768249
ZCTA5 15925,74,0,74,0,-1.600406463768249
ZCTA5 15712,74,0,74,0,-1.600406463768249
ZCTA5 18349,74,0,74,0,-1.600406463768249
ZCTA5 26684,74,0,74,0,-1.600406463768249
ZCTA5 89047,74,0,74,0,-1.600406463768249
ZCTA5 97342,74,0,74,0,-1.600406463768249
ZCTA5 96115,74,0,74,0,-1.600406463768249
ZCTA5 71064,1364,35,1329,0.025659824046920823,-1.6008639761886005
ZCTA5 52777,452,9,443,0.01991150442477876,-1.6011759689730887
ZCTA5 29042,1800,48,1752,0.02666666666666667,-1.6014542374320373
ZCTA5 04449,563,12,551,0.021314387211367674,-1.601884133057627
ZCTA5 20006,563,12,551,0.021314387211367674,-1.601884133057627
ZCTA5 33146,4077,118,3959,0.028942850134903116,-1.6019345300260976
ZCTA5 50546,127,1,126,0.007874015748031496,-1.603132852190421
ZCTA5 67734,127,1,126,0.007874015748031496,-1.603132852190421
ZCTA5 64440,258,4,254,0.015503875968992248,-1.603417011541674
ZCTA5 29325,5513,163,5350,0.02956647923090876,-1.6053056017753544
ZCTA5 68420,600,13,587,0.021666666666666667,-1.60569673624049
ZCTA5 37137,1161,29,1132,0.024978466838931956,-1.6060499987512153
ZCTA5 24325,377,7,370,0.01856763925729443,-1.6074209931950592
ZCTA5 59826,217,3,214,0.013824884792626729,-1.6080489139593284
ZCTA5 66111,3694,106,3588,0.028695181375203032,-1.6085460588175542
ZCTA5 68138,4719,138,4581,0.029243483788938335,-1.6086042002946535
ZCTA5 63654,299,5,294,0.016722408026755852,-1.6089497431620488
ZCTA5 56650,299,5,294,0.016722408026755852,-1.6089497431620488
ZCTA5 62844,885,21,864,0.023728813559322035,-1.6089548365274942
ZCTA5 48413,2951,83,2868,0.028126058963063368,-1.6096352964881522
ZCTA5 75750,1366,35,1331,0.02562225475841874,-1.6097590521099143
ZCTA5 77665,2364,65,2299,0.027495769881556685,-1.6110993806392322
ZCTA5 36039,75,0,75,0,-1.6111837334425865
ZCTA5 43005,75,0,75,0,-1.6111837334425865
ZCTA5 46155,75,0,75,0,-1.6111837334425865
ZCTA5 47958,75,0,75,0,-1.6111837334425865
ZCTA5 53706,75,0,75,0,-1.6111837334425865
ZCTA5 59311,75,0,75,0,-1.6111837334425865
ZCTA5 55977,75,0,75,0,-1.6111837334425865
ZCTA5 59260,75,0,75,0,-1.6111837334425865
ZCTA5 57474,75,0,75,0,-1.6111837334425865
ZCTA5 57585,75,0,75,0,-1.6111837334425865
ZCTA5 62851,75,0,75,0,-1.6111837334425865
ZCTA5 68655,75,0,75,0,-1.6111837334425865
ZCTA5 69221,75,0,75,0,-1.6111837334425865
ZCTA5 73058,75,0,75,0,-1.6111837334425865
ZCTA5 76820,75,0,75,0,-1.6111837334425865
ZCTA5 81640,75,0,75,0,-1.6111837334425865
ZCTA5 87735,75,0,75,0,-1.6111837334425865
ZCTA5 80453,75,0,75,0,-1.6111837334425865
ZCTA5 84764,75,0,75,0,-1.6111837334425865
ZCTA5 02836,75,0,75,0,-1.6111837334425865
ZCTA5 14135,75,0,75,0,-1.6111837334425865
ZCTA5 15733,75,0,75,0,-1.6111837334425865
ZCTA5 19017,75,0,75,0,-1.6111837334425865
ZCTA5 17029,75,0,75,0,-1.6111837334425865
ZCTA5 89428,75,0,75,0,-1.6111837334425865
ZCTA5 97621,75,0,75,0,-1.6111837334425865
ZCTA5 96104,259,4,255,0.015444015444015444,-1.6118787971798445
ZCTA5 04951,491,10,481,0.020366598778004074,-1.6127445562316602
ZCTA5 38579,339,6,333,0.017699115044247787,-1.6131884582221165
ZCTA5 62533,339,6,333,0.017699115044247787,-1.6131884582221165
ZCTA5 16661,339,6,333,0.017699115044247787,-1.6131884582221165
ZCTA5 71247,454,9,445,0.019823788546255508,-1.6151081625086587
ZCTA5 33967,8231,249,7982,0.030251488276029644,-1.6158981725879151
ZCTA5 38128,15737,490,15247,0.031136811336341108,-1.6167104537440338
ZCTA5 54515,218,3,215,0.013761467889908258,-1.6169569429863704
ZCTA5 75693,2366,65,2301,0.027472527472527472,-1.618067869338523
ZCTA5 32967,7604,229,7375,0.03011572856391373,-1.6189680797641552
ZCTA5 05401,12325,380,11945,0.030831643002028397,-1.6191598253229358
ZCTA5 28748,4787,140,4647,0.029245874242740756,-1.6192328435900627
ZCTA5 53960,1436,37,1399,0.02576601671309192,-1.620193492203191
ZCTA5 73857,260,4,256,0.015384615384615385,-1.620313970334731
ZCTA5 31757,4180,121,4059,0.02894736842105263,-1.6204191706443551
ZCTA5 81416,5202,153,5049,0.029411764705882353,-1.6214243851027184
ZCTA5 30289,76,0,76,0,-1.6218893909723904
ZCTA5 31747,76,0,76,0,-1.6218893909723904
ZCTA5 41524,76,0,76,0,-1.6218893909723904
ZCTA5 41367,76,0,76,0,-1.6218893909723904
ZCTA5 44439,76,0,76,0,-1.6218893909723904
ZCTA5 45789,76,0,76,0,-1.6218893909723904
ZCTA5 45888,76,0,76,0,-1.6218893909723904
ZCTA5 47884,76,0,76,0,-1.6218893909723904
ZCTA5 51554,76,0,76,0,-1.6218893909723904
ZCTA5 49929,76,0,76,0,-1.6218893909723904
ZCTA5 52308,76,0,76,0,-1.6218893909723904
ZCTA5 59529,76,0,76,0,-1.6218893909723904
ZCTA5 60557,76,0,76,0,-1.6218893909723904
ZCTA5 58241,76,0,76,0,-1.6218893909723904
ZCTA5 57724,76,0,76,0,-1.6218893909723904
ZCTA5 62085,76,0,76,0,-1.6218893909723904
ZCTA5 61955,76,0,76,0,-1.6218893909723904
ZCTA5 64453,76,0,76,0,-1.6218893909723904
ZCTA5 66772,76,0,76,0,-1.6218893909723904
ZCTA5 70801,76,0,76,0,-1.6218893909723904
ZCTA5 67675,76,0,76,0,-1.6218893909723904
ZCTA5 56075,76,0,76,0,-1.6218893909723904
ZCTA5 56629,76,0,76,0,-1.6218893909723904
ZCTA5 72546,76,0,76,0,-1.6218893909723904
ZCTA5 73444,76,0,76,0,-1.6218893909723904
ZCTA5 73097,76,0,76,0,-1.6218893909723904
ZCTA5 79001,76,0,76,0,-1.6218893909723904
ZCTA5 83312,76,0,76,0,-1.6218893909723904
ZCTA5 01084,76,0,76,0,-1.6218893909723904
ZCTA5 02815,76,0,76,0,-1.6218893909723904
ZCTA5 05907,76,0,76,0,-1.6218893909723904
ZCTA5 13064,76,0,76,0,-1.6218893909723904
ZCTA5 15662,76,0,76,0,-1.6218893909723904
ZCTA5 15693,76,0,76,0,-1.6218893909723904
ZCTA5 17945,76,0,76,0,-1.6218893909723904
ZCTA5 16236,76,0,76,0,-1.6218893909723904
ZCTA5 16834,76,0,76,0,-1.6218893909723904
ZCTA5 18242,76,0,76,0,-1.6218893909723904
ZCTA5 18340,76,0,76,0,-1.6218893909723904
ZCTA5 18653,76,0,76,0,-1.6218893909723904
ZCTA5 23161,76,0,76,0,-1.6218893909723904
ZCTA5 21543,76,0,76,0,-1.6218893909723904
ZCTA5 24536,76,0,76,0,-1.6218893909723904
ZCTA5 25915,76,0,76,0,-1.6218893909723904
ZCTA5 24830,76,0,76,0,-1.6218893909723904
ZCTA5 24058,76,0,76,0,-1.6218893909723904
ZCTA5 98575,76,0,76,0,-1.6218893909723904
ZCTA5 55314,455,9,446,0.01978021978021978,-1.6220541946268758
ZCTA5 53016,129,1,128,0.007751937984496124,-1.6234173493060073
ZCTA5 57763,129,1,128,0.007751937984496124,-1.6234173493060073
ZCTA5 62635,301,5,296,0.016611295681063124,-1.625042221198628
ZCTA5 05758,301,5,296,0.016611295681063124,-1.625042221198628
ZCTA5 43203,3571,102,3469,0.028563427611313356,-1.6253238430699883
ZCTA5 64466,219,3,216,0.0136986301369863,-1.6258326894032902
ZCTA5 60911,530,11,519,0.020754716981132074,-1.6258812079735678
ZCTA5 03234,1773,47,1726,0.026508742244782856,-1.6263779405699457
ZCTA5 83234,567,12,555,0.021164021164021163,-1.6274761131820843
ZCTA5 79065,7325,220,7105,0.030034129692832763,-1.6278270561595491
ZCTA5 97367,4375,127,4248,0.029028571428571428,-1.627915960306095
ZCTA5 74857,3346,95,3251,0.02839210998206814,-1.6283966994501586
ZCTA5 50123,341,6,335,0.017595307917888565,-1.6286003810296403
ZCTA5 58540,1200,30,1170,0.025,-1.6286539734001566
ZCTA5 14536,261,4,257,0.01532567049808429,-1.6287227434895566
ZCTA5 48727,456,9,447,0.019736842105263157,-1.628986934099547
ZCTA5 74364,712,16,696,0.02247191011235955,-1.629663725814678
ZCTA5 79851,176,2,174,0.011363636363636364,-1.6297734866842823
ZCTA5 30184,2468,68,2400,0.027552674230145867,-1.6304356569308054
ZCTA5 35139,77,0,77,0,-1.632524845197644
ZCTA5 36470,77,0,77,0,-1.632524845197644
ZCTA5 41559,77,0,77,0,-1.632524845197644
ZCTA5 46961,77,0,77,0,-1.632524845197644
ZCTA5 49960,77,0,77,0,-1.632524845197644
ZCTA5 50218,77,0,77,0,-1.632524845197644
ZCTA5 57750,77,0,77,0,-1.632524845197644
ZCTA5 58385,77,0,77,0,-1.632524845197644
ZCTA5 60437,77,0,77,0,-1.632524845197644
ZCTA5 61258,77,0,77,0,-1.632524845197644
ZCTA5 64646,77,0,77,0,-1.632524845197644
ZCTA5 68036,77,0,77,0,-1.632524845197644
ZCTA5 69144,77,0,77,0,-1.632524845197644
ZCTA5 70743,77,0,77,0,-1.632524845197644
ZCTA5 72526,77,0,77,0,-1.632524845197644
ZCTA5 82428,77,0,77,0,-1.632524845197644
ZCTA5 04673,77,0,77,0,-1.632524845197644
ZCTA5 04624,77,0,77,0,-1.632524845197644
ZCTA5 12165,77,0,77,0,-1.632524845197644
ZCTA5 12792,77,0,77,0,-1.632524845197644
ZCTA5 13345,77,0,77,0,-1.632524845197644
ZCTA5 21652,77,0,77,0,-1.632524845197644
ZCTA5 26424,77,0,77,0,-1.632524845197644
ZCTA5 25972,77,0,77,0,-1.632524845197644
ZCTA5 25062,77,0,77,0,-1.632524845197644
ZCTA5 25540,77,0,77,0,-1.632524845197644
ZCTA5 24239,77,0,77,0,-1.632524845197644
ZCTA5 27968,77,0,77,0,-1.632524845197644
ZCTA5 96105,77,0,77,0,-1.632524845197644
ZCTA5 55324,494,10,484,0.020242914979757085,-1.632951575873421
ZCTA5 13470,302,5,297,0.016556291390728478,-1.6330551218801928
ZCTA5 51552,130,1,129,0.007692307692307693,-1.6334784744378867
ZCTA5 74827,130,1,129,0.007692307692307693,-1.6334784744378867
ZCTA5 17307,2305,63,2242,0.027331887201735357,-1.6346230833945996
ZCTA5 68812,220,3,217,0.013636363636363636,-1.6346764549442216
ZCTA5 56134,220,3,217,0.013636363636363636,-1.6346764549442216
ZCTA5 17006,342,6,336,0.017543859649122806,-1.6362777221087077
ZCTA5 29571,5209,153,5056,0.029372240353234786,-1.6383786641383498
ZCTA5 52215,303,5,298,0.0165016501650165,-1.641046002564045
ZCTA5 52721,303,5,298,0.0165016501650165,-1.641046002564045
ZCTA5 72017,303,5,298,0.0165016501650165,-1.641046002564045
ZCTA5 54895,420,8,412,0.01904761904761905,-1.6419132370320635
ZCTA5 35119,78,0,78,0,-1.643091459361405
ZCTA5 38569,78,0,78,0,-1.643091459361405
ZCTA5 40161,78,0,78,0,-1.643091459361405
ZCTA5 45866,78,0,78,0,-1.643091459361405
ZCTA5 50243,78,0,78,0,-1.643091459361405
ZCTA5 57224,78,0,78,0,-1.643091459361405
ZCTA5 68659,78,0,78,0,-1.643091459361405
ZCTA5 67762,78,0,78,0,-1.643091459361405
ZCTA5 71401,78,0,78,0,-1.643091459361405
ZCTA5 72457,78,0,78,0,-1.643091459361405
ZCTA5 72540,78,0,78,0,-1.643091459361405
ZCTA5 81220,78,0,78,0,-1.643091459361405
ZCTA5 82512,78,0,78,0,-1.643091459361405
ZCTA5 88418,78,0,78,0,-1.643091459361405
ZCTA5 78563,78,0,78,0,-1.643091459361405
ZCTA5 84718,78,0,78,0,-1.643091459361405
ZCTA5 85640,78,0,78,0,-1.643091459361405
ZCTA5 03215,78,0,78,0,-1.643091459361405
ZCTA5 12450,78,0,78,0,-1.643091459361405
ZCTA5 10979,78,0,78,0,-1.643091459361405
ZCTA5 14479,78,0,78,0,-1.643091459361405
ZCTA5 14742,78,0,78,0,-1.643091459361405
ZCTA5 17246,78,0,78,0,-1.643091459361405
ZCTA5 23963,78,0,78,0,-1.643091459361405
ZCTA5 24539,78,0,78,0,-1.643091459361405
ZCTA5 25432,78,0,78,0,-1.643091459361405
ZCTA5 89319,78,0,78,0,-1.643091459361405
ZCTA5 97001,78,0,78,0,-1.643091459361405
ZCTA5 96112,78,0,78,0,-1.643091459361405
ZCTA5 96017,78,0,78,0,-1.643091459361405
ZCTA5 99147,78,0,78,0,-1.643091459361405
ZCTA5 99918,78,0,78,0,-1.643091459361405
ZCTA5 39421,1100,27,1073,0.024545454545454544,-1.6431546717357914
ZCTA5 58625,131,1,130,0.007633587786259542,-1.6434865736119495
ZCTA5 57340,131,1,130,0.007633587786259542,-1.6434865736119495
ZCTA5 17762,221,3,218,0.013574660633484163,-1.6434885370045718
ZCTA5 66046,8151,246,7905,0.030180345969819652,-1.6437450286236415
ZCTA5 01050,1031,25,1006,0.02424830261881668,-1.6438452746519596
ZCTA5 24245,343,6,337,0.01749271137026239,-1.6439361398489467
ZCTA5 63555,1272,32,1240,0.025157232704402517,-1.6456166181191856
ZCTA5 15687,496,10,486,0.020161290322580645,-1.6463632063227511
ZCTA5 56475,643,14,629,0.02177293934681182,-1.647252530430301
ZCTA5 97055,6735,201,6534,0.029844097995545656,-1.6476211469603645
ZCTA5 44403,1745,46,1699,0.026361031518624643,-1.647798716233859
ZCTA5 21639,1611,42,1569,0.0260707635009311,-1.6480575169657248
ZCTA5 45826,178,2,176,0.011235955056179775,-1.6484806867853947
ZCTA5 58487,178,2,176,0.011235955056179775,-1.6484806867853947
ZCTA5 79742,178,2,176,0.011235955056179775,-1.6484806867853947
ZCTA5 04285,178,2,176,0.011235955056179775,-1.6484806867853947
ZCTA5 14462,178,2,176,0.011235955056179775,-1.6484806867853947
ZCTA5 14719,1375,35,1340,0.025454545454545455,-1.6496370746415603
ZCTA5 26537,2012,54,1958,0.0268389662027833,-1.6501581669664396
ZCTA5 17981,1067,26,1041,0.02436738519212746,-1.650666710303459
ZCTA5 44842,2178,59,2119,0.027089072543617997,-1.6519715233993537
ZCTA5 51463,222,3,219,0.013513513513513514,-1.6522692287240468
ZCTA5 49795,858,20,838,0.023310023310023312,-1.6524400376674024
ZCTA5 76389,497,10,487,0.02012072434607646,-1.6530512615820099
ZCTA5 35958,1545,40,1505,0.025889967637540454,-1.6534652953247826
ZCTA5 49289,79,0,79,0,-1.6535905531494761
ZCTA5 58748,79,0,79,0,-1.6535905531494761
ZCTA5 60111,79,0,79,0,-1.6535905531494761
ZCTA5 61852,79,0,79,0,-1.6535905531494761
ZCTA5 63784,79,0,79,0,-1.6535905531494761
ZCTA5 67061,79,0,79,0,-1.6535905531494761
ZCTA5 64686,79,0,79,0,-1.6535905531494761
ZCTA5 66775,79,0,79,0,-1.6535905531494761
ZCTA5 67355,79,0,79,0,-1.6535905531494761
ZCTA5 68742,79,0,79,0,-1.6535905531494761
ZCTA5 69026,79,0,79,0,-1.6535905531494761
ZCTA5 69046,79,0,79,0,-1.6535905531494761
ZCTA5 70524,79,0,79,0,-1.6535905531494761
ZCTA5 77483,79,0,79,0,-1.6535905531494761
ZCTA5 75415,79,0,79,0,-1.6535905531494761
ZCTA5 79535,79,0,79,0,-1.6535905531494761
ZCTA5 78622,79,0,79,0,-1.6535905531494761
ZCTA5 76429,79,0,79,0,-1.6535905531494761
ZCTA5 88324,79,0,79,0,-1.6535905531494761
ZCTA5 78802,79,0,79,0,-1.6535905531494761
ZCTA5 01347,79,0,79,0,-1.6535905531494761
ZCTA5 05358,79,0,79,0,-1.6535905531494761
ZCTA5 03871,79,0,79,0,-1.6535905531494761
ZCTA5 13484,79,0,79,0,-1.6535905531494761
ZCTA5 21624,79,0,79,0,-1.6535905531494761
ZCTA5 26611,79,0,79,0,-1.6535905531494761
ZCTA5 95140,79,0,79,0,-1.6535905531494761
ZCTA5 96046,79,0,79,0,-1.6535905531494761
ZCTA5 99018,79,0,79,0,-1.6535905531494761
ZCTA5 56169,264,4,260,0.015151515151515152,-1.653792749087383
ZCTA5 27568,264,4,260,0.015151515151515152,-1.653792749087383
ZCTA5 01852,13747,425,13322,0.030915836182439805,-1.6551197681677627
ZCTA5 68716,460,9,451,0.01956521739130435,-1.6565862045703845
ZCTA5 56251,345,6,339,0.017391304347826087,-1.6591966693377898
ZCTA5 12522,1915,51,1864,0.026631853785900782,-1.6602918376457383
ZCTA5 68647,265,4,261,0.01509433962264151,-1.6620979957672632
ZCTA5 12469,265,4,261,0.01509433962264151,-1.6620979957672632
ZCTA5 15628,265,4,261,0.01509433962264151,-1.6620979957672632
ZCTA5 64476,133,1,132,0.007518796992481203,-1.663346754000678
ZCTA5 68622,133,1,132,0.007518796992481203,-1.663346754000678
ZCTA5 29046,80,0,80,0,-1.6640234046142472
ZCTA5 34268,80,0,80,0,-1.6640234046142472
ZCTA5 50078,80,0,80,0,-1.6640234046142472
ZCTA5 52232,80,0,80,0,-1.6640234046142472
ZCTA5 55725,80,0,80,0,-1.6640234046142472
ZCTA5 59064,80,0,80,0,-1.6640234046142472
ZCTA5 58056,80,0,80,0,-1.6640234046142472
ZCTA5 57759,80,0,80,0,-1.6640234046142472
ZCTA5 61949,80,0,80,0,-1.6640234046142472
ZCTA5 60920,80,0,80,0,-1.6640234046142472
ZCTA5 64655,80,0,80,0,-1.6640234046142472
ZCTA5 65603,80,0,80,0,-1.6640234046142472
ZCTA5 67626,80,0,80,0,-1.6640234046142472
ZCTA5 72427,80,0,80,0,-1.6640234046142472
ZCTA5 72453,80,0,80,0,-1.6640234046142472
ZCTA5 73659,80,0,80,0,-1.6640234046142472
ZCTA5 74456,80,0,80,0,-1.6640234046142472
ZCTA5 79527,80,0,80,0,-1.6640234046142472
ZCTA5 81124,80,0,80,0,-1.6640234046142472
ZCTA5 04489,80,0,80,0,-1.6640234046142472
ZCTA5 04637,80,0,80,0,-1.6640234046142472
ZCTA5 04675,80,0,80,0,-1.6640234046142472
ZCTA5 16937,80,0,80,0,-1.6640234046142472
ZCTA5 15770,80,0,80,0,-1.6640234046142472
ZCTA5 18441,80,0,80,0,-1.6640234046142472
ZCTA5 24816,80,0,80,0,-1.6640234046142472
ZCTA5 95232,80,0,80,0,-1.6640234046142472
ZCTA5 93669,80,0,80,0,-1.6640234046142472
ZCTA5 93528,80,0,80,0,-1.6640234046142472
ZCTA5 98614,80,0,80,0,-1.6640234046142472
ZCTA5 98558,80,0,80,0,-1.6640234046142472
ZCTA5 55112,17227,537,16690,0.031171997445869855,-1.6658333502722686
ZCTA5 26591,499,10,489,0.02004008016032064,-1.6663921068496408
ZCTA5 56646,180,2,178,0.011111111111111112,-1.6670306023213546
ZCTA5 81504,11420,350,11070,0.03064798598949212,-1.6677257156632128
ZCTA5 16041,861,20,841,0.023228803716608595,-1.6685797439511494
ZCTA5 76357,224,3,221,0.013392857142857142,-1.6697375929051042
ZCTA5 12059,683,15,668,0.021961932650073207,-1.6702484782764362
ZCTA5 13493,683,15,668,0.021961932650073207,-1.6702484782764362
ZCTA5 94903,12139,373,11766,0.03072740752945053,-1.6707618466307899
ZCTA5 71834,537,11,526,0.020484171322160148,-1.6714480349231724
ZCTA5 12209,3974,114,3860,0.02868646200301963,-1.6714521782155738
ZCTA5 63645,4680,136,4544,0.02905982905982906,-1.6718128739123175
ZCTA5 61810,134,1,133,0.007462686567164179,-1.6732003216916527
ZCTA5 92081,10424,318,10106,0.030506523407521104,-1.6736608312701229
ZCTA5 56446,611,13,598,0.02127659574468085,-1.6739688369793584
ZCTA5 72167,611,13,598,0.02127659574468085,-1.6739688369793584
ZCTA5 55805,4713,137,4576,0.029068533842563124,-1.6743734300471629
ZCTA5 51528,347,6,341,0.01729106628242075,-1.6743828867504358
ZCTA5 29921,81,0,81,0,-1.6743912519906423
ZCTA5 32639,81,0,81,0,-1.6743912519906423
ZCTA5 40350,81,0,81,0,-1.6743912519906423
ZCTA5 45115,81,0,81,0,-1.6743912519906423
ZCTA5 50066,81,0,81,0,-1.6743912519906423
ZCTA5 52767,81,0,81,0,-1.6743912519906423
ZCTA5 58277,81,0,81,0,-1.6743912519906423
ZCTA5 58716,81,0,81,0,-1.6743912519906423
ZCTA5 57640,81,0,81,0,-1.6743912519906423
ZCTA5 59462,81,0,81,0,-1.6743912519906423
ZCTA5 58266,81,0,81,0,-1.6743912519906423
ZCTA5 65690,81,0,81,0,-1.6743912519906423
ZCTA5 66960,81,0,81,0,-1.6743912519906423
ZCTA5 67072,81,0,81,0,-1.6743912519906423
ZCTA5 56227,81,0,81,0,-1.6743912519906423
ZCTA5 72573,81,0,81,0,-1.6743912519906423
ZCTA5 74722,81,0,81,0,-1.6743912519906423
ZCTA5 79539,81,0,81,0,-1.6743912519906423
ZCTA5 79777,81,0,81,0,-1.6743912519906423
ZCTA5 76828,81,0,81,0,-1.6743912519906423
ZCTA5 79847,81,0,81,0,-1.6743912519906423
ZCTA5 84729,81,0,81,0,-1.6743912519906423
ZCTA5 12507,81,0,81,0,-1.6743912519906423
ZCTA5 14707,81,0,81,0,-1.6743912519906423
ZCTA5 13342,81,0,81,0,-1.6743912519906423
ZCTA5 18469,81,0,81,0,-1.6743912519906423
ZCTA5 25654,81,0,81,0,-1.6743912519906423
ZCTA5 44704,1550,40,1510,0.025806451612903226,-1.6744238062588863
ZCTA5 53178,1141,28,1113,0.024539877300613498,-1.6745446242479582
ZCTA5 64402,1072,26,1046,0.024253731343283583,-1.6752237430912593
ZCTA5 74032,827,19,808,0.022974607013301087,-1.6759550360802813
ZCTA5 59046,181,2,179,0.011049723756906077,-1.6762476696029274
ZCTA5 66864,181,2,179,0.011049723756906077,-1.6762476696029274
ZCTA5 47879,1313,33,1280,0.02513328255902513,-1.6767537995990973
ZCTA5 79252,1176,29,1147,0.02465986394557823,-1.6771515288085643
ZCTA5 58367,648,14,634,0.021604938271604937,-1.677427471979883
ZCTA5 72660,225,3,222,0.013333333333333334,-1.6784258310875664
ZCTA5 43162,2679,74,2605,0.027622247107129527,-1.6786771794906952
ZCTA5 52237,612,13,599,0.021241830065359478,-1.680121017900168
ZCTA5 45710,2252,61,2191,0.02708703374777975,-1.680338957636741
ZCTA5 98059,13546,418,13128,0.03085781780599439,-1.6805272533199276
ZCTA5 29365,4042,116,3926,0.028698664027709056,-1.681377687877114
ZCTA5 47041,2516,69,2447,0.027424483306836247,-1.681972641762532
ZCTA5 86444,539,11,528,0.02040816326530612,-1.6843710554657003
ZCTA5 61486,576,12,564,0.020833333333333332,-1.6844776997329534
ZCTA5 32970,82,0,82,0,-1.6846952954114849
ZCTA5 35774,82,0,82,0,-1.6846952954114849
ZCTA5 36723,82,0,82,0,-1.6846952954114849
ZCTA5 40829,82,0,82,0,-1.6846952954114849
ZCTA5 40830,82,0,82,0,-1.6846952954114849
ZCTA5 41567,82,0,82,0,-1.6846952954114849
ZCTA5 44080,82,0,82,0,-1.6846952954114849
ZCTA5 42032,82,0,82,0,-1.6846952954114849
ZCTA5 42151,82,0,82,0,-1.6846952954114849
ZCTA5 47437,82,0,82,0,-1.6846952954114849
ZCTA5 51111,82,0,82,0,-1.6846952954114849
ZCTA5 87315,82,0,82,0,-1.6846952954114849
ZCTA5 58756,82,0,82,0,-1.6846952954114849
ZCTA5 58477,82,0,82,0,-1.6846952954114849
ZCTA5 57657,82,0,82,0,-1.6846952954114849
ZCTA5 59012,82,0,82,0,-1.6846952954114849
ZCTA5 59065,82,0,82,0,-1.6846952954114849
ZCTA5 62876,82,0,82,0,-1.6846952954114849
ZCTA5 65529,82,0,82,0,-1.6846952954114849
ZCTA5 67103,82,0,82,0,-1.6846952954114849
ZCTA5 67639,82,0,82,0,-1.6846952954114849
ZCTA5 73720,82,0,82,0,-1.6846952954114849
ZCTA5 76870,82,0,82,0,-1.6846952954114849
ZCTA5 82620,82,0,82,0,-1.6846952954114849
ZCTA5 05052,82,0,82,0,-1.6846952954114849
ZCTA5 05141,82,0,82,0,-1.6846952954114849
ZCTA5 12031,82,0,82,0,-1.6846952954114849
ZCTA5 13651,82,0,82,0,-1.6846952954114849
ZCTA5 15366,82,0,82,0,-1.6846952954114849
ZCTA5 18437,82,0,82,0,-1.6846952954114849
ZCTA5 23066,82,0,82,0,-1.6846952954114849
ZCTA5 99550,82,0,82,0,-1.6846952954114849
ZCTA5 48463,1788,47,1741,0.026286353467561523,-1.6855381743281261
ZCTA5 26425,502,10,492,0.0199203187250996,-1.6863159657536884
ZCTA5 84628,226,3,223,0.01327433628318584,-1.6870838105236599
ZCTA5 68508,5134,150,4984,0.0292169848071679,-1.688405112418651
ZCTA5 80444,650,14,636,0.021538461538461538,-1.689439276862811
ZCTA5 95501,9870,300,9570,0.030395136778115502,-1.6901186053793322
ZCTA5 76450,5071,148,4923,0.029185564977322026,-1.6904564890756355
ZCTA5 17103,4784,139,4645,0.029055183946488296,-1.6920732191832986
ZCTA5 70774,3659,104,3555,0.028423066411587865,-1.6924445983830128
ZCTA5 58711,136,1,135,0.007352941176470588,-1.6927580033662115
ZCTA5 59760,136,1,135,0.007352941176470588,-1.6927580033662115
ZCTA5 82835,136,1,135,0.007352941176470588,-1.6927580033662115
ZCTA5 71439,723,16,707,0.022130013831258646,-1.6933283876480074
ZCTA5 56381,1041,25,1016,0.024015369836695485,-1.6935926276252962
ZCTA5 92549,1145,28,1117,0.02445414847161572,-1.6936094487894542
ZCTA5 65682,759,17,742,0.022397891963109356,-1.6939325124828186
ZCTA5 85206,15388,477,14911,0.030998180400311933,-1.6943174784337365
ZCTA5 74643,183,2,181,0.01092896174863388,-1.694568140162508
ZCTA5 12884,183,2,181,0.01092896174863388,-1.694568140162508
ZCTA5 18508,5328,156,5172,0.02927927927927928,-1.694722603734217
ZCTA5 30055,1076,26,1050,0.024163568773234202,-1.694793586482699
ZCTA5 46146,83,0,83,0,-1.6949366985290013
ZCTA5 46998,83,0,83,0,-1.6949366985290013
ZCTA5 49748,83,0,83,0,-1.6949366985290013
ZCTA5 50570,83,0,83,0,-1.6949366985290013
ZCTA5 52231,83,0,83,0,-1.6949366985290013
ZCTA5 59336,83,0,83,0,-1.6949366985290013
ZCTA5 59067,83,0,83,0,-1.6949366985290013
ZCTA5 58787,83,0,83,0,-1.6949366985290013
ZCTA5 59720,83,0,83,0,-1.6949366985290013
ZCTA5 61731,83,0,83,0,-1.6949366985290013
ZCTA5 68974,83,0,83,0,-1.6949366985290013
ZCTA5 67739,83,0,83,0,-1.6949366985290013
ZCTA5 63560,83,0,83,0,-1.6949366985290013
ZCTA5 56147,83,0,83,0,-1.6949366985290013
ZCTA5 76373,83,0,83,0,-1.6949366985290013
ZCTA5 78838,83,0,83,0,-1.6949366985290013
ZCTA5 08348,83,0,83,0,-1.6949366985290013
ZCTA5 05360,83,0,83,0,-1.6949366985290013
ZCTA5 12169,83,0,83,0,-1.6949366985290013
ZCTA5 15745,83,0,83,0,-1.6949366985290013
ZCTA5 15710,83,0,83,0,-1.6949366985290013
ZCTA5 17946,83,0,83,0,-1.6949366985290013
ZCTA5 16825,83,0,83,0,-1.6949366985290013
ZCTA5 18212,83,0,83,0,-1.6949366985290013
ZCTA5 21056,83,0,83,0,-1.6949366985290013
ZCTA5 22432,83,0,83,0,-1.6949366985290013
ZCTA5 21930,83,0,83,0,-1.6949366985290013
ZCTA5 21672,83,0,83,0,-1.6949366985290013
ZCTA5 25810,83,0,83,0,-1.6949366985290013
ZCTA5 25920,83,0,83,0,-1.6949366985290013
ZCTA5 95637,83,0,83,0,-1.6949366985290013
ZCTA5 73626,389,7,382,0.017994858611825194,-1.6956269953226488
ZCTA5 56157,310,5,305,0.016129032258064516,-1.6963781870991503
ZCTA5 74531,350,6,344,0.017142857142857144,-1.6970248425476515
ZCTA5 54742,1724,45,1679,0.026102088167053363,-1.6976446835043233
ZCTA5 41562,1215,30,1185,0.024691358024691357,-1.6986296950928277
ZCTA5 98604,12219,375,11844,0.030689909157868893,-1.699309432603597
ZCTA5 54747,1077,26,1051,0.02414113277623027,-1.6996755931821128
ZCTA5 91901,6411,190,6221,0.02963656215878958,-1.6999117536285933
ZCTA5 96094,2882,80,2802,0.027758501040943788,-1.700438484978012
ZCTA5 97013,8652,261,8391,0.030166435506241332,-1.700703567156085
ZCTA5 00660,6253,185,6068,0.029585798816568046,-1.70115705110987
ZCTA5 74536,652,14,638,0.02147239263803681,-1.7014181715791734
ZCTA5 31415,4468,129,4339,0.028871978513876455,-1.7033366235714162
ZCTA5 45716,184,2,182,0.010869565217391304,-1.7036723685996888
ZCTA5 47708,184,2,182,0.010869565217391304,-1.7036723685996888
ZCTA5 62831,184,2,182,0.010869565217391304,-1.7036723685996888
ZCTA5 65258,184,2,182,0.010869565217391304,-1.7036723685996888
ZCTA5 52731,311,5,306,0.01607717041800643,-1.7041982525570032
ZCTA5 56667,228,3,225,0.013157894736842105,-1.7043100815177565
ZCTA5 19363,5619,165,5454,0.029364655632674853,-1.7047976122440367
ZCTA5 32361,84,0,84,0,-1.705116590048666
ZCTA5 35745,84,0,84,0,-1.705116590048666
ZCTA5 36031,84,0,84,0,-1.705116590048666
ZCTA5 46943,84,0,84,0,-1.705116590048666
ZCTA5 47361,84,0,84,0,-1.705116590048666
ZCTA5 55150,84,0,84,0,-1.705116590048666
ZCTA5 59830,84,0,84,0,-1.705116590048666
ZCTA5 58445,84,0,84,0,-1.705116590048666
ZCTA5 58451,84,0,84,0,-1.705116590048666
ZCTA5 57773,84,0,84,0,-1.705116590048666
ZCTA5 61743,84,0,84,0,-1.705116590048666
ZCTA5 62825,84,0,84,0,-1.705116590048666
ZCTA5 63860,84,0,84,0,-1.705116590048666
ZCTA5 66541,84,0,84,0,-1.705116590048666
ZCTA5 66964,84,0,84,0,-1.705116590048666
ZCTA5 71243,84,0,84,0,-1.705116590048666
ZCTA5 72520,84,0,84,0,-1.705116590048666
ZCTA5 73549,84,0,84,0,-1.705116590048666
ZCTA5 79783,84,0,84,0,-1.705116590048666
ZCTA5 88353,84,0,84,0,-1.705116590048666
ZCTA5 81033,84,0,84,0,-1.705116590048666
ZCTA5 84781,84,0,84,0,-1.705116590048666
ZCTA5 04237,84,0,84,0,-1.705116590048666
ZCTA5 11975,84,0,84,0,-1.705116590048666
ZCTA5 14415,84,0,84,0,-1.705116590048666
ZCTA5 25922,84,0,84,0,-1.705116590048666
ZCTA5 24871,84,0,84,0,-1.705116590048666
ZCTA5 96076,84,0,84,0,-1.705116590048666
ZCTA5 13750,429,8,421,0.018648018648018648,-1.7054394524930205
ZCTA5 49347,505,10,495,0.019801980198019802,-1.7061361229659544
ZCTA5 31020,653,14,639,0.021439509954058193,-1.7073953456849857
ZCTA5 97058,8121,244,7877,0.030045560891515822,-1.7082648818115929
ZCTA5 54648,580,12,568,0.020689655172413793,-1.7095592454124036
ZCTA5 78257,2754,76,2678,0.027596223674655047,-1.7096073889242618
ZCTA5 58535,271,4,267,0.014760147601476014,-1.7114034175219879
ZCTA5 62054,271,4,267,0.014760147601476014,-1.7114034175219879
ZCTA5 19032,2393,65,2328,0.027162557459256165,-1.7115986820696738
ZCTA5 12090,2459,67,2392,0.027246848312322082,-1.71179682386442
ZCTA5 51364,312,5,307,0.016025641025641024,-1.711997611288818
ZCTA5 67837,352,6,346,0.017045454545454544,-1.7120291823758558
ZCTA5 62538,138,1,137,0.007246376811594203,-1.7121210168653818
ZCTA5 30233,7997,240,7757,0.030011254220332625,-1.7122339495439245
ZCTA5 21869,430,8,422,0.018604651162790697,-1.7124270419922067
ZCTA5 77831,1218,30,1188,0.024630541871921183,-1.7125288381093406
ZCTA5 58059,506,10,496,0.019762845849802372,-1.712720025085924
ZCTA5 15466,185,2,183,0.010810810810810811,-1.7127397976147718
ZCTA5 08345,229,3,226,0.013100436681222707,-1.7128789078339774
ZCTA5 04427,1045,25,1020,0.023923444976076555,-1.713368775468266
ZCTA5 72843,940,22,918,0.023404255319148935,-1.713534599007814
ZCTA5 54552,2162,58,2104,0.02682701202590194,-1.7136554847989736
ZCTA5 16249,834,19,815,0.022781774580335732,-1.7140019411719905
ZCTA5 35751,85,0,85,0,-1.7152360651811138
ZCTA5 45864,85,0,85,0,-1.7152360651811138
ZCTA5 49825,85,0,85,0,-1.7152360651811138
ZCTA5 59059,85,0,85,0,-1.7152360651811138
ZCTA5 87063,85,0,85,0,-1.7152360651811138
ZCTA5 58769,85,0,85,0,-1.7152360651811138
ZCTA5 59732,85,0,85,0,-1.7152360651811138
ZCTA5 62359,85,0,85,0,-1.7152360651811138
ZCTA5 66014,85,0,85,0,-1.7152360651811138
ZCTA5 67747,85,0,85,0,-1.7152360651811138
ZCTA5 69366,85,0,85,0,-1.7152360651811138
ZCTA5 56160,85,0,85,0,-1.7152360651811138
ZCTA5 79377,85,0,85,0,-1.7152360651811138
ZCTA5 84623,85,0,85,0,-1.7152360651811138
ZCTA5 12874,85,0,85,0,-1.7152360651811138
ZCTA5 12108,85,0,85,0,-1.7152360651811138
ZCTA5 23422,85,0,85,0,-1.7152360651811138
ZCTA5 23354,85,0,85,0,-1.7152360651811138
ZCTA5 25989,85,0,85,0,-1.7152360651811138
ZCTA5 24413,85,0,85,0,-1.7152360651811138
ZCTA5 97620,85,0,85,0,-1.7152360651811138
ZCTA5 63873,1863,49,1814,0.026301663982823402,-1.7168510748178867
ZCTA5 74855,1863,49,1814,0.026301663982823402,-1.7168510748178867
ZCTA5 79762,15683,486,15197,0.030988968947267742,-1.7168962107689887
ZCTA5 56378,3051,85,2966,0.027859718125204852,-1.7184937355419105
ZCTA5 64859,507,10,497,0.01972386587771203,-1.7192925990685768
ZCTA5 75411,507,10,497,0.01972386587771203,-1.7192925990685768
ZCTA5 56176,431,8,423,0.018561484918793503,-1.7194007127934503
ZCTA5 33837,8882,268,8614,0.030173384372888988,-1.7195186453482278
ZCTA5 13489,272,4,268,0.014705882352941176,-1.7195351009888113
ZCTA5 31636,3895,111,3784,0.028498074454428753,-1.7201388392102634
ZCTA5 45349,139,1,138,0.007194244604316547,-1.7217311927092755
ZCTA5 73056,139,1,138,0.007194244604316547,-1.7217311927092755
ZCTA5 05842,186,2,184,0.010752688172043012,-1.721770822574383
ZCTA5 61924,977,23,954,0.02354145342886387,-1.7230845742713385
ZCTA5 97042,1047,25,1022,0.02387774594078319,-1.7232308295757153
ZCTA5 27355,942,22,920,0.02335456475583864,-1.723837841378553
ZCTA5 54628,393,7,386,0.017811704834605598,-1.7245143877776048
ZCTA5 67851,836,19,817,0.022727272727272728,-1.724819368005267
ZCTA5 61913,656,14,642,0.021341463414634148,-1.7252780984281044
ZCTA5 56315,656,14,642,0.021341463414634148,-1.7252780984281044
ZCTA5 38552,86,0,86,0,-1.725296187017403
ZCTA5 41622,86,0,86,0,-1.725296187017403
ZCTA5 49717,86,0,86,0,-1.725296187017403
ZCTA5 60945,86,0,86,0,-1.725296187017403
ZCTA5 58559,86,0,86,0,-1.725296187017403
ZCTA5 59035,86,0,86,0,-1.725296187017403
ZCTA5 58634,86,0,86,0,-1.725296187017403
ZCTA5 61539,86,0,86,0,-1.725296187017403
ZCTA5 67573,86,0,86,0,-1.725296187017403
ZCTA5 67155,86,0,86,0,-1.725296187017403
ZCTA5 56166,86,0,86,0,-1.725296187017403
ZCTA5 70782,86,0,86,0,-1.725296187017403
ZCTA5 70091,86,0,86,0,-1.725296187017403
ZCTA5 74646,86,0,86,0,-1.725296187017403
ZCTA5 73539,86,0,86,0,-1.725296187017403
ZCTA5 80463,86,0,86,0,-1.725296187017403
ZCTA5 81332,86,0,86,0,-1.725296187017403
ZCTA5 84334,86,0,86,0,-1.725296187017403
ZCTA5 15420,86,0,86,0,-1.725296187017403
ZCTA5 16036,86,0,86,0,-1.725296187017403
ZCTA5 24849,86,0,86,0,-1.725296187017403
ZCTA5 92378,86,0,86,0,-1.725296187017403
ZCTA5 89161,86,0,86,0,-1.725296187017403
ZCTA5 95936,86,0,86,0,-1.725296187017403
ZCTA5 97490,86,0,86,0,-1.725296187017403
ZCTA5 73450,508,10,498,0.01968503937007874,-1.7258538926541636
ZCTA5 62436,273,4,269,0.014652014652014652,-1.727642743184067
ZCTA5 72016,1013,24,989,0.023692003948667325,-1.7278959659010844
ZCTA5 32819,10142,308,9834,0.03036876355748373,-1.7280189531614163
ZCTA5 74637,693,15,678,0.021645021645021644,-1.728825904653894
ZCTA5 14024,620,13,607,0.020967741935483872,-1.729019819173409
ZCTA5 71602,6234,184,6050,0.029515559833172923,-1.729411304789866
ZCTA5 65713,908,21,887,0.023127753303964757,-1.73044999792595
ZCTA5 57257,187,2,185,0.0106951871657754,-1.7307658322378539
ZCTA5 83435,187,2,185,0.0106951871657754,-1.7307658322378539
ZCTA5 14877,187,2,185,0.0106951871657754,-1.7307658322378539
ZCTA5 74954,1766,46,1720,0.026047565118912798,-1.7309412462778653
ZCTA5 00602,12738,391,12347,0.030695556602292354,-1.7314784988562513
ZCTA5 36736,394,7,387,0.017766497461928935,-1.7316972620908753
ZCTA5 76103,5056,147,4909,0.029074367088607594,-1.7319251393000075
ZCTA5 55051,3835,109,3726,0.028422425032594525,-1.7328912194611
ZCTA5 58622,730,16,714,0.021917808219178082,-1.7333905782854893
ZCTA5 63351,802,18,784,0.022443890274314215,-1.7340108640781051
ZCTA5 76446,2696,74,2622,0.02744807121661721,-1.7342883223625412
ZCTA5 67844,355,6,349,0.016901408450704224,-1.734402395222737
ZCTA5 66868,315,5,310,0.015873015873015872,-1.7352728247831284
ZCTA5 42332,87,0,87,0,-1.7352979878325192
ZCTA5 47924,87,0,87,0,-1.7352979878325192
ZCTA5 59460,87,0,87,0,-1.7352979878325192
ZCTA5 57265,87,0,87,0,-1.7352979878325192
ZCTA5 62083,87,0,87,0,-1.7352979878325192
ZCTA5 65327,87,0,87,0,-1.7352979878325192
ZCTA5 65439,87,0,87,0,-1.7352979878325192
ZCTA5 80929,87,0,87,0,-1.7352979878325192
ZCTA5 80425,87,0,87,0,-1.7352979878325192
ZCTA5 79236,87,0,87,0,-1.7352979878325192
ZCTA5 83449,87,0,87,0,-1.7352979878325192
ZCTA5 84730,87,0,87,0,-1.7352979878325192
ZCTA5 84046,87,0,87,0,-1.7352979878325192
ZCTA5 84539,87,0,87,0,-1.7352979878325192
ZCTA5 84031,87,0,87,0,-1.7352979878325192
ZCTA5 15546,87,0,87,0,-1.7352979878325192
ZCTA5 15727,87,0,87,0,-1.7352979878325192
ZCTA5 15764,87,0,87,0,-1.7352979878325192
ZCTA5 19319,87,0,87,0,-1.7352979878325192
ZCTA5 17217,87,0,87,0,-1.7352979878325192
ZCTA5 21052,87,0,87,0,-1.7352979878325192
ZCTA5 24729,87,0,87,0,-1.7352979878325192
ZCTA5 89830,87,0,87,0,-1.7352979878325192
ZCTA5 92389,87,0,87,0,-1.7352979878325192
ZCTA5 93628,87,0,87,0,-1.7352979878325192
ZCTA5 99359,87,0,87,0,-1.7352979878325192
ZCTA5 54534,1223,30,1193,0.024529844644317254,-1.7356239421800401
ZCTA5 97543,274,4,270,0.014598540145985401,-1.7357265258925212
ZCTA5 04765,510,10,500,0.0196078431372549,-1.7389428280740136
ZCTA5 13661,510,10,500,0.0196078431372549,-1.7389428280740136
ZCTA5 81120,945,22,923,0.02328042328042328,-1.7392553995882971
ZCTA5 04910,803,18,785,0.0224159402241594,-1.7394961514053484
ZCTA5 80744,188,2,186,0.010638297872340425,-1.7397252089048967
ZCTA5 31323,585,12,573,0.020512820512820513,-1.7406975134422549
ZCTA5 51545,141,1,140,0.0070921985815602835,-1.7408120959616864
ZCTA5 84338,141,1,140,0.0070921985815602835,-1.7408120959616864
ZCTA5 67583,356,6,350,0.016853932584269662,-1.7418250080696562
ZCTA5 49227,473,9,464,0.019027484143763214,-1.7448684157716394
ZCTA5 29614,88,0,88,0,-1.7452424703216427
ZCTA5 30708,88,0,88,0,-1.7452424703216427
ZCTA5 30336,88,0,88,0,-1.7452424703216427
ZCTA5 44049,88,0,88,0,-1.7452424703216427
ZCTA5 50439,88,0,88,0,-1.7452424703216427
ZCTA5 49261,88,0,88,0,-1.7452424703216427
ZCTA5 52757,88,0,88,0,-1.7452424703216427
ZCTA5 57251,88,0,88,0,-1.7452424703216427
ZCTA5 61313,88,0,88,0,-1.7452424703216427
ZCTA5 61311,88,0,88,0,-1.7452424703216427
ZCTA5 63955,88,0,88,0,-1.7452424703216427
ZCTA5 67568,88,0,88,0,-1.7452424703216427
ZCTA5 67649,88,0,88,0,-1.7452424703216427
ZCTA5 67438,88,0,88,0,-1.7452424703216427
ZCTA5 65479,88,0,88,0,-1.7452424703216427
ZCTA5 68326,88,0,88,0,-1.7452424703216427
ZCTA5 71250,88,0,88,0,-1.7452424703216427
ZCTA5 71651,88,0,88,0,-1.7452424703216427
ZCTA5 70650,88,0,88,0,-1.7452424703216427
ZCTA5 70643,88,0,88,0,-1.7452424703216427
ZCTA5 72389,88,0,88,0,-1.7452424703216427
ZCTA5 72426,88,0,88,0,-1.7452424703216427
ZCTA5 76436,88,0,88,0,-1.7452424703216427
ZCTA5 79560,88,0,88,0,-1.7452424703216427
ZCTA5 76686,88,0,88,0,-1.7452424703216427
ZCTA5 78116,88,0,88,0,-1.7452424703216427
ZCTA5 79517,88,0,88,0,-1.7452424703216427
ZCTA5 83421,88,0,88,0,-1.7452424703216427
ZCTA5 84533,88,0,88,0,-1.7452424703216427
ZCTA5 87713,88,0,88,0,-1.7452424703216427
ZCTA5 12161,88,0,88,0,-1.7452424703216427
ZCTA5 17885,88,0,88,0,-1.7452424703216427
ZCTA5 16370,88,0,88,0,-1.7452424703216427
ZCTA5 15422,88,0,88,0,-1.7452424703216427
ZCTA5 23414,88,0,88,0,-1.7452424703216427
ZCTA5 25090,88,0,88,0,-1.7452424703216427
ZCTA5 24476,88,0,88,0,-1.7452424703216427
ZCTA5 93645,88,0,88,0,-1.7452424703216427
ZCTA5 96014,88,0,88,0,-1.7452424703216427
ZCTA5 24578,396,7,389,0.017676767676767676,-1.7460168262979998
ZCTA5 61736,623,13,610,0.02086677367576244,-1.747212849401489
ZCTA5 50851,876,20,856,0.0228310502283105,-1.7485196705634627
ZCTA5 62206,5223,152,5071,0.02910204863105495,-1.7491702277286187
ZCTA5 56297,357,6,351,0.01680672268907563,-1.7492302312068138
ZCTA5 50576,142,1,141,0.007042253521126761,-1.7502840675449929
ZCTA5 62839,2701,74,2627,0.0273972602739726,-1.750581078006789
ZCTA5 94957,474,9,465,0.0189873417721519,-1.7515721251812744
ZCTA5 74030,1535,39,1496,0.025407166123778503,-1.7532983749035962
ZCTA5 16426,1501,38,1463,0.02531645569620253,-1.7533158826398032
ZCTA5 00751,7829,234,7595,0.029888874696640696,-1.7543711087158051
ZCTA5 40743,89,0,89,0,-1.7551306087733727
ZCTA5 44274,89,0,89,0,-1.7551306087733727
ZCTA5 47574,89,0,89,0,-1.7551306087733727
ZCTA5 51630,89,0,89,0,-1.7551306087733727
ZCTA5 55933,89,0,89,0,-1.7551306087733727
ZCTA5 59454,89,0,89,0,-1.7551306087733727
ZCTA5 57649,89,0,89,0,-1.7551306087733727
ZCTA5 63451,89,0,89,0,-1.7551306087733727
ZCTA5 67736,89,0,89,0,-1.7551306087733727
ZCTA5 68325,89,0,89,0,-1.7551306087733727
ZCTA5 80802,89,0,89,0,-1.7551306087733727
ZCTA5 79730,89,0,89,0,-1.7551306087733727
ZCTA5 87012,89,0,89,0,-1.7551306087733727
ZCTA5 83848,89,0,89,0,-1.7551306087733727
ZCTA5 03441,89,0,89,0,-1.7551306087733727
ZCTA5 07880,89,0,89,0,-1.7551306087733727
ZCTA5 08808,89,0,89,0,-1.7551306087733727
ZCTA5 19733,89,0,89,0,-1.7551306087733727
ZCTA5 22646,89,0,89,0,-1.7551306087733727
ZCTA5 24866,89,0,89,0,-1.7551306087733727
ZCTA5 95463,89,0,89,0,-1.7551306087733727
ZCTA5 18426,1940,51,1889,0.026288659793814433,-1.755156879078639
ZCTA5 89166,6627,196,6431,0.02957597706352799,-1.755738892480071
ZCTA5 04495,190,2,188,0.010526315789473684,-1.757538561007934
ZCTA5 99029,475,9,466,0.018947368421052633,-1.7582636535791016
ZCTA5 68781,625,13,612,0.0208,-1.7592985466200073
ZCTA5 08638,8021,240,7781,0.029921456177533973,-1.7595257137571092
ZCTA5 25555,662,14,648,0.021148036253776436,-1.7608265306636923
ZCTA5 55376,5228,152,5076,0.029074215761285386,-1.7611987875921988
ZCTA5 74022,735,16,719,0.021768707482993196,-1.7617962150028885
ZCTA5 74051,735,16,719,0.021768707482993196,-1.7617962150028885
ZCTA5 63549,950,22,928,0.023157894736842106,-1.7648526099334014
ZCTA5 16917,476,9,467,0.018907563025210083,-1.7649430555161756
ZCTA5 36313,90,0,90,0,-1.7649633501837905
ZCTA5 50860,90,0,90,0,-1.7649633501837905
ZCTA5 57057,90,0,90,0,-1.7649633501837905
ZCTA5 57272,90,0,90,0,-1.7649633501837905
ZCTA5 57538,90,0,90,0,-1.7649633501837905
ZCTA5 58382,90,0,90,0,-1.7649633501837905
ZCTA5 59351,90,0,90,0,-1.7649633501837905
ZCTA5 57466,90,0,90,0,-1.7649633501837905
ZCTA5 65541,90,0,90,0,-1.7649633501837905
ZCTA5 68785,90,0,90,0,-1.7649633501837905
ZCTA5 68350,90,0,90,0,-1.7649633501837905
ZCTA5 71253,90,0,90,0,-1.7649633501837905
ZCTA5 75413,90,0,90,0,-1.7649633501837905
ZCTA5 72945,90,0,90,0,-1.7649633501837905
ZCTA5 82050,90,0,90,0,-1.7649633501837905
ZCTA5 83277,90,0,90,0,-1.7649633501837905
ZCTA5 04669,90,0,90,0,-1.7649633501837905
ZCTA5 06467,90,0,90,0,-1.7649633501837905
ZCTA5 13628,90,0,90,0,-1.7649633501837905
ZCTA5 16223,90,0,90,0,-1.7649633501837905
ZCTA5 15561,90,0,90,0,-1.7649633501837905
ZCTA5 23302,90,0,90,0,-1.7649633501837905
ZCTA5 97635,90,0,90,0,-1.7649633501837905
ZCTA5 96135,90,0,90,0,-1.7649633501837905
ZCTA5 51566,2968,82,2886,0.027628032345013476,-1.7651505491338841
ZCTA5 46962,3490,98,3392,0.028080229226361032,-1.7655301939913057
ZCTA5 26508,12104,370,11734,0.030568407138136154,-1.7656319810498649
ZCTA5 96090,191,2,189,0.010471204188481676,-1.7663932700177098
ZCTA5 38581,1436,36,1400,0.025069637883008356,-1.766946133766449
ZCTA5 79563,399,7,392,0.017543859649122806,-1.7673819379280014
ZCTA5 03602,1056,25,1031,0.023674242424242424,-1.767397632008455
ZCTA5 12835,1056,25,1031,0.023674242424242424,-1.767397632008455
ZCTA5 89703,4525,130,4395,0.028729281767955802,-1.7675482275125782
ZCTA5 68947,278,4,274,0.014388489208633094,-1.7678266243996137
ZCTA5 89822,700,15,685,0.02142857142857143,-1.7693825321883263
ZCTA5 28709,880,20,860,0.022727272727272728,-1.7696273328306007
ZCTA5 49646,3524,99,3425,0.028093076049943246,-1.7698682698084789
ZCTA5 97115,1437,36,1401,0.025052192066805846,-1.7712390138856051
ZCTA5 61261,360,6,354,0.016666666666666666,-1.7713425798569835
ZCTA5 62638,515,10,505,0.019417475728155338,-1.7714710434639491
ZCTA5 71333,236,3,233,0.012711864406779662,-1.7720576172340465
ZCTA5 50317,14541,448,14093,0.030809435389588063,-1.7735989105712036
ZCTA5 29809,1162,28,1134,0.024096385542168676,-1.773956359351328
ZCTA5 27311,1540,39,1501,0.025324675324675326,-1.7741539305750216
ZCTA5 29665,91,0,91,0,-1.7747416153149704
ZCTA5 45164,91,0,91,0,-1.7747416153149704
ZCTA5 50545,91,0,91,0,-1.7747416153149704
ZCTA5 59532,91,0,91,0,-1.7747416153149704
ZCTA5 57246,91,0,91,0,-1.7747416153149704
ZCTA5 62950,91,0,91,0,-1.7747416153149704
ZCTA5 63557,91,0,91,0,-1.7747416153149704
ZCTA5 63675,91,0,91,0,-1.7747416153149704
ZCTA5 67227,91,0,91,0,-1.7747416153149704
ZCTA5 70773,91,0,91,0,-1.7747416153149704
ZCTA5 73727,91,0,91,0,-1.7747416153149704
ZCTA5 75565,91,0,91,0,-1.7747416153149704
ZCTA5 83119,91,0,91,0,-1.7747416153149704
ZCTA5 04485,91,0,91,0,-1.7747416153149704
ZCTA5 04006,91,0,91,0,-1.7747416153149704
ZCTA5 17311,91,0,91,0,-1.7747416153149704
ZCTA5 18817,91,0,91,0,-1.7747416153149704
ZCTA5 26436,91,0,91,0,-1.7747416153149704
ZCTA5 24984,91,0,91,0,-1.7747416153149704
ZCTA5 80925,3298,92,3206,0.027895694360218316,-1.7752126315408974
ZCTA5 30175,2046,54,1992,0.026392961876832845,-1.7762326733786857
ZCTA5 93501,1845,48,1797,0.026016260162601626,-1.7767113442184925
ZCTA5 27302,11861,362,11499,0.030520192226625074,-1.7770202029797362
ZCTA5 54762,516,10,506,0.01937984496124031,-1.777943776486952
ZCTA5 56165,145,1,144,0.006896551724137931,-1.778433253698198
ZCTA5 04496,1609,41,1568,0.0254816656308266,-1.7784442589671088
ZCTA5 49616,738,16,722,0.02168021680216802,-1.7787567464373877
ZCTA5 68883,953,22,931,0.023084994753410283,-1.7801522007252637
ZCTA5 68725,237,3,234,0.012658227848101266,-1.78039996929228
ZCTA5 29929,440,8,432,0.01818181818181818,-1.7815485499458354
ZCTA5 56181,440,8,432,0.01818181818181818,-1.7815485499458354
ZCTA5 36040,1474,37,1437,0.025101763907734057,-1.783313168289907
ZCTA5 83445,2414,65,2349,0.026926263463131733,-1.7836555400189789
ZCTA5 03837,592,12,580,0.02027027027027027,-1.7839000017052025
ZCTA5 43565,193,2,191,0.010362694300518135,-1.7840005433718948
ZCTA5 50206,193,2,191,0.010362694300518135,-1.7840005433718948
ZCTA5 58064,193,2,191,0.010362694300518135,-1.7840005433718948
ZCTA5 62649,193,2,191,0.010362694300518135,-1.7840005433718948
ZCTA5 52530,517,10,507,0.019342359767891684,-1.7844056453651116
ZCTA5 29683,92,0,92,0,-1.784466299701283
ZCTA5 38946,92,0,92,0,-1.784466299701283
ZCTA5 40036,92,0,92,0,-1.784466299701283
ZCTA5 41612,92,0,92,0,-1.784466299701283
ZCTA5 41543,92,0,92,0,-1.784466299701283
ZCTA5 43717,92,0,92,0,-1.784466299701283
ZCTA5 46127,92,0,92,0,-1.784466299701283
ZCTA5 49917,92,0,92,0,-1.784466299701283
ZCTA5 47514,92,0,92,0,-1.784466299701283
ZCTA5 47983,92,0,92,0,-1.784466299701283
ZCTA5 52219,92,0,92,0,-1.784466299701283
ZCTA5 58475,92,0,92,0,-1.784466299701283
ZCTA5 58260,92,0,92,0,-1.784466299701283
ZCTA5 58479,92,0,92,0,-1.784466299701283
ZCTA5 64457,92,0,92,0,-1.784466299701283
ZCTA5 65654,92,0,92,0,-1.784466299701283
ZCTA5 68774,92,0,92,0,-1.784466299701283
ZCTA5 67057,92,0,92,0,-1.784466299701283
ZCTA5 67629,92,0,92,0,-1.784466299701283
ZCTA5 56517,92,0,92,0,-1.784466299701283
ZCTA5 73638,92,0,92,0,-1.784466299701283
ZCTA5 79011,92,0,92,0,-1.784466299701283
ZCTA5 12465,92,0,92,0,-1.784466299701283
ZCTA5 12530,92,0,92,0,-1.784466299701283
ZCTA5 25624,92,0,92,0,-1.784466299701283
ZCTA5 25036,92,0,92,0,-1.784466299701283
ZCTA5 25696,92,0,92,0,-1.784466299701283
ZCTA5 96106,92,0,92,0,-1.784466299701283
ZCTA5 98288,92,0,92,0,-1.784466299701283
ZCTA5 32440,2015,53,1962,0.02630272952853598,-1.7852499077061368
ZCTA5 75783,3040,84,2956,0.02763157894736842,-1.785344978491018
ZCTA5 94702,7466,222,7244,0.029734797749799088,-1.787253071132923
ZCTA5 49011,812,18,794,0.022167487684729065,-1.7885888391205724
ZCTA5 46407,4662,134,4528,0.028743028743028743,-1.7888862376026542
ZCTA5 12870,630,13,617,0.020634920634920634,-1.7893640428745883
ZCTA5 02744,4598,132,4466,0.028708133971291867,-1.7897234258145671
ZCTA5 61415,740,16,724,0.021621621621621623,-1.7900295828956787
ZCTA5 84341,7626,227,7399,0.02976658798846053,-1.7908638946685767
ZCTA5 35031,2845,78,2767,0.02741652021089631,-1.7909271026588494
ZCTA5 47528,194,2,192,0.010309278350515464,-1.7927538062166697
ZCTA5 69217,194,2,192,0.010309278350515464,-1.7927538062166697
ZCTA5 05463,194,2,192,0.010309278350515464,-1.7927538062166697
ZCTA5 97636,194,2,192,0.010309278350515464,-1.7927538062166697
ZCTA5 22560,2714,74,2640,0.027266028002947678,-1.7928085250729546
ZCTA5 38333,93,0,93,0,-1.7941382746066115
ZCTA5 42369,93,0,93,0,-1.7941382746066115
ZCTA5 42022,93,0,93,0,-1.7941382746066115
ZCTA5 51637,93,0,93,0,-1.7941382746066115
ZCTA5 87574,93,0,93,0,-1.7941382746066115
ZCTA5 59026,93,0,93,0,-1.7941382746066115
ZCTA5 61274,93,0,93,0,-1.7941382746066115
ZCTA5 62079,93,0,93,0,-1.7941382746066115
ZCTA5 67623,93,0,93,0,-1.7941382746066115
ZCTA5 67071,93,0,93,0,-1.7941382746066115
ZCTA5 70442,93,0,93,0,-1.7941382746066115
ZCTA5 69212,93,0,93,0,-1.7941382746066115
ZCTA5 56553,93,0,93,0,-1.7941382746066115
ZCTA5 56759,93,0,93,0,-1.7941382746066115
ZCTA5 72341,93,0,93,0,-1.7941382746066115
ZCTA5 84735,93,0,93,0,-1.7941382746066115
ZCTA5 04413,93,0,93,0,-1.7941382746066115
ZCTA5 12741,93,0,93,0,-1.7941382746066115
ZCTA5 16853,93,0,93,0,-1.7941382746066115
ZCTA5 13410,93,0,93,0,-1.7941382746066115
ZCTA5 15721,93,0,93,0,-1.7941382746066115
ZCTA5 17306,93,0,93,0,-1.7941382746066115
ZCTA5 18234,93,0,93,0,-1.7941382746066115
ZCTA5 18223,93,0,93,0,-1.7941382746066115
ZCTA5 25093,93,0,93,0,-1.7941382746066115
ZCTA5 97625,93,0,93,0,-1.7941382746066115
ZCTA5 97028,93,0,93,0,-1.7941382746066115
ZCTA5 72326,849,19,830,0.02237926972909305,-1.7945680367337762
ZCTA5 62422,442,8,434,0.01809954751131222,-1.7952116983399429
ZCTA5 82053,442,8,434,0.01809954751131222,-1.7952116983399429
ZCTA5 37829,741,16,725,0.021592442645074223,-1.795655805625699
ZCTA5 52572,403,7,396,0.017369727047146403,-1.7956588802981603
ZCTA5 61430,323,5,318,0.015479876160990712,-1.7964625283885394
ZCTA5 57335,147,1,146,0.006802721088435374,-1.7969828496415077
ZCTA5 74844,147,1,146,0.006802721088435374,-1.7969828496415077
ZCTA5 34610,5051,146,4905,0.028905167293605226,-1.7979416882975545
ZCTA5 75437,481,9,472,0.018711018711018712,-1.7981600518124907
ZCTA5 26292,282,4,278,0.014184397163120567,-1.7995589788217154
ZCTA5 46157,1341,33,1308,0.024608501118568233,-1.8014080972904727
ZCTA5 60457,4957,143,4814,0.028848093605003025,-1.8034795629941036
ZCTA5 72758,14717,453,14264,0.03078072976829517,-1.8036661790314474
ZCTA5 72136,520,10,510,0.019230769230769232,-1.803726513787073
ZCTA5 28554,94,0,94,0,-1.8037583879353658
ZCTA5 40062,94,0,94,0,-1.8037583879353658
ZCTA5 43010,94,0,94,0,-1.8037583879353658
ZCTA5 49919,94,0,94,0,-1.8037583879353658
ZCTA5 49822,94,0,94,0,-1.8037583879353658
ZCTA5 60549,94,0,94,0,-1.8037583879353658
ZCTA5 57449,94,0,94,0,-1.8037583879353658
ZCTA5 58317,94,0,94,0,-1.8037583879353658
ZCTA5 66959,94,0,94,0,-1.8037583879353658
ZCTA5 56162,94,0,94,0,-1.8037583879353658
ZCTA5 74836,94,0,94,0,-1.8037583879353658
ZCTA5 81136,94,0,94,0,-1.8037583879353658
ZCTA5 78585,94,0,94,0,-1.8037583879353658
ZCTA5 06376,94,0,94,0,-1.8037583879353658
ZCTA5 12036,94,0,94,0,-1.8037583879353658
ZCTA5 13859,94,0,94,0,-1.8037583879353658
ZCTA5 13666,94,0,94,0,-1.8037583879353658
ZCTA5 17215,94,0,94,0,-1.8037583879353658
ZCTA5 20838,94,0,94,0,-1.8037583879353658
ZCTA5 21669,94,0,94,0,-1.8037583879353658
ZCTA5 89414,94,0,94,0,-1.8037583879353658
ZCTA5 94074,94,0,94,0,-1.8037583879353658
ZCTA5 97369,94,0,94,0,-1.8037583879353658
ZCTA5 95248,94,0,94,0,-1.8037583879353658
ZCTA5 97343,94,0,94,0,-1.8037583879353658
ZCTA5 48733,706,15,691,0.021246458923512748,-1.8038588975846757
ZCTA5 40346,324,5,319,0.015432098765432098,-1.8040238156986403
ZCTA5 64637,240,3,237,0.0125,-1.8052646405225983
ZCTA5 28054,15185,468,14717,0.03081988804741521,-1.805285457988209
ZCTA5 80813,779,17,762,0.021822849807445442,-1.8053601431136583
ZCTA5 27823,3145,87,3058,0.02766295707472178,-1.8061297895835104
ZCTA5 48891,1134,27,1107,0.023809523809523808,-1.8061738411178414
ZCTA5 58570,148,1,147,0.006756756756756757,-1.806194351197949
ZCTA5 64682,148,1,147,0.006756756756756757,-1.806194351197949
ZCTA5 18917,887,20,867,0.02254791431792559,-1.8063578548079073
ZCTA5 49449,1169,28,1141,0.023952095808383235,-1.8067266334830043
ZCTA5 01340,743,16,727,0.021534320323014805,-1.8068879589608209
ZCTA5 07827,1616,41,1575,0.025371287128712873,-1.8069842806154535
ZCTA5 66035,283,4,279,0.014134275618374558,-1.8074358688538656
ZCTA5 83114,283,4,279,0.014134275618374558,-1.8074358688538656
ZCTA5 06065,283,4,279,0.014134275618374558,-1.8074358688538656
ZCTA5 62853,365,6,359,0.01643835616438356,-1.8078580618454154
ZCTA5 87522,923,21,902,0.02275189599133261,-1.8081867553732245
ZCTA5 49235,816,18,798,0.022058823529411766,-1.8102509543617349
ZCTA5 44506,1065,25,1040,0.023474178403755867,-1.8112215627039328
ZCTA5 48416,1854,48,1806,0.025889967637540454,-1.8112804806026492
ZCTA5 71945,559,11,548,0.01967799642218247,-1.811340755654161
ZCTA5 50048,325,5,320,0.015384615384615385,-1.8115660912805183
ZCTA5 73458,325,5,320,0.015384615384615385,-1.8115660912805183
ZCTA5 37690,1515,38,1477,0.025082508250825083,-1.8121129034746006
ZCTA5 42366,2123,56,2067,0.0263777673104098,-1.8132410946858772
ZCTA5 40840,95,0,95,0,-1.8133274650999995
ZCTA5 50057,95,0,95,0,-1.8133274650999995
ZCTA5 50863,95,0,95,0,-1.8133274650999995
ZCTA5 50465,95,0,95,0,-1.8133274650999995
ZCTA5 58632,95,0,95,0,-1.8133274650999995
ZCTA5 65083,95,0,95,0,-1.8133274650999995
ZCTA5 67574,95,0,95,0,-1.8133274650999995
ZCTA5 66850,95,0,95,0,-1.8133274650999995
ZCTA5 70076,95,0,95,0,-1.8133274650999995
ZCTA5 67650,95,0,95,0,-1.8133274650999995
ZCTA5 68419,95,0,95,0,-1.8133274650999995
ZCTA5 80822,95,0,95,0,-1.8133274650999995
ZCTA5 80830,95,0,95,0,-1.8133274650999995
ZCTA5 81251,95,0,95,0,-1.8133274650999995
ZCTA5 81320,95,0,95,0,-1.8133274650999995
ZCTA5 83533,95,0,95,0,-1.8133274650999995
ZCTA5 85931,95,0,95,0,-1.8133274650999995
ZCTA5 13602,95,0,95,0,-1.8133274650999995
ZCTA5 13115,95,0,95,0,-1.8133274650999995
ZCTA5 18460,95,0,95,0,-1.8133274650999995
ZCTA5 22749,95,0,95,0,-1.8133274650999995
ZCTA5 21523,95,0,95,0,-1.8133274650999995
ZCTA5 25913,95,0,95,0,-1.8133274650999995
ZCTA5 25051,95,0,95,0,-1.8133274650999995
ZCTA5 97904,95,0,95,0,-1.8133274650999995
ZCTA5 58521,241,3,238,0.012448132780082987,-1.81349949844293
ZCTA5 68722,241,3,238,0.012448132780082987,-1.81349949844293
ZCTA5 80438,284,4,280,0.014084507042253521,-1.8152906063954772
ZCTA5 11749,960,22,938,0.022916666666666665,-1.815681878956828
ZCTA5 95005,2787,76,2711,0.02726946537495515,-1.8157504762023406
ZCTA5 40873,889,20,869,0.02249718785151856,-1.8168042077179156
ZCTA5 93314,8934,268,8666,0.029997761361092456,-1.8168587867983768
ZCTA5 10522,3671,103,3568,0.028057749931898666,-1.8183081034847297
ZCTA5 68328,197,2,195,0.01015228426395939,-1.8188161741966251
ZCTA5 51430,326,5,321,0.015337423312883436,-1.8190894766158177
ZCTA5 00912,2491,67,2424,0.026896828582898435,-1.8200489267215396
ZCTA5 35456,1172,28,1144,0.023890784982935155,-1.82071595195911
ZCTA5 49788,1067,25,1042,0.023430178069353328,-1.8209142864886319
ZCTA5 52133,242,3,239,0.012396694214876033,-1.8217080472303715
ZCTA5 84657,242,3,239,0.012396694214876033,-1.8217080472303715
ZCTA5 57359,367,6,361,0.01634877384196185,-1.822348068921927
ZCTA5 29329,96,0,96,0,-1.8228463098475385
ZCTA5 41619,96,0,96,0,-1.8228463098475385
ZCTA5 43127,96,0,96,0,-1.8228463098475385
ZCTA5 45352,96,0,96,0,-1.8228463098475385
ZCTA5 48440,96,0,96,0,-1.8228463098475385
ZCTA5 47616,96,0,96,0,-1.8228463098475385
ZCTA5 61475,96,0,96,0,-1.8228463098475385
ZCTA5 63833,96,0,96,0,-1.8228463098475385
ZCTA5 62346,96,0,96,0,-1.8228463098475385
ZCTA5 64741,96,0,96,0,-1.8228463098475385
ZCTA5 66859,96,0,96,0,-1.8228463098475385
ZCTA5 66734,96,0,96,0,-1.8228463098475385
ZCTA5 66714,96,0,96,0,-1.8228463098475385
ZCTA5 67112,96,0,96,0,-1.8228463098475385
ZCTA5 87347,96,0,96,0,-1.8228463098475385
ZCTA5 03604,96,0,96,0,-1.8228463098475385
ZCTA5 08321,96,0,96,0,-1.8228463098475385
ZCTA5 12769,96,0,96,0,-1.8228463098475385
ZCTA5 12939,96,0,96,0,-1.8228463098475385
ZCTA5 14827,96,0,96,0,-1.8228463098475385
ZCTA5 15638,96,0,96,0,-1.8228463098475385
ZCTA5 20139,96,0,96,0,-1.8228463098475385
ZCTA5 24813,96,0,96,0,-1.8228463098475385
ZCTA5 23427,96,0,96,0,-1.8228463098475385
ZCTA5 92266,96,0,96,0,-1.8228463098475385
ZCTA5 70761,285,4,281,0.014035087719298246,-1.8231233517188008
ZCTA5 43728,561,11,550,0.0196078431372549,-1.8238186245460521
ZCTA5 77833,10071,304,9767,0.03018568166021249,-1.8241348003734197
ZCTA5 23009,2293,61,2232,0.026602703881378108,-1.8245413860131854
ZCTA5 56438,1103,26,1077,0.02357207615593835,-1.8251701801067448
ZCTA5 61501,673,14,659,0.020802377414561663,-1.8252630690186495
ZCTA5 68030,327,5,322,0.01529051987767584,-1.8265940919970562
ZCTA5 48133,2227,59,2168,0.026493039964077234,-1.8268712993858862
ZCTA5 64469,891,20,871,0.02244668911335578,-1.8272293818881196
ZCTA5 05154,198,2,196,0.010101010101010102,-1.8274389240302729
ZCTA5 72433,1278,31,1247,0.024256651017214397,-1.828533889752566
ZCTA5 74748,243,3,240,0.012345679012345678,-1.8298905067810582
ZCTA5 13477,562,11,551,0.019572953736654804,-1.830043057894625
ZCTA5 12567,1209,29,1180,0.023986765922249794,-1.8306733163565687
ZCTA5 61428,408,7,401,0.01715686274509804,-1.830674772568777
ZCTA5 81621,2461,66,2395,0.026818366517675742,-1.830702031409717
ZCTA5 95464,963,22,941,0.02284527518172378,-1.8308370093140918
ZCTA5 50483,286,4,282,0.013986013986013986,-1.8309342633126187
ZCTA5 44217,1451,36,1415,0.024810475534114404,-1.8310501854981087
ZCTA5 42160,674,14,660,0.020771513353115726,-1.8310746404814469
ZCTA5 31067,97,0,97,0,-1.832315705047465
ZCTA5 38781,97,0,97,0,-1.832315705047465
ZCTA5 41540,97,0,97,0,-1.832315705047465
ZCTA5 43408,97,0,97,0,-1.832315705047465
ZCTA5 57779,97,0,97,0,-1.832315705047465
ZCTA5 59928,97,0,97,0,-1.832315705047465
ZCTA5 57424,97,0,97,0,-1.832315705047465
ZCTA5 57052,97,0,97,0,-1.832315705047465
ZCTA5 62672,97,0,97,0,-1.832315705047465
ZCTA5 62928,97,0,97,0,-1.832315705047465
ZCTA5 65446,97,0,97,0,-1.832315705047465
ZCTA5 68977,97,0,97,0,-1.832315705047465
ZCTA5 67647,97,0,97,0,-1.832315705047465
ZCTA5 56226,97,0,97,0,-1.832315705047465
ZCTA5 72666,97,0,97,0,-1.832315705047465
ZCTA5 73673,97,0,97,0,-1.832315705047465
ZCTA5 73835,97,0,97,0,-1.832315705047465
ZCTA5 79078,97,0,97,0,-1.832315705047465
ZCTA5 83227,97,0,97,0,-1.832315705047465
ZCTA5 02553,97,0,97,0,-1.832315705047465
ZCTA5 08248,97,0,97,0,-1.832315705047465
ZCTA5 16940,97,0,97,0,-1.832315705047465
ZCTA5 16027,97,0,97,0,-1.832315705047465
ZCTA5 16245,97,0,97,0,-1.832315705047465
ZCTA5 17239,97,0,97,0,-1.832315705047465
ZCTA5 18628,97,0,97,0,-1.832315705047465
ZCTA5 26361,97,0,97,0,-1.832315705047465
ZCTA5 94964,97,0,97,0,-1.832315705047465
ZCTA5 96774,97,0,97,0,-1.832315705047465
ZCTA5 83116,328,5,323,0.01524390243902439,-1.8340800565430946
ZCTA5 83645,328,5,323,0.01524390243902439,-1.8340800565430946
ZCTA5 87008,1105,26,1079,0.023529411764705882,-1.8347111270459897
ZCTA5 83113,748,16,732,0.0213903743315508,-1.8348508843081777
ZCTA5 16311,199,2,197,0.010050251256281407,-1.8360298582135894
ZCTA5 03064,5804,169,5635,0.029117849758787045,-1.837198762067428
ZCTA5 54246,409,7,402,0.017114914425427872,-1.8376346718662602
ZCTA5 68047,712,15,697,0.021067415730337078,-1.838075931784192
ZCTA5 31030,6092,178,5914,0.029218647406434668,-1.8384771380452005
ZCTA5 15684,287,4,283,0.013937282229965157,-1.8387234979086697
ZCTA5 56443,601,12,589,0.019966722129783693,-1.8387924737962078
ZCTA5 95497,601,12,589,0.019966722129783693,-1.8387924737962078
ZCTA5 21562,1315,32,1283,0.024334600760456272,-1.8390948472867765
ZCTA5 75088,9104,273,8831,0.029986818980667837,-1.8398695022894949
ZCTA5 36793,98,0,98,0,-1.8417364134431367
ZCTA5 40209,98,0,98,0,-1.8417364134431367
ZCTA5 41759,98,0,98,0,-1.8417364134431367
ZCTA5 42788,98,0,98,0,-1.8417364134431367
ZCTA5 50132,98,0,98,0,-1.8417364134431367
ZCTA5 50594,98,0,98,0,-1.8417364134431367
ZCTA5 49611,98,0,98,0,-1.8417364134431367
ZCTA5 59411,98,0,98,0,-1.8417364134431367
ZCTA5 62518,98,0,98,0,-1.8417364134431367
ZCTA5 71662,98,0,98,0,-1.8417364134431367
ZCTA5 56113,98,0,98,0,-1.8417364134431367
ZCTA5 72663,98,0,98,0,-1.8417364134431367
ZCTA5 76268,98,0,98,0,-1.8417364134431367
ZCTA5 81656,98,0,98,0,-1.8417364134431367
ZCTA5 84762,98,0,98,0,-1.8417364134431367
ZCTA5 02873,98,0,98,0,-1.8417364134431367
ZCTA5 12495,98,0,98,0,-1.8417364134431367
ZCTA5 10519,98,0,98,0,-1.8417364134431367
ZCTA5 92239,98,0,98,0,-1.8417364134431367
ZCTA5 32332,526,10,516,0.019011406844106463,-1.8420808802630042
ZCTA5 56318,449,8,441,0.017817371937639197,-1.8426224122715638
ZCTA5 91773,11494,349,11145,0.030363668000696016,-1.8426333333500555
ZCTA5 38119,9767,294,9473,0.03010136172826866,-1.8427343809634202
ZCTA5 42087,894,20,874,0.02237136465324385,-1.8428276579958311
ZCTA5 98564,1001,23,978,0.022977022977022976,-1.843429416877303
ZCTA5 55956,786,17,769,0.021628498727735368,-1.84375468491698
ZCTA5 56433,786,17,769,0.021628498727735368,-1.84375468491698
ZCTA5 73456,786,17,769,0.021628498727735368,-1.84375468491698
ZCTA5 30624,1142,27,1115,0.023642732049036778,-1.843878809560408
ZCTA5 80246,7495,222,7273,0.02961974649766511,-1.846111940083159
ZCTA5 40140,245,3,242,0.012244897959183673,-1.8461780235891976
ZCTA5 38224,288,4,284,0.013888888888888888,-1.8464912105075846
ZCTA5 61516,288,4,284,0.013888888888888888,-1.8464912105075846
ZCTA5 62941,288,4,284,0.013888888888888888,-1.8464912105075846
ZCTA5 96073,1489,37,1452,0.024848891873740765,-1.8466279828647425
ZCTA5 31315,2433,65,2368,0.026715988491574187,-1.8483406786626788
ZCTA5 46760,527,10,517,0.018975332068311195,-1.8484365265216398
ZCTA5 03077,4104,116,3988,0.028265107212475632,-1.8486827557961865
ZCTA5 89145,9613,289,9324,0.030063455737022782,-1.8488172093979063
ZCTA5 57319,330,5,325,0.015151515151515152,-1.8489965038278207
ZCTA5 62883,330,5,325,0.015151515151515152,-1.8489965038278207
ZCTA5 76629,714,15,699,0.02100840336134454,-1.8494247943975726
ZCTA5 03835,2798,76,2722,0.027162258756254467,-1.8508663816602813
ZCTA5 38928,99,0,99,0,-1.8511091783687932
ZCTA5 41751,99,0,99,0,-1.8511091783687932
ZCTA5 46799,99,0,99,0,-1.8511091783687932
ZCTA5 59326,99,0,99,0,-1.8511091783687932
ZCTA5 58008,99,0,99,0,-1.8511091783687932
ZCTA5 61772,99,0,99,0,-1.8511091783687932
ZCTA5 67417,99,0,99,0,-1.8511091783687932
ZCTA5 67761,99,0,99,0,-1.8511091783687932
ZCTA5 68838,99,0,99,0,-1.8511091783687932
ZCTA5 72729,99,0,99,0,-1.8511091783687932
ZCTA5 73757,99,0,99,0,-1.8511091783687932
ZCTA5 76680,99,0,99,0,-1.8511091783687932
ZCTA5 82831,99,0,99,0,-1.8511091783687932
ZCTA5 78591,99,0,99,0,-1.8511091783687932
ZCTA5 81434,99,0,99,0,-1.8511091783687932
ZCTA5 08212,99,0,99,0,-1.8511091783687932
ZCTA5 12492,99,0,99,0,-1.8511091783687932
ZCTA5 15082,99,0,99,0,-1.8511091783687932
ZCTA5 15624,99,0,99,0,-1.8511091783687932
ZCTA5 17968,99,0,99,0,-1.8511091783687932
ZCTA5 15434,99,0,99,0,-1.8511091783687932
ZCTA5 18246,99,0,99,0,-1.8511091783687932
ZCTA5 22722,99,0,99,0,-1.8511091783687932
ZCTA5 20812,99,0,99,0,-1.8511091783687932
ZCTA5 95606,99,0,99,0,-1.8511091783687932
ZCTA5 52323,371,6,365,0.016172506738544475,-1.8511330499714578
ZCTA5 67346,153,1,152,0.006535947712418301,-1.851639846731014
ZCTA5 67051,201,2,199,0.009950248756218905,-1.853117534501473
ZCTA5 69169,246,3,243,0.012195121951219513,-1.8542835066175658
ZCTA5 13620,788,17,771,0.021573604060913704,-1.8546684567632834
ZCTA5 24931,528,10,518,0.01893939393939394,-1.8547817864614675
ZCTA5 11362,7151,211,6940,0.029506362746469027,-1.8565694774405161
ZCTA5 68456,490,9,481,0.018367346938775512,-1.8572110907247428
ZCTA5 36862,2469,66,2403,0.026731470230862697,-1.8576869695912739
ZCTA5 02670,679,14,665,0.020618556701030927,-1.860018842784131
ZCTA5 44838,100,0,100,0,-1.8604347244340471
ZCTA5 44697,100,0,100,0,-1.8604347244340471
ZCTA5 47035,100,0,100,0,-1.8604347244340471
ZCTA5 50116,100,0,100,0,-1.8604347244340471
ZCTA5 53931,100,0,100,0,-1.8604347244340471
ZCTA5 59755,100,0,100,0,-1.8604347244340471
ZCTA5 58223,100,0,100,0,-1.8604347244340471
ZCTA5 59710,100,0,100,0,-1.8604347244340471
ZCTA5 57021,100,0,100,0,-1.8604347244340471
ZCTA5 64467,100,0,100,0,-1.8604347244340471
ZCTA5 80432,100,0,100,0,-1.8604347244340471
ZCTA5 80757,100,0,100,0,-1.8604347244340471
ZCTA5 83657,100,0,100,0,-1.8604347244340471
ZCTA5 83806,100,0,100,0,-1.8604347244340471
ZCTA5 80824,100,0,100,0,-1.8604347244340471
ZCTA5 84038,100,0,100,0,-1.8604347244340471
ZCTA5 04855,100,0,100,0,-1.8604347244340471
ZCTA5 05067,100,0,100,0,-1.8604347244340471
ZCTA5 05902,100,0,100,0,-1.8604347244340471
ZCTA5 13636,100,0,100,0,-1.8604347244340471
ZCTA5 15647,100,0,100,0,-1.8604347244340471
ZCTA5 17979,100,0,100,0,-1.8604347244340471
ZCTA5 17371,100,0,100,0,-1.8604347244340471
ZCTA5 22548,100,0,100,0,-1.8604347244340471
ZCTA5 23021,100,0,100,0,-1.8604347244340471
ZCTA5 25261,100,0,100,0,-1.8604347244340471
ZCTA5 26342,100,0,100,0,-1.8604347244340471
ZCTA5 91046,100,0,100,0,-1.8604347244340471
ZCTA5 97357,100,0,100,0,-1.8604347244340471
ZCTA5 99755,100,0,100,0,-1.8604347244340471
ZCTA5 52163,154,1,153,0.006493506493506494,-1.860610048027029
ZCTA5 67054,529,10,519,0.01890359168241966,-1.8611167019298214
ZCTA5 15329,529,10,519,0.01890359168241966,-1.8611167019298214
ZCTA5 97813,529,10,519,0.01890359168241966,-1.8611167019298214
ZCTA5 05778,247,3,244,0.012145748987854251,-1.8623637520460161
ZCTA5 05774,452,8,444,0.017699115044247787,-1.8627495812162727
ZCTA5 57241,413,7,406,0.01694915254237288,-1.8653324657307047
ZCTA5 75479,680,14,666,0.020588235294117647,-1.8657851201721327
ZCTA5 79765,5272,152,5120,0.028831562974203338,-1.866574283598537
ZCTA5 14589,2869,78,2791,0.02718717323109097,-1.8667810820908843
ZCTA5 41074,2138,56,2082,0.026192703461178673,-1.8672225517154708
ZCTA5 46773,1252,30,1222,0.023961661341853034,-1.867884180852522
ZCTA5 36071,155,1,154,0.0064516129032258064,-1.8695417394908436
ZCTA5 31547,101,0,101,0,-1.8697137581776488
ZCTA5 50527,101,0,101,0,-1.8697137581776488
ZCTA5 52359,101,0,101,0,-1.8697137581776488
ZCTA5 87832,101,0,101,0,-1.8697137581776488
ZCTA5 58486,101,0,101,0,-1.8697137581776488
ZCTA5 57646,101,0,101,0,-1.8697137581776488
ZCTA5 62811,101,0,101,0,-1.8697137581776488
ZCTA5 58643,101,0,101,0,-1.8697137581776488
ZCTA5 62438,101,0,101,0,-1.8697137581776488
ZCTA5 64639,101,0,101,0,-1.8697137581776488
ZCTA5 66941,101,0,101,0,-1.8697137581776488
ZCTA5 70585,101,0,101,0,-1.8697137581776488
ZCTA5 67492,101,0,101,0,-1.8697137581776488
ZCTA5 68728,101,0,101,0,-1.8697137581776488
ZCTA5 56581,101,0,101,0,-1.8697137581776488
ZCTA5 76858,101,0,101,0,-1.8697137581776488
ZCTA5 83840,101,0,101,0,-1.8697137581776488
ZCTA5 82929,101,0,101,0,-1.8697137581776488
ZCTA5 88052,101,0,101,0,-1.8697137581776488
ZCTA5 78837,101,0,101,0,-1.8697137581776488
ZCTA5 84749,101,0,101,0,-1.8697137581776488
ZCTA5 83821,101,0,101,0,-1.8697137581776488
ZCTA5 05254,101,0,101,0,-1.8697137581776488
ZCTA5 15440,101,0,101,0,-1.8697137581776488
ZCTA5 18602,101,0,101,0,-1.8697137581776488
ZCTA5 24882,101,0,101,0,-1.8697137581776488
ZCTA5 24845,101,0,101,0,-1.8697137581776488
ZCTA5 89039,101,0,101,0,-1.8697137581776488
ZCTA5 96116,101,0,101,0,-1.8697137581776488
ZCTA5 99586,101,0,101,0,-1.8697137581776488
ZCTA5 07885,3787,106,3681,0.02799049379456034,-1.8698297313775956
ZCTA5 58541,203,2,201,0.009852216748768473,-1.870081664720697
ZCTA5 68016,203,2,201,0.009852216748768473,-1.870081664720697
ZCTA5 84064,203,2,201,0.009852216748768473,-1.870081664720697
ZCTA5 89316,492,9,483,0.018292682926829267,-1.8702074024021993
ZCTA5 03582,1042,24,1018,0.023032629558541268,-1.870820980594572
ZCTA5 06068,681,14,667,0.020558002936857563,-1.871543931976824
ZCTA5 38633,718,15,703,0.020891364902506964,-1.8720383212161198
ZCTA5 76088,4048,114,3934,0.02816205533596838,-1.8724884887982414
ZCTA5 63530,374,6,368,0.016042780748663103,-1.8725540080015874
ZCTA5 76453,569,11,558,0.019332161687170474,-1.8733468032964447
ZCTA5 85624,569,11,558,0.019332161687170474,-1.8733468032964447
ZCTA5 39851,900,20,880,0.022222222222222223,-1.8738833214237944
ZCTA5 39358,607,12,595,0.019769357495881382,-1.8749895974694282
ZCTA5 59001,607,12,595,0.019769357495881382,-1.8749895974694282
ZCTA5 64076,3561,99,3462,0.02780117944397641,-1.8760028344495883
ZCTA5 76569,792,17,775,0.021464646464646464,-1.8764220897931165
ZCTA5 32714,14829,455,14374,0.03068312091172702,-1.8766173850529497
ZCTA5 79529,493,9,484,0.018255578093306288,-1.8766886541010104
ZCTA5 95528,493,9,484,0.018255578093306288,-1.8766886541010104
ZCTA5 62854,682,14,668,0.020527859237536656,-1.877295301731603
ZCTA5 62075,1393,34,1359,0.024407753050969132,-1.8776693424895317
ZCTA5 82221,156,1,155,0.00641025641025641,-1.8784353837559777
ZCTA5 58573,249,3,246,0.012048192771084338,-1.8784493521343413
ZCTA5 51007,204,2,202,0.00980392156862745,-1.8785181488050064
ZCTA5 17213,204,2,202,0.00980392156862745,-1.8785181488050064
ZCTA5 72513,1079,25,1054,0.023169601482854494,-1.8787253537605786
ZCTA5 40171,102,0,102,0,-1.878946968692195
ZCTA5 54214,102,0,102,0,-1.878946968692195
ZCTA5 58727,102,0,102,0,-1.878946968692195
ZCTA5 58853,102,0,102,0,-1.878946968692195
ZCTA5 58490,102,0,102,0,-1.878946968692195
ZCTA5 64480,102,0,102,0,-1.878946968692195
ZCTA5 64164,102,0,102,0,-1.878946968692195
ZCTA5 64745,102,0,102,0,-1.878946968692195
ZCTA5 76845,102,0,102,0,-1.878946968692195
ZCTA5 79780,102,0,102,0,-1.878946968692195
ZCTA5 87044,102,0,102,0,-1.878946968692195
ZCTA5 83809,102,0,102,0,-1.878946968692195
ZCTA5 05862,102,0,102,0,-1.878946968692195
ZCTA5 14592,102,0,102,0,-1.878946968692195
ZCTA5 13483,102,0,102,0,-1.878946968692195
ZCTA5 15020,102,0,102,0,-1.878946968692195
ZCTA5 19316,102,0,102,0,-1.878946968692195
ZCTA5 22529,102,0,102,0,-1.878946968692195
ZCTA5 24847,102,0,102,0,-1.878946968692195
ZCTA5 26209,102,0,102,0,-1.878946968692195
ZCTA5 96040,102,0,102,0,-1.878946968692195
ZCTA5 23040,1702,43,1659,0.02526439482961222,-1.878966826058513
ZCTA5 65789,570,11,559,0.01929824561403509,-1.8794952988087046
ZCTA5 36785,532,10,522,0.018796992481203006,-1.8800597961529621
ZCTA5 50056,532,10,522,0.018796992481203006,-1.8800597961529621
ZCTA5 28080,3038,83,2955,0.027320605661619486,-1.8800767371454754
ZCTA5 76861,608,12,596,0.019736842105263157,-1.8809920898175132
ZCTA5 08034,6972,205,6767,0.02940332759609868,-1.8810298665993122
ZCTA5 81101,5824,169,5655,0.029017857142857144,-1.8827981561325176
ZCTA5 76537,1805,46,1759,0.02548476454293629,-1.8829205595596619
ZCTA5 27981,720,15,705,0.020833333333333332,-1.8833033215926813
ZCTA5 55926,293,4,289,0.013651877133105802,-1.8850122505589642
ZCTA5 23347,293,4,289,0.013651877133105802,-1.8850122505589642
ZCTA5 44887,335,5,330,0.014925373134328358,-1.8859693514170939
ZCTA5 64790,335,5,330,0.014925373134328358,-1.8859693514170939
ZCTA5 98445,11332,343,10989,0.03026826685492411,-1.8860787225934537
ZCTA5 70576,250,3,247,0.012,-1.8864551113332924
ZCTA5 57260,376,6,370,0.015957446808510637,-1.8867560899181408
ZCTA5 04942,609,12,597,0.019704433497536946,-1.886985988802834
ZCTA5 38310,2311,61,2250,0.026395499783643445,-1.8870825303593282
ZCTA5 29525,794,17,777,0.021410579345088162,-1.8872622192805915
ZCTA5 66754,157,1,156,0.006369426751592357,-1.8872914346140652
ZCTA5 37848,103,0,103,0,-1.8881350282213367
ZCTA5 36529,103,0,103,0,-1.8881350282213367
ZCTA5 40914,103,0,103,0,-1.8881350282213367
ZCTA5 40946,103,0,103,0,-1.8881350282213367
ZCTA5 43438,103,0,103,0,-1.8881350282213367
ZCTA5 43740,103,0,103,0,-1.8881350282213367
ZCTA5 46290,103,0,103,0,-1.8881350282213367
ZCTA5 51444,103,0,103,0,-1.8881350282213367
ZCTA5 54160,103,0,103,0,-1.8881350282213367
ZCTA5 59451,103,0,103,0,-1.8881350282213367
ZCTA5 58233,103,0,103,0,-1.8881350282213367
ZCTA5 57435,103,0,103,0,-1.8881350282213367
ZCTA5 57576,103,0,103,0,-1.8881350282213367
ZCTA5 57791,103,0,103,0,-1.8881350282213367
ZCTA5 61044,103,0,103,0,-1.8881350282213367
ZCTA5 62695,103,0,103,0,-1.8881350282213367
ZCTA5 64667,103,0,103,0,-1.8881350282213367
ZCTA5 67564,103,0,103,0,-1.8881350282213367
ZCTA5 70580,103,0,103,0,-1.8881350282213367
ZCTA5 74540,103,0,103,0,-1.8881350282213367
ZCTA5 76852,103,0,103,0,-1.8881350282213367
ZCTA5 76388,103,0,103,0,-1.8881350282213367
ZCTA5 84630,103,0,103,0,-1.8881350282213367
ZCTA5 04451,103,0,103,0,-1.8881350282213367
ZCTA5 12452,103,0,103,0,-1.8881350282213367
ZCTA5 14736,103,0,103,0,-1.8881350282213367
ZCTA5 17952,103,0,103,0,-1.8881350282213367
ZCTA5 22643,103,0,103,0,-1.8881350282213367
ZCTA5 23068,103,0,103,0,-1.8881350282213367
ZCTA5 24927,103,0,103,0,-1.8881350282213367
ZCTA5 26560,103,0,103,0,-1.8881350282213367
ZCTA5 95728,103,0,103,0,-1.8881350282213367
ZCTA5 97484,103,0,103,0,-1.8881350282213367
ZCTA5 97050,103,0,103,0,-1.8881350282213367
ZCTA5 55790,939,21,918,0.022364217252396165,-1.889856142659592
ZCTA5 78701,5571,161,5410,0.028899658948124216,-1.890510323448434
ZCTA5 73103,2645,71,2574,0.026843100189035917,-1.890831990453511
ZCTA5 27016,534,10,524,0.018726591760299626,-1.8926375590571194
ZCTA5 56311,294,4,290,0.013605442176870748,-1.8926539923965524
ZCTA5 25507,336,5,331,0.01488095238095238,-1.8933102616339226
ZCTA5 77591,5380,155,5225,0.028810408921933085,-1.8942250400278664
ZCTA5 71061,685,14,671,0.020437956204379562,-1.8945049923517394
ZCTA5 76471,685,14,671,0.020437956204379562,-1.8945049923517394
ZCTA5 56551,868,19,849,0.021889400921658985,-1.894798163414771
ZCTA5 75423,1047,24,1023,0.022922636103151862,-1.8950967651143984
ZCTA5 45354,206,2,204,0.009708737864077669,-1.8953014128892818
ZCTA5 58843,206,2,204,0.009708737864077669,-1.8953014128892818
ZCTA5 84776,206,2,204,0.009708737864077669,-1.8953014128892818
ZCTA5 40972,496,9,487,0.018145161290322582,-1.8960653720134908
ZCTA5 69134,158,1,157,0.006329113924050633,-1.8961103372434964
ZCTA5 26205,1328,32,1296,0.024096385542168676,-1.8964391187947156
ZCTA5 33190,4608,131,4477,0.028428819444444444,-1.8971103895283306
ZCTA5 32061,104,0,104,0,-1.8972785927309643
ZCTA5 32658,104,0,104,0,-1.8972785927309643
ZCTA5 33944,104,0,104,0,-1.8972785927309643
ZCTA5 37732,104,0,104,0,-1.8972785927309643
ZCTA5 43926,104,0,104,0,-1.8972785927309643
ZCTA5 42715,104,0,104,0,-1.8972785927309643
ZCTA5 45819,104,0,104,0,-1.8972785927309643
ZCTA5 47863,104,0,104,0,-1.8972785927309643
ZCTA5 49764,104,0,104,0,-1.8972785927309643
ZCTA5 52543,104,0,104,0,-1.8972785927309643
ZCTA5 63030,104,0,104,0,-1.8972785927309643
ZCTA5 88056,104,0,104,0,-1.8972785927309643
ZCTA5 83834,104,0,104,0,-1.8972785927309643
ZCTA5 87723,104,0,104,0,-1.8972785927309643
ZCTA5 12042,104,0,104,0,-1.8972785927309643
ZCTA5 26707,104,0,104,0,-1.8972785927309643
ZCTA5 24738,104,0,104,0,-1.8972785927309643
ZCTA5 99401,104,0,104,0,-1.8972785927309643
ZCTA5 03836,573,11,562,0.019197207678883072,-1.897884929833002
ZCTA5 29372,1536,38,1498,0.024739583333333332,-1.8993696885066185
ZCTA5 07718,2348,62,2286,0.026405451448040886,-1.8994473176322493
ZCTA5 73460,1945,50,1895,0.02570694087403599,-1.900088366227504
ZCTA5 45634,686,14,672,0.02040816326530612,-1.9002268270075005
ZCTA5 54746,295,4,291,0.013559322033898305,-1.9002752508517604
ZCTA5 62358,295,4,291,0.013559322033898305,-1.9002752508517604
ZCTA5 72025,295,4,291,0.013559322033898305,-1.9002752508517604
ZCTA5 24828,337,5,332,0.01483679525222552,-1.900633542703643
ZCTA5 68827,252,3,249,0.011904761904761904,-1.9023935404151677
ZCTA5 31545,5705,165,5540,0.028921998247151623,-1.903728164655772
ZCTA5 89179,2081,54,2027,0.025949062950504566,-1.9039724955911757
ZCTA5 62354,612,12,600,0.0196078431372549,-1.9049164262959304
ZCTA5 49327,3112,85,3027,0.02731362467866324,-1.9050022575894043
ZCTA5 46788,1120,26,1094,0.023214285714285715,-1.9057703813569293
ZCTA5 40939,105,0,105,0,-1.9063783024557293
ZCTA5 47114,105,0,105,0,-1.9063783024557293
ZCTA5 49942,105,0,105,0,-1.9063783024557293
ZCTA5 49962,105,0,105,0,-1.9063783024557293
ZCTA5 50556,105,0,105,0,-1.9063783024557293
ZCTA5 58036,105,0,105,0,-1.9063783024557293
ZCTA5 59219,105,0,105,0,-1.9063783024557293
ZCTA5 62370,105,0,105,0,-1.9063783024557293
ZCTA5 62886,105,0,105,0,-1.9063783024557293
ZCTA5 68816,105,0,105,0,-1.9063783024557293
ZCTA5 56335,105,0,105,0,-1.9063783024557293
ZCTA5 73021,105,0,105,0,-1.9063783024557293
ZCTA5 79538,105,0,105,0,-1.9063783024557293
ZCTA5 83348,105,0,105,0,-1.9063783024557293
ZCTA5 01009,105,0,105,0,-1.9063783024557293
ZCTA5 12745,105,0,105,0,-1.9063783024557293
ZCTA5 24612,105,0,105,0,-1.9063783024557293
ZCTA5 24628,105,0,105,0,-1.9063783024557293
ZCTA5 89412,105,0,105,0,-1.9063783024557293
ZCTA5 26438,105,0,105,0,-1.9063783024557293
ZCTA5 32234,2183,57,2126,0.026110856619331196,-1.9080369048218266
ZCTA5 72031,2816,76,2740,0.026988636363636364,-1.9080474821295321
ZCTA5 19956,5675,164,5511,0.028898678414096917,-1.9084856283042002
ZCTA5 73754,459,8,451,0.017429193899782137,-1.9092773963583132
ZCTA5 12184,2551,68,2483,0.026656213249705997,-1.9094216530728991
ZCTA5 48659,1050,24,1026,0.022857142857142857,-1.909611826103652
ZCTA5 01801,15756,484,15272,0.03071845646103072,-1.9097184766206805
ZCTA5 24892,575,11,564,0.019130434782608695,-1.9100984834983064
ZCTA5 72941,2049,53,1996,0.025866276232308444,-1.9101167377550308
ZCTA5 68957,253,3,250,0.011857707509881422,-1.910326599835959
ZCTA5 74630,253,3,250,0.011857707509881422,-1.910326599835959
ZCTA5 56309,537,10,527,0.0186219739292365,-1.9114285628775138
ZCTA5 24631,835,18,817,0.02155688622754491,-1.9118644687404576
ZCTA5 63048,1401,34,1367,0.02426837972876517,-1.9120642960908552
ZCTA5 38870,1015,23,992,0.022660098522167486,-1.9124260495652807
ZCTA5 21625,1015,23,992,0.022660098522167486,-1.9124260495652807
ZCTA5 04463,1297,31,1266,0.023901310717039322,-1.9132429569960703
ZCTA5 10023,33693,1064,32629,0.03157925978689936,-1.91395553131857
ZCTA5 20852,20577,639,19938,0.031054089517422365,-1.914671794930447
ZCTA5 38670,339,5,334,0.014749262536873156,-1.9152276491051268
ZCTA5 32157,106,0,106,0,-1.9154347824222018
ZCTA5 33039,106,0,106,0,-1.9154347824222018
ZCTA5 47552,106,0,106,0,-1.9154347824222018
ZCTA5 50521,106,0,106,0,-1.9154347824222018
ZCTA5 54850,106,0,106,0,-1.9154347824222018
ZCTA5 57722,106,0,106,0,-1.9154347824222018
ZCTA5 59631,106,0,106,0,-1.9154347824222018
ZCTA5 59250,106,0,106,0,-1.9154347824222018
ZCTA5 64036,106,0,106,0,-1.9154347824222018
ZCTA5 67111,106,0,106,0,-1.9154347824222018
ZCTA5 68711,106,0,106,0,-1.9154347824222018
ZCTA5 68365,106,0,106,0,-1.9154347824222018
ZCTA5 56153,106,0,106,0,-1.9154347824222018
ZCTA5 80742,106,0,106,0,-1.9154347824222018
ZCTA5 76882,106,0,106,0,-1.9154347824222018
ZCTA5 88318,106,0,106,0,-1.9154347824222018
ZCTA5 79505,106,0,106,0,-1.9154347824222018
ZCTA5 12976,106,0,106,0,-1.9154347824222018
ZCTA5 13305,106,0,106,0,-1.9154347824222018
ZCTA5 15448,106,0,106,0,-1.9154347824222018
ZCTA5 17570,106,0,106,0,-1.9154347824222018
ZCTA5 16246,106,0,106,0,-1.9154347824222018
ZCTA5 16244,106,0,106,0,-1.9154347824222018
ZCTA5 15738,106,0,106,0,-1.9154347824222018
ZCTA5 17779,106,0,106,0,-1.9154347824222018
ZCTA5 24731,106,0,106,0,-1.9154347824222018
ZCTA5 25030,106,0,106,0,-1.9154347824222018
ZCTA5 23401,106,0,106,0,-1.9154347824222018
ZCTA5 23952,106,0,106,0,-1.9154347824222018
ZCTA5 25444,106,0,106,0,-1.9154347824222018
ZCTA5 27978,106,0,106,0,-1.9154347824222018
ZCTA5 97134,106,0,106,0,-1.9154347824222018
ZCTA5 41824,576,11,565,0.019097222222222224,-1.9161915029753496
ZCTA5 49645,614,12,602,0.019543973941368076,-1.9168276330002942
ZCTA5 63147,3804,106,3698,0.02786540483701367,-1.916926357049073
ZCTA5 82331,1016,23,993,0.022637795275590553,-1.917321366155619
ZCTA5 65035,689,14,675,0.020319303338171262,-1.9173484660388287
ZCTA5 25537,689,14,675,0.020319303338171262,-1.9173484660388287
ZCTA5 69358,763,16,747,0.020969855832241154,-1.917753861175332
ZCTA5 92860,7149,210,6939,0.029374737725556023,-1.9182003722593917
ZCTA5 17087,945,21,924,0.022222222222222223,-1.9201590135782465
ZCTA5 52073,500,9,491,0.018,-1.9217463491155748
ZCTA5 50149,381,6,375,0.015748031496062992,-1.9219913932647166
ZCTA5 72730,3315,91,3224,0.027450980392156862,-1.9221740718254134
ZCTA5 31022,577,11,566,0.019064124783362217,-1.9222753960991785
ZCTA5 56570,461,8,453,0.01735357917570499,-1.9224611117845452
ZCTA5 78663,340,5,335,0.014705882352941176,-1.922498687753974
ZCTA5 29850,107,0,107,0,-1.9244486429498677
ZCTA5 43519,107,0,107,0,-1.9244486429498677
ZCTA5 53935,107,0,107,0,-1.9244486429498677
ZCTA5 51447,107,0,107,0,-1.9244486429498677
ZCTA5 54637,107,0,107,0,-1.9244486429498677
ZCTA5 58758,107,0,107,0,-1.9244486429498677
ZCTA5 58497,107,0,107,0,-1.9244486429498677
ZCTA5 59827,107,0,107,0,-1.9244486429498677
ZCTA5 62967,107,0,107,0,-1.9244486429498677
ZCTA5 61243,107,0,107,0,-1.9244486429498677
ZCTA5 61815,107,0,107,0,-1.9244486429498677
ZCTA5 68433,107,0,107,0,-1.9244486429498677
ZCTA5 67744,107,0,107,0,-1.9244486429498677
ZCTA5 80532,107,0,107,0,-1.9244486429498677
ZCTA5 13418,107,0,107,0,-1.9244486429498677
ZCTA5 14874,107,0,107,0,-1.9244486429498677
ZCTA5 17072,107,0,107,0,-1.9244486429498677
ZCTA5 22820,107,0,107,0,-1.9244486429498677
ZCTA5 23828,107,0,107,0,-1.9244486429498677
ZCTA5 26276,107,0,107,0,-1.9244486429498677
ZCTA5 25837,107,0,107,0,-1.9244486429498677
ZCTA5 24086,107,0,107,0,-1.9244486429498677
ZCTA5 95488,107,0,107,0,-1.9244486429498677
ZCTA5 97730,107,0,107,0,-1.9244486429498677
ZCTA5 93226,107,0,107,0,-1.9244486429498677
ZCTA5 31784,255,3,252,0.011764705882352941,-1.9261213642433932
ZCTA5 61839,255,3,252,0.011764705882352941,-1.9261213642433932
ZCTA5 63879,255,3,252,0.011764705882352941,-1.9261213642433932
ZCTA5 68313,255,3,252,0.011764705882352941,-1.9261213642433932
ZCTA5 56754,255,3,252,0.011764705882352941,-1.9261213642433932
ZCTA5 16674,255,3,252,0.011764705882352941,-1.9261213642433932
ZCTA5 27316,2523,67,2456,0.026555687673404677,-1.9269938299485496
ZCTA5 17302,1018,23,995,0.022593320235756387,-1.9270989534192922
ZCTA5 54623,838,18,820,0.021479713603818614,-1.927719503997394
ZCTA5 74839,210,2,208,0.009523809523809525,-1.928517017186009
ZCTA5 50076,691,14,677,0.020260492040520984,-1.9287265653072725
ZCTA5 66531,691,14,677,0.020260492040520984,-1.9287265653072725
ZCTA5 04457,2390,63,2327,0.026359832635983262,-1.9287626722176743
ZCTA5 78226,2457,65,2392,0.026455026455026454,-1.9293701261687597
ZCTA5 77612,3252,89,3163,0.027367773677736778,-1.9302088668443234
ZCTA5 63465,162,1,161,0.006172839506172839,-1.9310230797714354
ZCTA5 16230,162,1,161,0.006172839506172839,-1.9310230797714354
ZCTA5 81625,4945,141,4804,0.028513650151668353,-1.9320836214177743
ZCTA5 30629,1784,45,1739,0.02522421524663677,-1.9331351036093558
ZCTA5 46984,108,0,108,0,-1.9334204801311037
ZCTA5 45033,108,0,108,0,-1.9334204801311037
ZCTA5 47871,108,0,108,0,-1.9334204801311037
ZCTA5 47382,108,0,108,0,-1.9334204801311037
ZCTA5 51044,108,0,108,0,-1.9334204801311037
ZCTA5 55615,108,0,108,0,-1.9334204801311037
ZCTA5 59748,108,0,108,0,-1.9334204801311037
ZCTA5 63538,108,0,108,0,-1.9334204801311037
ZCTA5 67341,108,0,108,0,-1.9334204801311037
ZCTA5 66942,108,0,108,0,-1.9334204801311037
ZCTA5 69168,108,0,108,0,-1.9334204801311037
ZCTA5 76445,108,0,108,0,-1.9334204801311037
ZCTA5 77987,108,0,108,0,-1.9334204801311037
ZCTA5 84530,108,0,108,0,-1.9334204801311037
ZCTA5 82432,108,0,108,0,-1.9334204801311037
ZCTA5 03231,108,0,108,0,-1.9334204801311037
ZCTA5 12174,108,0,108,0,-1.9334204801311037
ZCTA5 12574,108,0,108,0,-1.9334204801311037
ZCTA5 16024,108,0,108,0,-1.9334204801311037
ZCTA5 12493,108,0,108,0,-1.9334204801311037
ZCTA5 13435,108,0,108,0,-1.9334204801311037
ZCTA5 16725,108,0,108,0,-1.9334204801311037
ZCTA5 21647,108,0,108,0,-1.9334204801311037
ZCTA5 21650,108,0,108,0,-1.9334204801311037
ZCTA5 24920,108,0,108,0,-1.9334204801311037
ZCTA5 26148,108,0,108,0,-1.9334204801311037
ZCTA5 94569,108,0,108,0,-1.9334204801311037
ZCTA5 96125,108,0,108,0,-1.9334204801311037
ZCTA5 62972,423,7,416,0.016548463356973995,-1.9336091745594048
ZCTA5 56068,423,7,416,0.016548463356973995,-1.9336091745594048
ZCTA5 56323,256,3,253,0.01171875,-1.9339834445036903
ZCTA5 14748,256,3,253,0.01171875,-1.9339834445036903
ZCTA5 63769,502,9,493,0.017928286852589643,-1.9345214016823609
ZCTA5 92845,5655,163,5492,0.028824049513704687,-1.9363291670913558
ZCTA5 51571,211,2,209,0.009478672985781991,-1.936749404986941
ZCTA5 26074,211,2,209,0.009478672985781991,-1.936749404986941
ZCTA5 49716,342,5,337,0.014619883040935672,-1.9369892617694715
ZCTA5 20166,3942,110,3832,0.027904616945712835,-1.9376961425968706
ZCTA5 82939,580,11,569,0.01896551724137931,-1.9404726531604026
ZCTA5 75770,1198,28,1170,0.02337228714524207,-1.9406026557975193
ZCTA5 75158,1373,33,1340,0.02403495994173343,-1.9409598722356138
ZCTA5 81326,804,17,787,0.021144278606965175,-1.9411012642927254
ZCTA5 56258,5946,172,5774,0.02892700975445678,-1.94137341957873
ZCTA5 68768,257,3,254,0.011673151750972763,-1.9418222364915048
ZCTA5 35615,109,0,109,0,-1.9423508762911987
ZCTA5 41560,109,0,109,0,-1.9423508762911987
ZCTA5 45674,109,0,109,0,-1.9423508762911987
ZCTA5 47388,109,0,109,0,-1.9423508762911987
ZCTA5 58549,109,0,109,0,-1.9423508762911987
ZCTA5 62352,109,0,109,0,-1.9423508762911987
ZCTA5 63941,109,0,109,0,-1.9423508762911987
ZCTA5 65618,109,0,109,0,-1.9423508762911987
ZCTA5 67733,109,0,109,0,-1.9423508762911987
ZCTA5 56276,109,0,109,0,-1.9423508762911987
ZCTA5 56032,109,0,109,0,-1.9423508762911987
ZCTA5 72440,109,0,109,0,-1.9423508762911987
ZCTA5 72449,109,0,109,0,-1.9423508762911987
ZCTA5 72683,109,0,109,0,-1.9423508762911987
ZCTA5 82059,109,0,109,0,-1.9423508762911987
ZCTA5 06373,109,0,109,0,-1.9423508762911987
ZCTA5 95639,109,0,109,0,-1.9423508762911987
ZCTA5 73082,1057,24,1033,0.02270577105014191,-1.9433347873961802
ZCTA5 94535,1057,24,1033,0.02270577105014191,-1.9433347873961802
ZCTA5 74056,2193,57,2136,0.025991792065663474,-1.9434095002116079
ZCTA5 06042,9729,291,9438,0.029910576626580327,-1.943796764348006
ZCTA5 45328,212,2,210,0.009433962264150943,-1.9449537186289283
ZCTA5 54757,1374,33,1341,0.024017467248908297,-1.9452724711793348
ZCTA5 62842,301,4,297,0.013289036544850499,-1.9455804992115606
ZCTA5 13072,301,4,297,0.013289036544850499,-1.9455804992115606
ZCTA5 39323,619,12,607,0.01938610662358643,-1.9464588985473805
ZCTA5 97021,425,7,418,0.01647058823529412,-1.9471030086798278
ZCTA5 36853,3258,89,3169,0.027317372621240024,-1.9479871471984636
ZCTA5 59275,164,1,163,0.006097560975609756,-1.9482675392304936
ZCTA5 68971,164,1,163,0.006097560975609756,-1.9482675392304936
ZCTA5 56342,1235,29,1206,0.02348178137651822,-1.9489436226023065
ZCTA5 31206,9195,274,8921,0.029798803697661774,-1.949302975013019
ZCTA5 16038,1375,33,1342,0.024,-1.9495821900531287
ZCTA5 67853,258,3,255,0.011627906976744186,-1.949637922161005
ZCTA5 71747,385,6,379,0.015584415584415584,-1.9499075666458734
ZCTA5 29519,110,0,110,0,-1.951240400429426
ZCTA5 28076,110,0,110,0,-1.951240400429426
ZCTA5 39836,110,0,110,0,-1.951240400429426
ZCTA5 51648,110,0,110,0,-1.951240400429426
ZCTA5 54862,110,0,110,0,-1.951240400429426
ZCTA5 62419,110,0,110,0,-1.951240400429426
ZCTA5 66761,110,0,110,0,-1.951240400429426
ZCTA5 71853,110,0,110,0,-1.951240400429426
ZCTA5 73622,110,0,110,0,-1.951240400429426
ZCTA5 80722,110,0,110,0,-1.951240400429426
ZCTA5 78931,110,0,110,0,-1.951240400429426
ZCTA5 05084,110,0,110,0,-1.951240400429426
ZCTA5 15540,110,0,110,0,-1.951240400429426
ZCTA5 25849,110,0,110,0,-1.951240400429426
ZCTA5 26224,110,0,110,0,-1.951240400429426
ZCTA5 38076,344,5,339,0.014534883720930232,-1.9514118544461956
ZCTA5 98941,302,4,298,0.013245033112582781,-1.9530622673360132
ZCTA5 81057,213,2,211,0.009389671361502348,-1.9531302169326739
ZCTA5 87002,8596,255,8341,0.029664960446719405,-1.953750350333715
ZCTA5 55991,544,10,534,0.01838235294117647,-1.954926787826238
ZCTA5 23219,2698,72,2626,0.026686434395848776,-1.9549362320595582
ZCTA5 12758,1584,39,1545,0.02462121212121212,-1.9550181643934674
ZCTA5 28210,20579,638,19941,0.03100247825453132,-1.9559385295730405
ZCTA5 13697,770,16,754,0.02077922077922078,-1.9559486856199013
ZCTA5 73627,165,1,164,0.006060606060606061,-1.9568381904655543
ZCTA5 38342,583,11,572,0.018867924528301886,-1.9585889741050957
ZCTA5 49276,345,5,340,0.014492753623188406,-1.9585979128324447
ZCTA5 79092,345,5,340,0.014492753623188406,-1.9585979128324447
ZCTA5 29527,9706,290,9416,0.029878425716051926,-1.9591125260940832
ZCTA5 36455,111,0,111,0,-1.9600896086421118
ZCTA5 42130,111,0,111,0,-1.9600896086421118
ZCTA5 45310,111,0,111,0,-1.9600896086421118
ZCTA5 50861,111,0,111,0,-1.9600896086421118
ZCTA5 58795,111,0,111,0,-1.9600896086421118
ZCTA5 58250,111,0,111,0,-1.9600896086421118
ZCTA5 58481,111,0,111,0,-1.9600896086421118
ZCTA5 62323,111,0,111,0,-1.9600896086421118
ZCTA5 68871,111,0,111,0,-1.9600896086421118
ZCTA5 72672,111,0,111,0,-1.9600896086421118
ZCTA5 78027,111,0,111,0,-1.9600896086421118
ZCTA5 84772,111,0,111,0,-1.9600896086421118
ZCTA5 85328,111,0,111,0,-1.9600896086421118
ZCTA5 05252,111,0,111,0,-1.9600896086421118
ZCTA5 12738,111,0,111,0,-1.9600896086421118
ZCTA5 15004,111,0,111,0,-1.9600896086421118
ZCTA5 23064,111,0,111,0,-1.9600896086421118
ZCTA5 25879,111,0,111,0,-1.9600896086421118
ZCTA5 98255,111,0,111,0,-1.9600896086421118
ZCTA5 50845,303,4,299,0.013201320132013201,-1.9605246470060833
ZCTA5 50578,303,4,299,0.013201320132013201,-1.9605246470060833
ZCTA5 05647,427,7,420,0.01639344262295082,-1.9605442457248239
ZCTA5 99661,427,7,420,0.01639344262295082,-1.9605442457248239
ZCTA5 24986,2198,57,2141,0.025932666060054597,-1.9610391339756954
ZCTA5 58053,545,10,535,0.01834862385321101,-1.9611016803255017
ZCTA5 05077,545,10,535,0.01834862385321101,-1.9611016803255017
ZCTA5 74084,214,2,212,0.009345794392523364,-1.961279154979653
ZCTA5 04626,214,2,212,0.009345794392523364,-1.961279154979653
ZCTA5 55929,467,8,459,0.017130620985010708,-1.9617257211728039
ZCTA5 10596,467,8,459,0.017130620985010708,-1.9617257211728039
ZCTA5 56329,2667,71,2596,0.02662167229096363,-1.9622719403090738
ZCTA5 56628,808,17,791,0.02103960396039604,-1.9624705430948493
ZCTA5 75486,808,17,791,0.02103960396039604,-1.9624705430948493
ZCTA5 64424,1860,47,1813,0.025268817204301075,-1.9631850229209258
ZCTA5 96088,1996,51,1945,0.02555110220440882,-1.9635568684648763
ZCTA5 56016,387,6,381,0.015503875968992248,-1.9637767615876935
ZCTA5 18255,1758,44,1714,0.02502844141069397,-1.9646452301625486
ZCTA5 10940,18287,564,17723,0.030841581451304206,-1.9648010844704678
ZCTA5 05161,260,3,257,0.011538461538461539,-1.9652006913646518
ZCTA5 48022,954,21,933,0.0220125786163522,-1.9652906150667446
ZCTA5 37779,1274,30,1244,0.023547880690737835,-1.9663569036941915
ZCTA5 97438,428,7,421,0.016355140186915886,-1.9672453015759688
ZCTA5 75117,1518,37,1481,0.024374176548089592,-1.9673805056292883
ZCTA5 44676,1656,41,1615,0.024758454106280192,-1.9678981553292751
ZCTA5 32437,304,4,300,0.013157894736842105,-1.9679677686937396
ZCTA5 64487,304,4,300,0.013157894736842105,-1.9679677686937396
ZCTA5 21861,304,4,300,0.013157894736842105,-1.9679677686937396
ZCTA5 62245,698,14,684,0.02005730659025788,-1.9683238754789387
ZCTA5 16435,698,14,684,0.02005730659025788,-1.9683238754789387
ZCTA5 31832,112,0,112,0,-1.968899044528588
ZCTA5 40921,112,0,112,0,-1.968899044528588
ZCTA5 41817,112,0,112,0,-1.968899044528588
ZCTA5 53939,112,0,112,0,-1.968899044528588
ZCTA5 58428,112,0,112,0,-1.968899044528588
ZCTA5 61474,112,0,112,0,-1.968899044528588
ZCTA5 61417,112,0,112,0,-1.968899044528588
ZCTA5 63934,112,0,112,0,-1.968899044528588
ZCTA5 63457,112,0,112,0,-1.968899044528588
ZCTA5 67106,112,0,112,0,-1.968899044528588
ZCTA5 74747,112,0,112,0,-1.968899044528588
ZCTA5 02641,112,0,112,0,-1.968899044528588
ZCTA5 08324,112,0,112,0,-1.968899044528588
ZCTA5 12416,112,0,112,0,-1.968899044528588
ZCTA5 14856,112,0,112,0,-1.968899044528588
ZCTA5 15520,112,0,112,0,-1.968899044528588
ZCTA5 26586,112,0,112,0,-1.968899044528588
ZCTA5 97864,112,0,112,0,-1.968899044528588
ZCTA5 93549,112,0,112,0,-1.968899044528588
ZCTA5 34221,15392,471,14921,0.03060031185031185,-1.9690426936674628
ZCTA5 45886,215,2,213,0.009302325581395349,-1.9694007841846601
ZCTA5 52326,215,2,213,0.009302325581395349,-1.9694007841846601
ZCTA5 49648,955,21,934,0.02198952879581152,-1.970281622992473
ZCTA5 58033,167,1,166,0.005988023952095809,-1.9738782544803737
ZCTA5 97137,429,7,422,0.016317016317016316,-1.9739334006701437
ZCTA5 71652,469,8,461,0.017057569296375266,-1.9747198470607703
ZCTA5 40516,1311,31,1280,0.02364607170099161,-1.9749350456326284
ZCTA5 40445,305,4,301,0.013114754098360656,-1.975391761515752
ZCTA5 48472,662,13,649,0.019637462235649546,-1.97696603569022
ZCTA5 68813,216,2,214,0.009259259259259259,-1.9774953523666012
ZCTA5 04746,216,2,214,0.009259259259259259,-1.9774953523666012
ZCTA5 56045,389,6,383,0.015424164524421594,-1.9775875437541175
ZCTA5 15477,389,6,383,0.015424164524421594,-1.9775875437541175
ZCTA5 38387,113,0,113,0,-1.9776692395808726
ZCTA5 38740,113,0,113,0,-1.9776692395808726
ZCTA5 43033,113,0,113,0,-1.9776692395808726
ZCTA5 51018,113,0,113,0,-1.9776692395808726
ZCTA5 52221,113,0,113,0,-1.9776692395808726
ZCTA5 57239,113,0,113,0,-1.9776692395808726
ZCTA5 61936,113,0,113,0,-1.9776692395808726
ZCTA5 65543,113,0,113,0,-1.9776692395808726
ZCTA5 67843,113,0,113,0,-1.9776692395808726
ZCTA5 70519,113,0,113,0,-1.9776692395808726
ZCTA5 78162,113,0,113,0,-1.9776692395808726
ZCTA5 06263,113,0,113,0,-1.9776692395808726
ZCTA5 12069,113,0,113,0,-1.9776692395808726
ZCTA5 12172,113,0,113,0,-1.9776692395808726
ZCTA5 12471,113,0,113,0,-1.9776692395808726
ZCTA5 12821,113,0,113,0,-1.9776692395808726
ZCTA5 12987,113,0,113,0,-1.9776692395808726
ZCTA5 14884,113,0,113,0,-1.9776692395808726
ZCTA5 17835,113,0,113,0,-1.9776692395808726
ZCTA5 22943,113,0,113,0,-1.9776692395808726
ZCTA5 22964,113,0,113,0,-1.9776692395808726
ZCTA5 21665,113,0,113,0,-1.9776692395808726
ZCTA5 93641,113,0,113,0,-1.9776692395808726
ZCTA5 47446,4218,118,4100,0.02797534376481745,-1.978838045731737
ZCTA5 20664,1277,30,1247,0.023492560689115115,-1.9796643407358647
ZCTA5 45101,1029,23,1006,0.022351797862001945,-1.9805678223522256
ZCTA5 13081,430,7,423,0.01627906976744186,-1.980608606179694
ZCTA5 50859,262,3,259,0.011450381679389313,-1.9806731642554738
ZCTA5 95006,3991,111,3880,0.02781257830117765,-1.9820370628385797
ZCTA5 43311,7595,223,7372,0.0293614219881501,-1.9835833889235133
ZCTA5 56523,217,2,215,0.009216589861751152,-1.9855631038175816
ZCTA5 17953,217,2,215,0.009216589861751152,-1.9855631038175816
ZCTA5 30452,549,10,539,0.018214936247723135,-1.9857049187036364
ZCTA5 82729,1066,24,1042,0.0225140712945591,-1.9863974089068626
ZCTA5 43925,114,0,114,0,-1.986400713557863
ZCTA5 51631,114,0,114,0,-1.986400713557863
ZCTA5 53953,114,0,114,0,-1.986400713557863
ZCTA5 54844,114,0,114,0,-1.986400713557863
ZCTA5 58654,114,0,114,0,-1.986400713557863
ZCTA5 68846,114,0,114,0,-1.986400713557863
ZCTA5 67468,114,0,114,0,-1.986400713557863
ZCTA5 68732,114,0,114,0,-1.986400713557863
ZCTA5 81064,114,0,114,0,-1.986400713557863
ZCTA5 05083,114,0,114,0,-1.986400713557863
ZCTA5 10975,114,0,114,0,-1.986400713557863
ZCTA5 19931,114,0,114,0,-1.986400713557863
ZCTA5 17748,114,0,114,0,-1.986400713557863
ZCTA5 20630,114,0,114,0,-1.986400713557863
ZCTA5 21634,114,0,114,0,-1.986400713557863
ZCTA5 21648,114,0,114,0,-1.986400713557863
ZCTA5 25251,114,0,114,0,-1.986400713557863
ZCTA5 93207,114,0,114,0,-1.986400713557863
ZCTA5 55018,349,5,344,0.014326647564469915,-1.9871762248092564
ZCTA5 39232,3436,94,3342,0.027357392316647265,-1.9874478248325966
ZCTA5 50135,626,12,614,0.019169329073482427,-1.9875960952766571
ZCTA5 39745,263,3,260,0.011406844106463879,-1.9883759716530403
ZCTA5 56756,263,3,260,0.011406844106463879,-1.9883759716530403
ZCTA5 30563,2037,52,1985,0.025527736867943053,-1.9894856442854867
ZCTA5 61089,307,4,303,0.013029315960912053,-1.9901828703662623
ZCTA5 64830,307,4,303,0.013029315960912053,-1.9901828703662623
ZCTA5 16932,307,4,303,0.013029315960912053,-1.9901828703662623
ZCTA5 04547,391,6,385,0.015345268542199489,-1.9913405363946708
ZCTA5 06907,3372,92,3280,0.027283511269276393,-1.9927097391437034
ZCTA5 24137,1280,30,1250,0.0234375,-1.9929432800818982
ZCTA5 53115,6354,184,6170,0.02895813660686182,-1.9930763949226982
ZCTA5 04965,887,19,868,0.02142051860202931,-1.993082368648235
ZCTA5 26378,1628,40,1588,0.02457002457002457,-1.9934708328768833
ZCTA5 96033,218,2,216,0.009174311926605505,-1.99360427937034
ZCTA5 20743,14284,435,13849,0.030453654438532624,-1.9943227189166857
ZCTA5 42285,115,0,115,0,-1.9950939748447907
ZCTA5 50274,115,0,115,0,-1.9950939748447907
ZCTA5 50515,115,0,115,0,-1.9950939748447907
ZCTA5 49116,115,0,115,0,-1.9950939748447907
ZCTA5 59751,115,0,115,0,-1.9950939748447907
ZCTA5 59739,115,0,115,0,-1.9950939748447907
ZCTA5 58460,115,0,115,0,-1.9950939748447907
ZCTA5 61439,115,0,115,0,-1.9950939748447907
ZCTA5 61340,115,0,115,0,-1.9950939748447907
ZCTA5 65345,115,0,115,0,-1.9950939748447907
ZCTA5 70662,115,0,115,0,-1.9950939748447907
ZCTA5 72640,115,0,115,0,-1.9950939748447907
ZCTA5 76519,115,0,115,0,-1.9950939748447907
ZCTA5 79741,115,0,115,0,-1.9950939748447907
ZCTA5 87731,115,0,115,0,-1.9950939748447907
ZCTA5 82227,115,0,115,0,-1.9950939748447907
ZCTA5 04733,115,0,115,0,-1.9950939748447907
ZCTA5 08561,115,0,115,0,-1.9950939748447907
ZCTA5 12961,115,0,115,0,-1.9950939748447907
ZCTA5 95920,115,0,115,0,-1.9950939748447907
ZCTA5 95837,115,0,115,0,-1.9950939748447907
ZCTA5 98164,115,0,115,0,-1.9950939748447907
ZCTA5 23608,16004,490,15514,0.030617345663584105,-1.995822941752364
ZCTA5 50558,264,3,261,0.011363636363636364,-1.996056719346563
ZCTA5 77597,264,3,261,0.011363636363636364,-1.996056719346563
ZCTA5 90712,10453,313,10140,0.029943556873624797,-1.9960729587252022
ZCTA5 55952,924,20,904,0.021645021645021644,-1.996276202867848
ZCTA5 52342,1316,31,1285,0.023556231003039513,-1.996821970568916
ZCTA5 55910,512,9,503,0.017578125,-1.9977568095696445
ZCTA5 46914,551,10,541,0.018148820326678767,-1.997949259108072
ZCTA5 76454,551,10,541,0.018148820326678767,-1.997949259108072
ZCTA5 03266,888,19,869,0.021396396396396396,-1.9982030316165273
ZCTA5 52030,170,1,169,0.0058823529411764705,-1.9991908072035856
ZCTA5 94105,4908,139,4769,0.028321108394458026,-1.9998554897836858
ZCTA5 02898,666,13,653,0.01951951951951952,-1.999856412211778
ZCTA5 13158,590,11,579,0.01864406779661017,-2.000550577444161
ZCTA5 56019,351,5,346,0.014245014245014245,-2.001367198098042
ZCTA5 66717,219,2,217,0.0091324200913242,-2.0016191164640693
ZCTA5 56292,219,2,217,0.0091324200913242,-2.0016191164640693
ZCTA5 62823,704,14,690,0.019886363636363636,-2.001988846657402
ZCTA5 88061,7700,226,7474,0.02935064935064935,-2.002504640131989
ZCTA5 45671,116,0,116,0,-2.003749520798642
ZCTA5 54625,116,0,116,0,-2.003749520798642
ZCTA5 59525,116,0,116,0,-2.003749520798642
ZCTA5 57217,116,0,116,0,-2.003749520798642
ZCTA5 63951,116,0,116,0,-2.003749520798642
ZCTA5 68062,116,0,116,0,-2.003749520798642
ZCTA5 56356,116,0,116,0,-2.003749520798642
ZCTA5 81024,116,0,116,0,-2.003749520798642
ZCTA5 83244,116,0,116,0,-2.003749520798642
ZCTA5 01093,116,0,116,0,-2.003749520798642
ZCTA5 82083,116,0,116,0,-2.003749520798642
ZCTA5 15827,116,0,116,0,-2.003749520798642
ZCTA5 17951,116,0,116,0,-2.003749520798642
ZCTA5 16132,116,0,116,0,-2.003749520798642
ZCTA5 18842,116,0,116,0,-2.003749520798642
ZCTA5 20628,116,0,116,0,-2.003749520798642
ZCTA5 25156,116,0,116,0,-2.003749520798642
ZCTA5 95511,116,0,116,0,-2.003749520798642
ZCTA5 36346,552,10,542,0.018115942028985508,-2.0040572381360913
ZCTA5 77615,309,4,305,0.012944983818770227,-2.0048989800932238
ZCTA5 50163,393,6,387,0.015267175572519083,-2.0050363525964996
ZCTA5 54204,742,15,727,0.02021563342318059,-2.00543080957032
ZCTA5 56060,171,1,170,0.005847953216374269,-2.0075637487082383
ZCTA5 84758,171,1,170,0.005847953216374269,-2.0075637487082383
ZCTA5 54655,705,14,691,0.019858156028368795,-2.007575295095624
ZCTA5 36370,352,5,347,0.014204545454545454,-2.008438475420427
ZCTA5 97023,3739,103,3636,0.027547472586253008,-2.008590654696463
ZCTA5 49891,220,2,218,0.00909090909090909,-2.009607849208682
ZCTA5 29102,6970,203,6767,0.029124820659971306,-2.0100651189757177
ZCTA5 39861,514,9,505,0.017509727626459144,-2.010278386547043
ZCTA5 63352,514,9,505,0.017509727626459144,-2.010278386547043
ZCTA5 58041,630,12,618,0.01904761904761905,-2.0109248163249824
ZCTA5 84542,630,12,618,0.01904761904761905,-2.0109248163249824
ZCTA5 83686,16951,520,16431,0.030676656244469355,-2.0110804071505033
ZCTA5 72419,668,13,655,0.019461077844311378,-2.0112568470843954
ZCTA5 28577,117,0,117,0,-2.012367838080202
ZCTA5 39174,117,0,117,0,-2.012367838080202
ZCTA5 42156,117,0,117,0,-2.012367838080202
ZCTA5 50470,117,0,117,0,-2.012367838080202
ZCTA5 58731,117,0,117,0,-2.012367838080202
ZCTA5 59447,117,0,117,0,-2.012367838080202
ZCTA5 54948,117,0,117,0,-2.012367838080202
ZCTA5 57467,117,0,117,0,-2.012367838080202
ZCTA5 62969,117,0,117,0,-2.012367838080202
ZCTA5 61478,117,0,117,0,-2.012367838080202
ZCTA5 58847,117,0,117,0,-2.012367838080202
ZCTA5 64166,117,0,117,0,-2.012367838080202
ZCTA5 65001,117,0,117,0,-2.012367838080202
ZCTA5 75469,117,0,117,0,-2.012367838080202
ZCTA5 75562,117,0,117,0,-2.012367838080202
ZCTA5 78371,117,0,117,0,-2.012367838080202
ZCTA5 11956,117,0,117,0,-2.012367838080202
ZCTA5 15348,117,0,117,0,-2.012367838080202
ZCTA5 22743,117,0,117,0,-2.012367838080202
ZCTA5 23032,117,0,117,0,-2.012367838080202
ZCTA5 20862,117,0,117,0,-2.012367838080202
ZCTA5 25437,117,0,117,0,-2.012367838080202
ZCTA5 89317,117,0,117,0,-2.012367838080202
ZCTA5 99115,475,8,467,0.016842105263157894,-2.01342585622931
ZCTA5 57035,435,7,428,0.016091954022988506,-2.0137934082929014
ZCTA5 83444,435,7,428,0.016091954022988506,-2.0137934082929014
ZCTA5 11561,16017,490,15527,0.030592495473559342,-2.0141231214836677
ZCTA5 98589,2850,76,2774,0.02666666666666667,-2.0151190580457756
ZCTA5 54441,353,5,348,0.014164305949008499,-2.0154937390158443
ZCTA5 55961,172,1,171,0.005813953488372093,-2.015904982141048
ZCTA5 66419,172,1,171,0.005813953488372093,-2.015904982141048
ZCTA5 97918,1530,37,1493,0.024183006535947713,-2.016725632372018
ZCTA5 14065,669,13,656,0.01943198804185351,-2.0169459596380124
ZCTA5 74354,6878,200,6678,0.02907822041291073,-2.018247477380358
ZCTA5 12914,395,6,389,0.015189873417721518,-2.018675595504137
ZCTA5 07067,6109,176,5933,0.02880995252905549,-2.0186832433782906
ZCTA5 75657,3249,88,3161,0.02708525700215451,-2.018871745976844
ZCTA5 29051,267,3,264,0.011235955056179775,-2.0189682667284967
ZCTA5 50560,267,3,264,0.011235955056179775,-2.0189682667284967
ZCTA5 67648,267,3,264,0.011235955056179775,-2.0189682667284967
ZCTA5 56327,311,4,307,0.012861736334405145,-2.0195410767176027
ZCTA5 30259,1109,25,1084,0.02254283137962128,-2.0207384841143794
ZCTA5 40040,118,0,118,0,-2.0209494029733617
ZCTA5 38949,118,0,118,0,-2.0209494029733617
ZCTA5 41845,118,0,118,0,-2.0209494029733617
ZCTA5 43158,118,0,118,0,-2.0209494029733617
ZCTA5 47010,118,0,118,0,-2.0209494029733617
ZCTA5 51230,118,0,118,0,-2.0209494029733617
ZCTA5 57047,118,0,118,0,-2.0209494029733617
ZCTA5 58572,118,0,118,0,-2.0209494029733617
ZCTA5 66758,118,0,118,0,-2.0209494029733617
ZCTA5 76666,118,0,118,0,-2.0209494029733617
ZCTA5 83287,118,0,118,0,-2.0209494029733617
ZCTA5 83825,118,0,118,0,-2.0209494029733617
ZCTA5 82324,118,0,118,0,-2.0209494029733617
ZCTA5 87515,118,0,118,0,-2.0209494029733617
ZCTA5 85609,118,0,118,0,-2.0209494029733617
ZCTA5 04650,118,0,118,0,-2.0209494029733617
ZCTA5 12787,118,0,118,0,-2.0209494029733617
ZCTA5 13639,118,0,118,0,-2.0209494029733617
ZCTA5 15863,118,0,118,0,-2.0209494029733617
ZCTA5 16734,118,0,118,0,-2.0209494029733617
ZCTA5 16677,118,0,118,0,-2.0209494029733617
ZCTA5 25848,118,0,118,0,-2.0209494029733617
ZCTA5 24957,118,0,118,0,-2.0209494029733617
ZCTA5 89409,118,0,118,0,-2.0209494029733617
ZCTA5 92341,118,0,118,0,-2.0209494029733617
ZCTA5 97839,118,0,118,0,-2.0209494029733617
ZCTA5 96063,118,0,118,0,-2.0209494029733617
ZCTA5 96759,118,0,118,0,-2.0209494029733617
ZCTA5 13812,929,20,909,0.021528525296017224,-2.021416286324969
ZCTA5 62009,745,15,730,0.020134228187919462,-2.0218372726757576
ZCTA5 14058,745,15,730,0.020134228187919462,-2.0218372726757576
ZCTA5 80487,6752,196,6556,0.029028436018957347,-2.0224251476348942
ZCTA5 38549,1601,39,1562,0.024359775140537165,-2.0236546953632883
ZCTA5 76524,1038,23,1015,0.022157996146435453,-2.0239335171426536
ZCTA5 72564,173,1,172,0.005780346820809248,-2.024214846495561
ZCTA5 00616,3515,96,3419,0.027311522048364154,-2.0252892049542988
ZCTA5 16938,268,3,265,0.011194029850746268,-2.026562428401643
ZCTA5 56314,437,7,430,0.016018306636155607,-2.0269792331467027
ZCTA5 73573,894,19,875,0.021252796420581657,-2.0288197108471513
ZCTA5 65348,517,9,508,0.017408123791102514,-2.028983919312888
ZCTA5 31627,119,0,119,0,-2.029494681692264
ZCTA5 34138,119,0,119,0,-2.029494681692264
ZCTA5 50051,119,0,119,0,-2.029494681692264
ZCTA5 50531,119,0,119,0,-2.029494681692264
ZCTA5 49970,119,0,119,0,-2.029494681692264
ZCTA5 52212,119,0,119,0,-2.029494681692264
ZCTA5 59347,119,0,119,0,-2.029494681692264
ZCTA5 54839,119,0,119,0,-2.029494681692264
ZCTA5 58273,119,0,119,0,-2.029494681692264
ZCTA5 61451,119,0,119,0,-2.029494681692264
ZCTA5 65067,119,0,119,0,-2.029494681692264
ZCTA5 67664,119,0,119,0,-2.029494681692264
ZCTA5 68345,119,0,119,0,-2.029494681692264
ZCTA5 76370,119,0,119,0,-2.029494681692264
ZCTA5 87578,119,0,119,0,-2.029494681692264
ZCTA5 12460,119,0,119,0,-2.029494681692264
ZCTA5 14441,119,0,119,0,-2.029494681692264
ZCTA5 15832,119,0,119,0,-2.029494681692264
ZCTA5 16263,119,0,119,0,-2.029494681692264
ZCTA5 16744,119,0,119,0,-2.029494681692264
ZCTA5 21051,119,0,119,0,-2.029494681692264
ZCTA5 25690,119,0,119,0,-2.029494681692264
ZCTA5 90743,119,0,119,0,-2.029494681692264
ZCTA5 99321,119,0,119,0,-2.029494681692264
ZCTA5 98859,119,0,119,0,-2.029494681692264
ZCTA5 56510,967,21,946,0.02171664943123061,-2.0298113971580394
ZCTA5 53510,595,11,584,0.018487394957983194,-2.0302623630299106
ZCTA5 42740,821,17,804,0.020706455542021926,-2.0312798301672097
ZCTA5 30555,931,20,911,0.021482277121374866,-2.0314385448289625
ZCTA5 62432,174,1,173,0.005747126436781609,-2.0324936749715996
ZCTA5 62867,223,2,221,0.008968609865470852,-2.033419713815036
ZCTA5 04017,223,2,221,0.008968609865470852,-2.033419713815036
ZCTA5 15531,1569,38,1531,0.024219247928616953,-2.0342840115065606
ZCTA5 22849,2050,52,1998,0.025365853658536587,-2.036584654453143
ZCTA5 97239,8704,257,8447,0.029526654411764705,-2.0377423915591204
ZCTA5 32072,120,0,120,0,-2.03800413067687
ZCTA5 31810,120,0,120,0,-2.03800413067687
ZCTA5 38347,120,0,120,0,-2.03800413067687
ZCTA5 43101,120,0,120,0,-2.03800413067687
ZCTA5 43468,120,0,120,0,-2.03800413067687
ZCTA5 50605,120,0,120,0,-2.03800413067687
ZCTA5 51366,120,0,120,0,-2.03800413067687
ZCTA5 59762,120,0,120,0,-2.03800413067687
ZCTA5 61338,120,0,120,0,-2.03800413067687
ZCTA5 62459,120,0,120,0,-2.03800413067687
ZCTA5 68416,120,0,120,0,-2.03800413067687
ZCTA5 69333,120,0,120,0,-2.03800413067687
ZCTA5 74636,120,0,120,0,-2.03800413067687
ZCTA5 80804,120,0,120,0,-2.03800413067687
ZCTA5 80721,120,0,120,0,-2.03800413067687
ZCTA5 88042,120,0,120,0,-2.03800413067687
ZCTA5 81649,120,0,120,0,-2.03800413067687
ZCTA5 04050,120,0,120,0,-2.03800413067687
ZCTA5 12844,120,0,120,0,-2.03800413067687
ZCTA5 10503,120,0,120,0,-2.03800413067687
ZCTA5 18845,120,0,120,0,-2.03800413067687
ZCTA5 17263,120,0,120,0,-2.03800413067687
ZCTA5 21667,120,0,120,0,-2.03800413067687
ZCTA5 39638,1255,29,1226,0.023107569721115537,-2.038384049108401
ZCTA5 13321,479,8,471,0.016701461377870562,-2.0390036162214478
ZCTA5 76655,3024,81,2943,0.026785714285714284,-2.0393157805895847
ZCTA5 62427,673,13,660,0.019316493313521546,-2.039628926342551
ZCTA5 47456,558,10,548,0.017921146953405017,-2.040508705625082
ZCTA5 71368,558,10,548,0.017921146953405017,-2.040508705625082
ZCTA5 29567,175,1,174,0.005714285714285714,-2.0407417951096494
ZCTA5 50434,175,1,174,0.005714285714285714,-2.0407417951096494
ZCTA5 84521,270,3,267,0.011111111111111112,-2.0416871806459107
ZCTA5 62642,597,11,586,0.018425460636515914,-2.042087240437778
ZCTA5 66451,597,11,586,0.018425460636515914,-2.042087240437778
ZCTA5 02568,1571,38,1533,0.0241884150222788,-2.0423763397185053
ZCTA5 11796,1185,27,1158,0.02278481012658228,-2.042508706221871
ZCTA5 64739,357,5,352,0.014005602240896359,-2.043556509735983
ZCTA5 01522,1150,26,1124,0.022608695652173914,-2.0453319216031076
ZCTA5 68366,399,6,393,0.015037593984962405,-2.0457867255794873
ZCTA5 86325,2492,65,2427,0.02608346709470305,-2.0462125688778507
ZCTA5 28668,121,0,121,0,-2.0464781968774517
ZCTA5 43111,121,0,121,0,-2.0464781968774517
ZCTA5 52313,121,0,121,0,-2.0464781968774517
ZCTA5 54931,121,0,121,0,-2.0464781968774517
ZCTA5 59416,121,0,121,0,-2.0464781968774517
ZCTA5 59054,121,0,121,0,-2.0464781968774517
ZCTA5 58542,121,0,121,0,-2.0464781968774517
ZCTA5 58004,121,0,121,0,-2.0464781968774517
ZCTA5 58420,121,0,121,0,-2.0464781968774517
ZCTA5 58067,121,0,121,0,-2.0464781968774517
ZCTA5 58269,121,0,121,0,-2.0464781968774517
ZCTA5 62373,121,0,121,0,-2.0464781968774517
ZCTA5 69214,121,0,121,0,-2.0464781968774517
ZCTA5 56533,121,0,121,0,-2.0464781968774517
ZCTA5 73733,121,0,121,0,-2.0464781968774517
ZCTA5 72948,121,0,121,0,-2.0464781968774517
ZCTA5 77334,121,0,121,0,-2.0464781968774517
ZCTA5 84330,121,0,121,0,-2.0464781968774517
ZCTA5 12454,121,0,121,0,-2.0464781968774517
ZCTA5 12752,121,0,121,0,-2.0464781968774517
ZCTA5 13633,121,0,121,0,-2.0464781968774517
ZCTA5 13103,121,0,121,0,-2.0464781968774517
ZCTA5 17223,121,0,121,0,-2.0464781968774517
ZCTA5 15756,121,0,121,0,-2.0464781968774517
ZCTA5 17978,121,0,121,0,-2.0464781968774517
ZCTA5 18413,121,0,121,0,-2.0464781968774517
ZCTA5 23025,121,0,121,0,-2.0464781968774517
ZCTA5 24167,121,0,121,0,-2.0464781968774517
ZCTA5 72087,712,14,698,0.019662921348314606,-2.046488137753706
ZCTA5 28719,2960,79,2881,0.02668918918918919,-2.046824779228359
ZCTA5 61536,1186,27,1159,0.022765598650927487,-2.0470496511085243
ZCTA5 23148,787,16,771,0.020330368487928845,-2.0474475858379475
ZCTA5 12578,861,18,843,0.020905923344947737,-2.0476254378255074
ZCTA5 62922,1079,24,1055,0.022242817423540315,-2.048023586618634
ZCTA5 66418,176,1,175,0.005681818181818182,-2.0489595289213365
ZCTA5 63350,225,2,223,0.008888888888888889,-2.049167916275401
ZCTA5 73655,358,5,353,0.013966480446927373,-2.0505330876869636
ZCTA5 64762,637,12,625,0.018838304552590265,-2.0514444317722114
ZCTA5 73628,560,10,550,0.017857142857142856,-2.052585224124654
ZCTA5 10704,12283,370,11913,0.030122934136611577,-2.0531992716562937
ZCTA5 35228,4083,113,3970,0.027675728630908645,-2.053380872244917
ZCTA5 46379,122,0,122,0,-2.0549173180285347
ZCTA5 49793,122,0,122,0,-2.0549173180285347
ZCTA5 55087,122,0,122,0,-2.0549173180285347
ZCTA5 59061,122,0,122,0,-2.0549173180285347
ZCTA5 57323,122,0,122,0,-2.0549173180285347
ZCTA5 62818,122,0,122,0,-2.0549173180285347
ZCTA5 65232,122,0,122,0,-2.0549173180285347
ZCTA5 72955,122,0,122,0,-2.0549173180285347
ZCTA5 82441,122,0,122,0,-2.0549173180285347
ZCTA5 82063,122,0,122,0,-2.0549173180285347
ZCTA5 15828,122,0,122,0,-2.0549173180285347
ZCTA5 23876,122,0,122,0,-2.0549173180285347
ZCTA5 25152,122,0,122,0,-2.0549173180285347
ZCTA5 96092,122,0,122,0,-2.0549173180285347
ZCTA5 96710,122,0,122,0,-2.0549173180285347
ZCTA5 44510,936,20,916,0.021367521367521368,-2.0564105341874166
ZCTA5 13652,676,13,663,0.019230769230769232,-2.0565646446197623
ZCTA5 27601,4215,117,4098,0.027758007117437724,-2.0566026271834428
ZCTA5 14724,826,17,809,0.020581113801452784,-2.057488958269617
ZCTA5 97325,2327,60,2267,0.02578427159432746,-2.0575739052255924
ZCTA5 54443,863,18,845,0.02085747392815759,-2.0579173654537355
ZCTA5 75631,1117,25,1092,0.022381378692927483,-2.0580217527132327
ZCTA5 27024,1117,25,1092,0.022381378692927483,-2.0580217527132327
ZCTA5 62702,15642,477,15165,0.03049482163406214,-2.0583395791979693
ZCTA5 81648,900,19,881,0.021111111111111112,-2.0592543640177117
ZCTA5 45382,442,7,435,0.01583710407239819,-2.0597277384882626
ZCTA5 73017,600,11,589,0.018333333333333333,-2.059761203683314
ZCTA5 27544,1920,48,1872,0.025,-2.060102430491112
ZCTA5 55412,8557,252,8305,0.029449573448638543,-2.0601141627787847
ZCTA5 54722,1436,34,1402,0.023676880222841225,-2.060451416892965
ZCTA5 89040,1401,33,1368,0.023554603854389723,-2.060638728440369
ZCTA5 49047,6289,181,6108,0.028780410240101764,-2.061235925092599
ZCTA5 17237,639,12,627,0.018779342723004695,-2.0629510496610184
ZCTA5 14846,317,4,313,0.012618296529968454,-2.06303285201115
ZCTA5 28581,123,0,123,0,-2.063321922912754
ZCTA5 39736,123,0,123,0,-2.063321922912754
ZCTA5 52646,123,0,123,0,-2.063321922912754
ZCTA5 52355,123,0,123,0,-2.063321922912754
ZCTA5 57433,123,0,123,0,-2.063321922912754
ZCTA5 59471,123,0,123,0,-2.063321922912754
ZCTA5 57460,123,0,123,0,-2.063321922912754
ZCTA5 57644,123,0,123,0,-2.063321922912754
ZCTA5 64498,123,0,123,0,-2.063321922912754
ZCTA5 67510,123,0,123,0,-2.063321922912754
ZCTA5 72930,123,0,123,0,-2.063321922912754
ZCTA5 78344,123,0,123,0,-2.063321922912754
ZCTA5 13614,123,0,123,0,-2.063321922912754
ZCTA5 13051,123,0,123,0,-2.063321922912754
ZCTA5 23893,123,0,123,0,-2.063321922912754
ZCTA5 25688,123,0,123,0,-2.063321922912754
ZCTA5 95493,123,0,123,0,-2.063321922912754
ZCTA5 17823,483,8,475,0.016563146997929608,-2.06440406825531
ZCTA5 54459,562,10,552,0.017793594306049824,-2.0646252225481287
ZCTA5 01098,562,10,552,0.017793594306049824,-2.0646252225481287
ZCTA5 94924,562,10,552,0.017793594306049824,-2.0646252225481287
ZCTA5 52170,227,2,225,0.00881057268722467,-2.0648170510484243
ZCTA5 04762,227,2,225,0.00881057268722467,-2.0648170510484243
ZCTA5 65330,178,1,177,0.0056179775280898875,-2.065305098724423
ZCTA5 73016,601,11,590,0.018302828618968387,-2.065635750153446
ZCTA5 52160,402,6,396,0.014925373134328358,-2.0659759130690603
ZCTA5 68814,402,6,396,0.014925373134328358,-2.0659759130690603
ZCTA5 14621,12480,376,12104,0.03012820512820513,-2.066324186912219
ZCTA5 74631,3000,80,2920,0.02666666666666667,-2.067468530429193
ZCTA5 23898,828,17,811,0.020531400966183576,-2.067933481086173
ZCTA5 65263,754,15,739,0.01989389920424403,-2.0707121129887867
ZCTA5 04030,939,20,919,0.021299254526091587,-2.071336803135739
ZCTA5 56024,1227,28,1199,0.022819885900570498,-2.0715571914069044
ZCTA5 36113,274,3,271,0.010948905109489052,-2.0716867527764253
ZCTA5 50062,274,3,271,0.010948905109489052,-2.0716867527764253
ZCTA5 74565,274,3,271,0.010948905109489052,-2.0716867527764253
ZCTA5 43722,124,0,124,0,-2.0716924316150758
ZCTA5 46393,124,0,124,0,-2.0716924316150758
ZCTA5 47449,124,0,124,0,-2.0716924316150758
ZCTA5 58642,124,0,124,0,-2.0716924316150758
ZCTA5 58424,124,0,124,0,-2.0716924316150758
ZCTA5 67644,124,0,124,0,-2.0716924316150758
ZCTA5 67520,124,0,124,0,-2.0716924316150758
ZCTA5 67529,124,0,124,0,-2.0716924316150758
ZCTA5 64445,124,0,124,0,-2.0716924316150758
ZCTA5 66058,124,0,124,0,-2.0716924316150758
ZCTA5 65630,124,0,124,0,-2.0716924316150758
ZCTA5 70082,124,0,124,0,-2.0716924316150758
ZCTA5 72524,124,0,124,0,-2.0716924316150758
ZCTA5 81155,124,0,124,0,-2.0716924316150758
ZCTA5 80131,124,0,124,0,-2.0716924316150758
ZCTA5 82838,124,0,124,0,-2.0716924316150758
ZCTA5 08329,124,0,124,0,-2.0716924316150758
ZCTA5 12459,124,0,124,0,-2.0716924316150758
ZCTA5 12855,124,0,124,0,-2.0716924316150758
ZCTA5 13806,124,0,124,0,-2.0716924316150758
ZCTA5 13678,124,0,124,0,-2.0716924316150758
ZCTA5 16821,124,0,124,0,-2.0716924316150758
ZCTA5 19550,124,0,124,0,-2.0716924316150758
ZCTA5 17776,124,0,124,0,-2.0716924316150758
ZCTA5 25149,124,0,124,0,-2.0716924316150758
ZCTA5 89004,124,0,124,0,-2.0716924316150758
ZCTA5 79057,524,9,515,0.01717557251908397,-2.0722774079604616
ZCTA5 66520,228,2,226,0.008771929824561403,-2.0726049974855454
ZCTA5 93420,11634,349,11285,0.029998280900807976,-2.0729911412390063
ZCTA5 03465,829,17,812,0.020506634499396863,-2.0731474158415892
ZCTA5 54479,1509,36,1473,0.02385685884691849,-2.0732942019841873
ZCTA5 56761,179,1,178,0.00558659217877095,-2.0734335522170255
ZCTA5 33920,1958,49,1909,0.02502553626149132,-2.074105112007093
ZCTA5 79118,7768,227,7541,0.029222451081359423,-2.0741621861539477
ZCTA5 19938,3102,83,3019,0.02675693101225016,-2.0743640941392547
ZCTA5 74962,1787,44,1743,0.024622271964185788,-2.0762678156442473
ZCTA5 98568,1121,25,1096,0.02230151650312221,-2.076573238678029
ZCTA5 33812,4484,125,4359,0.027876895628902765,-2.076940896949876
ZCTA5 36277,1993,50,1943,0.025087807325639738,-2.0771009417774806
ZCTA5 52069,603,11,592,0.01824212271973466,-2.07735985848093
ZCTA5 04090,4582,128,4454,0.027935399388913137,-2.0774916027862154
ZCTA5 48766,525,9,516,0.017142857142857144,-2.078422472534355
ZCTA5 56662,275,3,272,0.01090909090909091,-2.079135462579058
ZCTA5 67834,404,6,398,0.01485148514851485,-2.0793677840347686
ZCTA5 41132,125,0,125,0,-2.0800292557678093
ZCTA5 41226,125,0,125,0,-2.0800292557678093
ZCTA5 49808,125,0,125,0,-2.0800292557678093
ZCTA5 50857,125,0,125,0,-2.0800292557678093
ZCTA5 52581,125,0,125,0,-2.0800292557678093
ZCTA5 55606,125,0,125,0,-2.0800292557678093
ZCTA5 57218,125,0,125,0,-2.0800292557678093
ZCTA5 61359,125,0,125,0,-2.0800292557678093
ZCTA5 67657,125,0,125,0,-2.0800292557678093
ZCTA5 68414,125,0,125,0,-2.0800292557678093
ZCTA5 74452,125,0,125,0,-2.0800292557678093
ZCTA5 77878,125,0,125,0,-2.0800292557678093
ZCTA5 04677,125,0,125,0,-2.0800292557678093
ZCTA5 95224,125,0,125,0,-2.0800292557678093
ZCTA5 97873,125,0,125,0,-2.0800292557678093
ZCTA5 63019,1788,44,1744,0.024608501118568233,-2.080086899782052
ZCTA5 69210,1122,25,1097,0.022281639928698752,-2.081201798416308
ZCTA5 82225,756,15,741,0.01984126984126984,-2.081503933219179
ZCTA5 70570,14124,428,13696,0.030303030303030304,-2.0826706401782684
ZCTA5 76577,1194,27,1167,0.022613065326633167,-2.0832530538953096
ZCTA5 32833,3271,88,3183,0.026903087740752063,-2.083635425131013
ZCTA5 46795,2436,63,2373,0.02586206896551724,-2.083858891610168
ZCTA5 40065,11168,334,10834,0.029906876790830945,-2.0847676161729716
ZCTA5 17045,1230,28,1202,0.022764227642276424,-2.0849434984389985
ZCTA5 37141,446,7,439,0.01569506726457399,-2.085708143286718
ZCTA5 99013,643,12,631,0.01866251944012442,-2.0858717486536236
ZCTA5 60518,1372,32,1340,0.023323615160349854,-2.0867808209805054
ZCTA5 32062,757,15,742,0.019815059445178335,-2.0868905064249446
ZCTA5 27281,1266,29,1237,0.022906793048973143,-2.08702540132436
ZCTA5 49709,1617,39,1578,0.02411873840445269,-2.0876430777469603
ZCTA5 45358,126,0,126,0,-2.088332798786818
ZCTA5 52624,126,0,126,0,-2.088332798786818
ZCTA5 55609,126,0,126,0,-2.088332798786818
ZCTA5 58734,126,0,126,0,-2.088332798786818
ZCTA5 57051,126,0,126,0,-2.088332798786818
ZCTA5 62273,126,0,126,0,-2.088332798786818
ZCTA5 57422,126,0,126,0,-2.088332798786818
ZCTA5 60934,126,0,126,0,-2.088332798786818
ZCTA5 62297,126,0,126,0,-2.088332798786818
ZCTA5 68844,126,0,126,0,-2.088332798786818
ZCTA5 66958,126,0,126,0,-2.088332798786818
ZCTA5 66008,126,0,126,0,-2.088332798786818
ZCTA5 67511,126,0,126,0,-2.088332798786818
ZCTA5 68623,126,0,126,0,-2.088332798786818
ZCTA5 68437,126,0,126,0,-2.088332798786818
ZCTA5 68014,126,0,126,0,-2.088332798786818
ZCTA5 72747,126,0,126,0,-2.088332798786818
ZCTA5 73756,126,0,126,0,-2.088332798786818
ZCTA5 80749,126,0,126,0,-2.088332798786818
ZCTA5 01224,126,0,126,0,-2.088332798786818
ZCTA5 05833,126,0,126,0,-2.088332798786818
ZCTA5 12420,126,0,126,0,-2.088332798786818
ZCTA5 16855,126,0,126,0,-2.088332798786818
ZCTA5 18843,126,0,126,0,-2.088332798786818
ZCTA5 20629,126,0,126,0,-2.088332798786818
ZCTA5 24457,126,0,126,0,-2.088332798786818
ZCTA5 25134,126,0,126,0,-2.088332798786818
ZCTA5 97451,126,0,126,0,-2.088332798786818
ZCTA5 99631,126,0,126,0,-2.088332798786818
ZCTA5 59036,566,10,556,0.0176678445229682,-2.0885967534452674
ZCTA5 89139,12589,379,12210,0.03010564778775121,-2.0894031241659263
ZCTA5 56522,181,1,180,0.0055248618784530384,-2.089603302134306
ZCTA5 73759,644,12,632,0.018633540372670808,-2.091582793679408
ZCTA5 94571,4555,127,4428,0.0278814489571899,-2.091610559849171
ZCTA5 61458,321,4,317,0.012461059190031152,-2.0916745065226965
ZCTA5 68843,321,4,317,0.012461059190031152,-2.0916745065226965
ZCTA5 62627,406,6,400,0.014778325123152709,-2.0927062305546515
ZCTA5 31015,7746,226,7520,0.029176349083397883,-2.093787241580032
ZCTA5 11977,833,17,816,0.02040816326530612,-2.0939479782619594
ZCTA5 13361,277,3,274,0.010830324909747292,-2.0939724984711083
ZCTA5 61319,567,10,557,0.01763668430335097,-2.094567236016624
ZCTA5 10992,3076,82,2994,0.026657997399219768,-2.096166536703119
ZCTA5 38764,127,0,127,0,-2.0966034560993134
ZCTA5 38070,127,0,127,0,-2.0966034560993134
ZCTA5 52225,127,0,127,0,-2.0966034560993134
ZCTA5 59540,127,0,127,0,-2.0966034560993134
ZCTA5 57227,127,0,127,0,-2.0966034560993134
ZCTA5 58792,127,0,127,0,-2.0966034560993134
ZCTA5 62444,127,0,127,0,-2.0966034560993134
ZCTA5 00786,127,0,127,0,-2.0966034560993134
ZCTA5 12978,127,0,127,0,-2.0966034560993134
ZCTA5 10914,127,0,127,0,-2.0966034560993134
ZCTA5 12847,127,0,127,0,-2.0966034560993134
ZCTA5 17888,127,0,127,0,-2.0966034560993134
ZCTA5 21153,127,0,127,0,-2.0966034560993134
ZCTA5 26343,127,0,127,0,-2.0966034560993134
ZCTA5 25864,127,0,127,0,-2.0966034560993134
ZCTA5 26680,127,0,127,0,-2.0966034560993134
ZCTA5 95318,127,0,127,0,-2.0966034560993134
ZCTA5 93563,127,0,127,0,-2.0966034560993134
ZCTA5 17555,2169,55,2114,0.025357307514983864,-2.097074903297119
ZCTA5 65032,645,12,633,0.018604651162790697,-2.0972862373122245
ZCTA5 16112,645,12,633,0.018604651162790697,-2.0972862373122245
ZCTA5 73179,1689,41,1648,0.02427471876850207,-2.097965997570053
ZCTA5 56041,448,7,441,0.015625,-2.0986267928961757
ZCTA5 68869,871,18,853,0.02066590126291619,-2.0988754787458888
ZCTA5 48754,365,5,360,0.0136986301369863,-2.0989409765928526
ZCTA5 57472,365,5,360,0.0136986301369863,-2.0989409765928526
ZCTA5 54169,1054,23,1031,0.021821631878557873,-2.100201187516932
ZCTA5 04981,1162,26,1136,0.022375215146299483,-2.100236077838039
ZCTA5 76036,8483,249,8234,0.029352823293646114,-2.1007422357879015
ZCTA5 30803,278,3,275,0.01079136690647482,-2.1013611139449377
ZCTA5 61042,278,3,275,0.01079136690647482,-2.1013611139449377
ZCTA5 05086,278,3,275,0.01079136690647482,-2.1013611139449377
ZCTA5 93626,722,14,708,0.019390581717451522,-2.101504577194446
ZCTA5 76550,4950,139,4811,0.02808080808080808,-2.1024140652268657
ZCTA5 45821,529,9,520,0.017013232514177693,-2.10290501835667
ZCTA5 50029,232,2,230,0.008620689655172414,-2.10351743715718
ZCTA5 61769,232,2,230,0.008620689655172414,-2.10351743715718
ZCTA5 58563,909,19,890,0.020902090209020903,-2.1045707285229405
ZCTA5 38630,128,0,128,0,-2.104841615363585
ZCTA5 39635,128,0,128,0,-2.104841615363585
ZCTA5 44671,128,0,128,0,-2.104841615363585
ZCTA5 50582,128,0,128,0,-2.104841615363585
ZCTA5 50432,128,0,128,0,-2.104841615363585
ZCTA5 50433,128,0,128,0,-2.104841615363585
ZCTA5 50473,128,0,128,0,-2.104841615363585
ZCTA5 51440,128,0,128,0,-2.104841615363585
ZCTA5 52158,128,0,128,0,-2.104841615363585
ZCTA5 57374,128,0,128,0,-2.104841615363585
ZCTA5 58581,128,0,128,0,-2.104841615363585
ZCTA5 63531,128,0,128,0,-2.104841615363585
ZCTA5 66432,128,0,128,0,-2.104841615363585
ZCTA5 67638,128,0,128,0,-2.104841615363585
ZCTA5 69030,128,0,128,0,-2.104841615363585
ZCTA5 56590,128,0,128,0,-2.104841615363585
ZCTA5 78635,128,0,128,0,-2.104841615363585
ZCTA5 82421,128,0,128,0,-2.104841615363585
ZCTA5 80497,128,0,128,0,-2.104841615363585
ZCTA5 12927,128,0,128,0,-2.104841615363585
ZCTA5 24432,128,0,128,0,-2.104841615363585
ZCTA5 97473,128,0,128,0,-2.104841615363585
ZCTA5 08201,3807,104,3703,0.027318098240084056,-2.1054776315828097
ZCTA5 49333,4234,117,4117,0.027633443552196504,-2.1063070636333023
ZCTA5 56062,1306,30,1276,0.022970903522205207,-2.1068550062112883
ZCTA5 24874,1235,28,1207,0.022672064777327937,-2.1071885030168884
ZCTA5 92397,1726,42,1684,0.02433371958285052,-2.107189570811318
ZCTA5 75134,7145,207,6938,0.028971308607417774,-2.1073043429445852
ZCTA5 16374,761,15,746,0.01971090670170828,-2.108374962211301
ZCTA5 74831,279,3,276,0.010752688172043012,-2.1087299846596532
ZCTA5 93653,530,9,521,0.016981132075471698,-2.1090014210626578
ZCTA5 14879,873,18,855,0.020618556701030927,-2.1090631251004104
ZCTA5 76634,2847,75,2772,0.026343519494204427,-2.1099446400400224
ZCTA5 28585,1518,36,1482,0.023715415019762844,-2.1101144480521707
ZCTA5 35765,1483,35,1448,0.023600809170600135,-2.110190226191834
ZCTA5 62263,2207,56,2151,0.025373810602628003,-2.111053581482243
ZCTA5 57441,233,2,231,0.008583690987124463,-2.1111867106077797
ZCTA5 76464,233,2,231,0.008583690987124463,-2.1111867106077797
ZCTA5 08323,233,2,231,0.008583690987124463,-2.1111867106077797
ZCTA5 26440,450,7,443,0.015555555555555555,-2.1114983312538116
ZCTA5 35143,1236,28,1208,0.022653721682847898,-2.1116277296815054
ZCTA5 38855,1762,43,1719,0.024404086265607264,-2.112625437390653
ZCTA5 99032,324,4,320,0.012345679012345678,-2.1129755533551693
ZCTA5 28775,129,0,129,0,-2.1130476566810286
ZCTA5 35036,129,0,129,0,-2.1130476566810286
ZCTA5 54841,129,0,129,0,-2.1130476566810286
ZCTA5 59531,129,0,129,0,-2.1130476566810286
ZCTA5 87743,129,0,129,0,-2.1130476566810286
ZCTA5 60968,129,0,129,0,-2.1130476566810286
ZCTA5 58760,129,0,129,0,-2.1130476566810286
ZCTA5 65702,129,0,129,0,-2.1130476566810286
ZCTA5 72517,129,0,129,0,-2.1130476566810286
ZCTA5 84716,129,0,129,0,-2.1130476566810286
ZCTA5 84656,129,0,129,0,-2.1130476566810286
ZCTA5 82710,129,0,129,0,-2.1130476566810286
ZCTA5 12886,129,0,129,0,-2.1130476566810286
ZCTA5 14475,129,0,129,0,-2.1130476566810286
ZCTA5 21010,129,0,129,0,-2.1130476566810286
ZCTA5 25628,129,0,129,0,-2.1130476566810286
ZCTA5 97029,129,0,129,0,-2.1130476566810286
ZCTA5 67952,184,1,183,0.005434782608695652,-2.1136444056174875
ZCTA5 21664,184,1,183,0.005434782608695652,-2.1136444056174875
ZCTA5 37143,1519,36,1483,0.02369980250164582,-2.114193245014684
ZCTA5 23661,5378,152,5226,0.028263294905169208,-2.1169995413241858
ZCTA5 53035,985,21,964,0.02131979695431472,-2.1178804665582454
ZCTA5 36919,725,14,711,0.019310344827586208,-2.117880572808951
ZCTA5 49880,451,7,444,0.015521064301552107,-2.117916569923216
ZCTA5 95684,1344,31,1313,0.023065476190476192,-2.1180053129580942
ZCTA5 47230,610,11,599,0.018032786885245903,-2.118134948466516
ZCTA5 53809,1520,36,1484,0.02368421052631579,-2.1182695866700136
ZCTA5 37373,1094,24,1070,0.021937842778793418,-2.1183064909836506
ZCTA5 29065,234,2,232,0.008547008547008548,-2.118832840295351
ZCTA5 62572,234,2,232,0.008547008547008548,-2.118832840295351
ZCTA5 46920,410,6,404,0.014634146341463415,-2.119225015727935
ZCTA5 73042,410,6,404,0.014634146341463415,-2.119225015727935
ZCTA5 62982,368,5,363,0.01358695652173913,-2.119462562041827
ZCTA5 39440,7759,226,7533,0.02912746487949478,-2.119489579249406
ZCTA5 41514,1415,33,1382,0.023321554770318022,-2.119660562510404
ZCTA5 12440,838,17,821,0.02028639618138425,-2.1198255963084067
ZCTA5 68826,1660,40,1620,0.024096385542168676,-2.1202833924073916
ZCTA5 81501,9797,290,9507,0.029600898234153312,-2.1210371976776683
ZCTA5 61041,532,9,523,0.016917293233082706,-2.121165414794361
ZCTA5 75944,532,9,523,0.016917293233082706,-2.121165414794361
ZCTA5 38226,130,0,130,0,-2.121221952800787
ZCTA5 40927,130,0,130,0,-2.121221952800787
ZCTA5 58725,130,0,130,0,-2.121221952800787
ZCTA5 58018,130,0,130,0,-2.121221952800787
ZCTA5 61363,130,0,130,0,-2.121221952800787
ZCTA5 61316,130,0,130,0,-2.121221952800787
ZCTA5 62081,130,0,130,0,-2.121221952800787
ZCTA5 68948,130,0,130,0,-2.121221952800787
ZCTA5 70756,130,0,130,0,-2.121221952800787
ZCTA5 68303,130,0,130,0,-2.121221952800787
ZCTA5 56376,130,0,130,0,-2.121221952800787
ZCTA5 88028,130,0,130,0,-2.121221952800787
ZCTA5 88032,130,0,130,0,-2.121221952800787
ZCTA5 02876,130,0,130,0,-2.121221952800787
ZCTA5 08072,130,0,130,0,-2.121221952800787
ZCTA5 12439,130,0,130,0,-2.121221952800787
ZCTA5 16619,130,0,130,0,-2.121221952800787
ZCTA5 26141,130,0,130,0,-2.121221952800787
ZCTA5 23130,130,0,130,0,-2.121221952800787
ZCTA5 98582,130,0,130,0,-2.121221952800787
ZCTA5 98940,130,0,130,0,-2.121221952800787
ZCTA5 02379,2515,65,2450,0.02584493041749503,-2.122159046773708
ZCTA5 81413,2074,52,2022,0.02507232401157184,-2.122810912257202
ZCTA5 49759,726,14,712,0.01928374655647383,-2.123326195626396
ZCTA5 05457,650,12,638,0.018461538461538463,-2.1256903061434675
ZCTA5 71326,411,6,405,0.014598540145985401,-2.1258221607252055
ZCTA5 14723,411,6,405,0.014598540145985401,-2.1258221607252055
ZCTA5 75478,369,5,364,0.013550135501355014,-2.1262737495003496
ZCTA5 56023,235,2,233,0.00851063829787234,-2.1264560171634823
ZCTA5 01833,3253,87,3166,0.026744543498309254,-2.1281814846136218
ZCTA5 83876,689,13,676,0.018867924528301886,-2.1292106946283824
ZCTA5 29346,131,0,131,0,-2.129364869317324
ZCTA5 45158,131,0,131,0,-2.129364869317324
ZCTA5 45698,131,0,131,0,-2.129364869317324
ZCTA5 62887,131,0,131,0,-2.129364869317324
ZCTA5 66417,131,0,131,0,-2.129364869317324
ZCTA5 69023,131,0,131,0,-2.129364869317324
ZCTA5 71839,131,0,131,0,-2.129364869317324
ZCTA5 73440,131,0,131,0,-2.129364869317324
ZCTA5 81071,131,0,131,0,-2.129364869317324
ZCTA5 88025,131,0,131,0,-2.129364869317324
ZCTA5 79256,131,0,131,0,-2.129364869317324
ZCTA5 83126,131,0,131,0,-2.129364869317324
ZCTA5 12724,131,0,131,0,-2.129364869317324
ZCTA5 15038,131,0,131,0,-2.129364869317324
ZCTA5 16030,131,0,131,0,-2.129364869317324
ZCTA5 16334,131,0,131,0,-2.129364869317324
ZCTA5 16852,131,0,131,0,-2.129364869317324
ZCTA5 24860,131,0,131,0,-2.129364869317324
ZCTA5 77994,186,1,185,0.005376344086021506,-2.129532751647859
ZCTA5 50543,612,11,601,0.017973856209150325,-2.129711834691693
ZCTA5 63436,612,11,601,0.017973856209150325,-2.129711834691693
ZCTA5 50246,282,3,279,0.010638297872340425,-2.130719527236933
ZCTA5 74145,7605,221,7384,0.02905982905982906,-2.1311516167886353
ZCTA5 67880,2619,68,2551,0.025964108438335243,-2.1316744739952673
ZCTA5 06069,1133,25,1108,0.02206531332744925,-2.131872637997442
ZCTA5 32052,2720,71,2649,0.02610294117647059,-2.1321228696679864
ZCTA5 66503,6322,181,6141,0.028630180322682695,-2.133064100711134
ZCTA5 48601,14378,435,13943,0.03025455557101127,-2.133638326775786
ZCTA5 76579,1524,36,1488,0.023622047244094488,-2.134550470505635
ZCTA5 62061,690,13,677,0.01884057971014493,-2.134749782851014
ZCTA5 70057,1594,38,1556,0.02383939774153074,-2.1347641052078266
ZCTA5 70820,7223,209,7014,0.028935345424338916,-2.1357728573348713
ZCTA5 44865,1098,24,1074,0.02185792349726776,-2.1369026014648558
ZCTA5 15327,652,12,640,0.018404907975460124,-2.1369995902897188
ZCTA5 89061,2587,67,2520,0.025898724391186703,-2.137105717884116
ZCTA5 71341,1313,30,1283,0.02284843869002285,-2.1371715292309963
ZCTA5 66406,187,1,186,0.0053475935828877,-2.1374360272797364
ZCTA5 40843,132,0,132,0,-2.137476764861219
ZCTA5 46377,132,0,132,0,-2.137476764861219
ZCTA5 48728,132,0,132,0,-2.137476764861219
ZCTA5 49791,132,0,132,0,-2.137476764861219
ZCTA5 54928,132,0,132,0,-2.137476764861219
ZCTA5 59936,132,0,132,0,-2.137476764861219
ZCTA5 59453,132,0,132,0,-2.137476764861219
ZCTA5 58483,132,0,132,0,-2.137476764861219
ZCTA5 58035,132,0,132,0,-2.137476764861219
ZCTA5 62631,132,0,132,0,-2.137476764861219
ZCTA5 67447,132,0,132,0,-2.137476764861219
ZCTA5 66091,132,0,132,0,-2.137476764861219
ZCTA5 67138,132,0,132,0,-2.137476764861219
ZCTA5 68858,132,0,132,0,-2.137476764861219
ZCTA5 72760,132,0,132,0,-2.137476764861219
ZCTA5 74633,132,0,132,0,-2.137476764861219
ZCTA5 88053,132,0,132,0,-2.137476764861219
ZCTA5 78342,132,0,132,0,-2.137476764861219
ZCTA5 18619,132,0,132,0,-2.137476764861219
ZCTA5 24485,132,0,132,0,-2.137476764861219
ZCTA5 26430,132,0,132,0,-2.137476764861219
ZCTA5 26321,132,0,132,0,-2.137476764861219
ZCTA5 26865,132,0,132,0,-2.137476764861219
ZCTA5 27967,132,0,132,0,-2.137476764861219
ZCTA5 27948,4769,133,4636,0.027888446215139442,-2.137492746657636
ZCTA5 63867,413,6,407,0.014527845036319613,-2.1389778464785802
ZCTA5 18636,495,8,487,0.01616161616161616,-2.1395718538626154
ZCTA5 60953,1026,22,1004,0.021442495126705652,-2.139652596499075
ZCTA5 54469,691,13,678,0.01881331403762663,-2.140281969364229
ZCTA5 44851,1804,44,1760,0.024390243902439025,-2.1409255831310117
ZCTA5 57720,328,4,324,0.012195121951219513,-2.1411421633990697
ZCTA5 62643,237,2,235,0.008438818565400843,-2.1416342638517922
ZCTA5 68447,237,2,235,0.008438818565400843,-2.1416342638517922
ZCTA5 28371,2386,61,2325,0.02556580050293378,-2.142841164624252
ZCTA5 32829,6230,178,6052,0.02857142857142857,-2.1432752790616476
ZCTA5 62367,455,7,448,0.015384615384615385,-2.143473905674693
ZCTA5 24563,2454,63,2391,0.02567237163814181,-2.1438027731191758
ZCTA5 56042,284,3,281,0.01056338028169014,-2.1452830363615765
ZCTA5 78340,188,1,187,0.005319148936170213,-2.1453123921836608
ZCTA5 15696,188,1,187,0.005319148936170213,-2.1453123921836608
ZCTA5 98590,188,1,187,0.005319148936170213,-2.1453123921836608
ZCTA5 81334,536,9,527,0.016791044776119403,-2.145379213028436
ZCTA5 40982,133,0,133,0,-2.145557991283476
ZCTA5 47857,133,0,133,0,-2.145557991283476
ZCTA5 50032,133,0,133,0,-2.145557991283476
ZCTA5 53969,133,0,133,0,-2.145557991283476
ZCTA5 58565,133,0,133,0,-2.145557991283476
ZCTA5 58258,133,0,133,0,-2.145557991283476
ZCTA5 59477,133,0,133,0,-2.145557991283476
ZCTA5 63866,133,0,133,0,-2.145557991283476
ZCTA5 56249,133,0,133,0,-2.145557991283476
ZCTA5 72026,133,0,133,0,-2.145557991283476
ZCTA5 88027,133,0,133,0,-2.145557991283476
ZCTA5 87564,133,0,133,0,-2.145557991283476
ZCTA5 87752,133,0,133,0,-2.145557991283476
ZCTA5 02561,133,0,133,0,-2.145557991283476
ZCTA5 02672,133,0,133,0,-2.145557991283476
ZCTA5 06758,133,0,133,0,-2.145557991283476
ZCTA5 16939,133,0,133,0,-2.145557991283476
ZCTA5 24657,133,0,133,0,-2.145557991283476
ZCTA5 26443,133,0,133,0,-2.145557991283476
ZCTA5 98860,133,0,133,0,-2.145557991283476
ZCTA5 64740,843,17,826,0.020166073546856466,-2.145568081889117
ZCTA5 92145,692,13,679,0.01878612716763006,-2.145807275405352
ZCTA5 23442,372,5,367,0.013440860215053764,-2.14662042342541
ZCTA5 68358,615,11,604,0.01788617886178862,-2.147017056057337
ZCTA5 77010,576,10,566,0.017361111111111112,-2.1479053062177464
ZCTA5 49040,1351,31,1320,0.0229459659511473,-2.1479422400944914
ZCTA5 52251,238,2,236,0.008403361344537815,-2.1491897033245237
ZCTA5 81242,238,2,236,0.008403361344537815,-2.1491897033245237
ZCTA5 04255,238,2,236,0.008403361344537815,-2.1491897033245237
ZCTA5 28743,881,18,863,0.02043132803632236,-2.149609229174313
ZCTA5 56547,955,20,935,0.020942408376963352,-2.1502356051529516
ZCTA5 24467,844,17,827,0.02014218009478673,-2.150700514443084
ZCTA5 50471,285,3,282,0.010526315789473684,-2.152536338867421
ZCTA5 68020,285,3,282,0.010526315789473684,-2.152536338867421
ZCTA5 35584,134,0,134,0,-2.1536088938336007
ZCTA5 33877,134,0,134,0,-2.1536088938336007
ZCTA5 36435,134,0,134,0,-2.1536088938336007
ZCTA5 41365,134,0,134,0,-2.1536088938336007
ZCTA5 41254,134,0,134,0,-2.1536088938336007
ZCTA5 43768,134,0,134,0,-2.1536088938336007
ZCTA5 42083,134,0,134,0,-2.1536088938336007
ZCTA5 44678,134,0,134,0,-2.1536088938336007
ZCTA5 61460,134,0,134,0,-2.1536088938336007
ZCTA5 61871,134,0,134,0,-2.1536088938336007
ZCTA5 70640,134,0,134,0,-2.1536088938336007
ZCTA5 81126,134,0,134,0,-2.1536088938336007
ZCTA5 03850,134,0,134,0,-2.1536088938336007
ZCTA5 18962,134,0,134,0,-2.1536088938336007
ZCTA5 23125,134,0,134,0,-2.1536088938336007
ZCTA5 24714,134,0,134,0,-2.1536088938336007
ZCTA5 95569,134,0,134,0,-2.1536088938336007
ZCTA5 93512,134,0,134,0,-2.1536088938336007
ZCTA5 38220,770,15,755,0.01948051948051948,-2.1563579457460547
ZCTA5 37186,3429,92,3337,0.026829979585885098,-2.157172623743909
ZCTA5 27376,3727,101,3626,0.02709954386906359,-2.1574377373678577
ZCTA5 63561,416,6,410,0.014423076923076924,-2.1586158256594645
ZCTA5 95338,4843,135,4708,0.027875283914928762,-2.159106439209387
ZCTA5 22644,920,19,901,0.020652173913043477,-2.159421609014437
ZCTA5 15940,656,12,644,0.018292682926829267,-2.1595294944346812
ZCTA5 27310,2391,61,2330,0.025512337933918862,-2.159623149176883
ZCTA5 03816,578,10,568,0.01730103806228374,-2.1596627634632775
ZCTA5 95663,883,18,865,0.020385050962627407,-2.1596951332362675
ZCTA5 15312,1460,34,1426,0.023287671232876714,-2.1603015499536435
ZCTA5 05858,190,1,189,0.005263157894736842,-2.160985427587989
ZCTA5 44856,135,0,135,0,-2.1616298113317147
ZCTA5 50836,135,0,135,0,-2.1616298113317147
ZCTA5 53810,135,0,135,0,-2.1616298113317147
ZCTA5 65449,135,0,135,0,-2.1616298113317147
ZCTA5 66516,135,0,135,0,-2.1616298113317147
ZCTA5 74949,135,0,135,0,-2.1616298113317147
ZCTA5 88348,135,0,135,0,-2.1616298113317147
ZCTA5 87562,135,0,135,0,-2.1616298113317147
ZCTA5 01467,135,0,135,0,-2.1616298113317147
ZCTA5 04359,135,0,135,0,-2.1616298113317147
ZCTA5 15429,135,0,135,0,-2.1616298113317147
ZCTA5 21840,135,0,135,0,-2.1616298113317147
ZCTA5 95956,135,0,135,0,-2.1616298113317147
ZCTA5 58436,771,15,756,0.019455252918287938,-2.1616592677003608
ZCTA5 71801,5948,169,5779,0.028412911903160726,-2.1621926945959498
ZCTA5 55329,809,16,793,0.019777503090234856,-2.1633171728378984
ZCTA5 76711,3265,87,3178,0.02664624808575804,-2.163337945100864
ZCTA5 47118,1176,26,1150,0.022108843537414966,-2.1636491724973044
ZCTA5 47588,240,2,238,0.008333333333333333,-2.1642341209402725
ZCTA5 47967,240,2,238,0.008333333333333333,-2.1642341209402725
ZCTA5 13026,579,10,569,0.017271157167530225,-2.165528666609177
ZCTA5 53541,375,5,370,0.013333333333333334,-2.1668384305488293
ZCTA5 56307,1949,48,1901,0.024628014366341714,-2.1669283551436016
ZCTA5 73507,8774,257,8517,0.0292910873033964,-2.168629085090193
ZCTA5 56450,459,7,452,0.015250544662309368,-2.1688487754580836
ZCTA5 29596,922,19,903,0.020607375271149676,-2.169332262571311
ZCTA5 35112,136,0,136,0,-2.16962107633494
ZCTA5 38453,136,0,136,0,-2.16962107633494
ZCTA5 36728,136,0,136,0,-2.16962107633494
ZCTA5 45111,136,0,136,0,-2.16962107633494
ZCTA5 47576,136,0,136,0,-2.16962107633494
ZCTA5 50528,136,0,136,0,-2.16962107633494
ZCTA5 51541,136,0,136,0,-2.16962107633494
ZCTA5 57232,136,0,136,0,-2.16962107633494
ZCTA5 59647,136,0,136,0,-2.16962107633494
ZCTA5 58645,136,0,136,0,-2.16962107633494
ZCTA5 68417,136,0,136,0,-2.16962107633494
ZCTA5 82712,136,0,136,0,-2.16962107633494
ZCTA5 13494,136,0,136,0,-2.16962107633494
ZCTA5 14881,136,0,136,0,-2.16962107633494
ZCTA5 21679,136,0,136,0,-2.16962107633494
ZCTA5 21920,136,0,136,0,-2.16962107633494
ZCTA5 25505,136,0,136,0,-2.16962107633494
ZCTA5 89314,136,0,136,0,-2.16962107633494
ZCTA5 96117,136,0,136,0,-2.16962107633494
ZCTA5 58701,13585,409,13176,0.030106735369893264,-2.169778333756546
ZCTA5 92518,500,8,492,0.016,-2.1704477004955796
ZCTA5 36375,2766,72,2694,0.026030368763557483,-2.1713019023653124
ZCTA5 74052,418,6,412,0.014354066985645933,-2.171644848296667
ZCTA5 62238,241,2,239,0.008298755186721992,-2.1717234547320374
ZCTA5 04280,2699,70,2629,0.025935531678399407,-2.172242802889378
ZCTA5 56524,288,3,285,0.010416666666666666,-2.1741840136420327
ZCTA5 83622,886,18,868,0.020316027088036117,-2.1747864222100812
ZCTA5 78704,24115,746,23369,0.03093510263321584,-2.175505784962566
ZCTA5 75555,659,12,647,0.018209408194233688,-2.17635009240814
ZCTA5 39824,192,1,191,0.005208333333333333,-2.1765538934772892
ZCTA5 50160,192,1,191,0.005208333333333333,-2.1765538934772892
ZCTA5 52586,192,1,191,0.005208333333333333,-2.1765538934772892
ZCTA5 68932,192,1,191,0.005208333333333333,-2.1765538934772892
ZCTA5 36481,137,0,137,0,-2.1775830152982882
ZCTA5 45372,137,0,137,0,-2.1775830152982882
ZCTA5 50039,137,0,137,0,-2.1775830152982882
ZCTA5 58377,137,0,137,0,-2.1775830152982882
ZCTA5 57247,137,0,137,0,-2.1775830152982882
ZCTA5 68304,137,0,137,0,-2.1775830152982882
ZCTA5 68531,137,0,137,0,-2.1775830152982882
ZCTA5 72571,137,0,137,0,-2.1775830152982882
ZCTA5 74349,137,0,137,0,-2.1775830152982882
ZCTA5 78675,137,0,137,0,-2.1775830152982882
ZCTA5 04691,137,0,137,0,-2.1775830152982882
ZCTA5 06387,137,0,137,0,-2.1775830152982882
ZCTA5 12975,137,0,137,0,-2.1775830152982882
ZCTA5 15064,137,0,137,0,-2.1775830152982882
ZCTA5 18081,137,0,137,0,-2.1775830152982882
ZCTA5 23934,137,0,137,0,-2.1775830152982882
ZCTA5 26254,137,0,137,0,-2.1775830152982882
ZCTA5 96121,137,0,137,0,-2.1775830152982882
ZCTA5 98827,137,0,137,0,-2.1775830152982882
ZCTA5 79603,8364,244,8120,0.029172644667623145,-2.1775930721830385
ZCTA5 68319,242,2,240,0.008264462809917356,-2.179191105195224
ZCTA5 15380,242,2,240,0.008264462809917356,-2.179191105195224
ZCTA5 65351,961,20,941,0.02081165452653486,-2.1795210148955326
ZCTA5 28034,6279,179,6100,0.028507724159898072,-2.1797596750357973
ZCTA5 33584,9258,272,8986,0.0293799956794124,-2.180066799988518
ZCTA5 61238,1323,30,1293,0.022675736961451247,-2.1802279086777308
ZCTA5 12072,998,21,977,0.021042084168336674,-2.1805997830470916
ZCTA5 57226,850,17,833,0.02,-2.1813837946499968
ZCTA5 64443,542,9,533,0.016605166051660517,-2.181418881757522
ZCTA5 85334,461,7,454,0.015184381778741865,-2.1814688173002885
ZCTA5 14527,4787,133,4654,0.02778358053060372,-2.18187137855654
ZCTA5 46531,582,10,572,0.01718213058419244,-2.18307544634674
ZCTA5 04955,582,10,572,0.01718213058419244,-2.18307544634674
ZCTA5 44045,193,1,192,0.0051813471502590676,-2.1842995319473215
ZCTA5 36858,138,0,138,0,-2.1855159487302727
ZCTA5 45673,138,0,138,0,-2.1855159487302727
ZCTA5 48502,138,0,138,0,-2.1855159487302727
ZCTA5 64167,138,0,138,0,-2.1855159487302727
ZCTA5 56715,138,0,138,0,-2.1855159487302727
ZCTA5 70639,138,0,138,0,-2.1855159487302727
ZCTA5 83112,138,0,138,0,-2.1855159487302727
ZCTA5 84763,138,0,138,0,-2.1855159487302727
ZCTA5 82723,138,0,138,0,-2.1855159487302727
ZCTA5 15634,138,0,138,0,-2.1855159487302727
ZCTA5 16110,138,0,138,0,-2.1855159487302727
ZCTA5 24894,138,0,138,0,-2.1855159487302727
ZCTA5 86411,138,0,138,0,-2.1855159487302727
ZCTA5 27879,138,0,138,0,-2.1855159487302727
ZCTA5 32009,1217,27,1190,0.02218570254724733,-2.1861318384748794
ZCTA5 71001,1816,44,1772,0.024229074889867842,-2.1862290330947243
ZCTA5 01010,1431,33,1398,0.023060796645702306,-2.1864664026840197
ZCTA5 56355,243,2,241,0.00823045267489712,-2.186637244586257
ZCTA5 05873,290,3,287,0.010344827586206896,-2.188523554184294
ZCTA5 54638,583,10,573,0.017152658662092625,-2.1889074987494985
ZCTA5 13054,583,10,573,0.017152658662092625,-2.1889074987494985
ZCTA5 58369,421,6,415,0.014251781472684086,-2.19109517508253
ZCTA5 42337,777,15,762,0.019305019305019305,-2.1933425524808885
ZCTA5 33304,9329,274,9055,0.02937077929038482,-2.193360760470323
ZCTA5 31814,139,0,139,0,-2.193420191343461
ZCTA5 41712,139,0,139,0,-2.193420191343461
ZCTA5 50120,139,0,139,0,-2.193420191343461
ZCTA5 59931,139,0,139,0,-2.193420191343461
ZCTA5 59915,139,0,139,0,-2.193420191343461
ZCTA5 58480,139,0,139,0,-2.193420191343461
ZCTA5 61431,139,0,139,0,-2.193420191343461
ZCTA5 61251,139,0,139,0,-2.193420191343461
ZCTA5 62998,139,0,139,0,-2.193420191343461
ZCTA5 62850,139,0,139,0,-2.193420191343461
ZCTA5 67584,139,0,139,0,-2.193420191343461
ZCTA5 64422,139,0,139,0,-2.193420191343461
ZCTA5 72179,139,0,139,0,-2.193420191343461
ZCTA5 80457,139,0,139,0,-2.193420191343461
ZCTA5 87828,139,0,139,0,-2.193420191343461
ZCTA5 08316,139,0,139,0,-2.193420191343461
ZCTA5 12424,139,0,139,0,-2.193420191343461
ZCTA5 11970,139,0,139,0,-2.193420191343461
ZCTA5 15430,139,0,139,0,-2.193420191343461
ZCTA5 17974,139,0,139,0,-2.193420191343461
ZCTA5 17005,139,0,139,0,-2.193420191343461
ZCTA5 96075,139,0,139,0,-2.193420191343461
ZCTA5 98571,139,0,139,0,-2.193420191343461
ZCTA5 56725,379,5,374,0.013192612137203167,-2.1935992415857366
ZCTA5 62611,463,7,456,0.01511879049676026,-2.194044469257655
ZCTA5 17060,463,7,456,0.01511879049676026,-2.194044469257655
ZCTA5 65347,244,2,242,0.00819672131147541,-2.1940620430023063
ZCTA5 99929,1074,23,1051,0.021415270018621976,-2.1940926211209657
ZCTA5 16350,964,20,944,0.02074688796680498,-2.1941031717294295
ZCTA5 27707,20646,634,20012,0.030708127482321032,-2.1943248202537733
ZCTA5 80930,701,13,688,0.018544935805991442,-2.195228864031849
ZCTA5 70121,5412,152,5260,0.028085735402808575,-2.1963225829606516
ZCTA5 24263,2436,62,2374,0.025451559934318555,-2.1965330973432016
ZCTA5 49831,336,4,332,0.011904761904761904,-2.196694845326604
ZCTA5 26884,336,4,332,0.011904761904761904,-2.196694845326604
ZCTA5 28791,6449,184,6265,0.028531555279888356,-2.1984276745246416
ZCTA5 68038,624,11,613,0.017628205128205128,-2.198506819488827
ZCTA5 17813,778,15,763,0.019280205655526992,-2.198602477688261
ZCTA5 95223,1363,31,1332,0.022743947175348497,-2.198937062285162
ZCTA5 56211,195,1,194,0.005128205128205128,-2.1997148253229115
ZCTA5 21671,380,5,375,0.013157894736842105,-2.200254854163892
ZCTA5 13744,464,7,457,0.015086206896551725,-2.200315773355
ZCTA5 62932,585,10,575,0.017094017094017096,-2.2005464748154826
ZCTA5 23002,3875,105,3770,0.027096774193548386,-2.2008156848025635
ZCTA5 15475,505,8,497,0.015841584158415842,-2.201070310723129
ZCTA5 93532,1039,22,1017,0.021174205967276226,-2.2012573657291554
ZCTA5 29324,140,0,140,0,-2.201296052200154
ZCTA5 37351,140,0,140,0,-2.201296052200154
ZCTA5 41812,140,0,140,0,-2.201296052200154
ZCTA5 43322,140,0,140,0,-2.201296052200154
ZCTA5 45621,140,0,140,0,-2.201296052200154
ZCTA5 50147,140,0,140,0,-2.201296052200154
ZCTA5 51056,140,0,140,0,-2.201296052200154
ZCTA5 68755,140,0,140,0,-2.201296052200154
ZCTA5 68348,140,0,140,0,-2.201296052200154
ZCTA5 79837,140,0,140,0,-2.201296052200154
ZCTA5 80834,140,0,140,0,-2.201296052200154
ZCTA5 01243,140,0,140,0,-2.201296052200154
ZCTA5 24105,140,0,140,0,-2.201296052200154
ZCTA5 24607,140,0,140,0,-2.201296052200154
ZCTA5 97750,140,0,140,0,-2.201296052200154
ZCTA5 51433,245,2,243,0.00816326530612245,-2.201465668417776
ZCTA5 81091,245,2,243,0.00816326530612245,-2.201465668417776
ZCTA5 25106,245,2,243,0.00816326530612245,-2.201465668417776
ZCTA5 49613,292,3,289,0.010273972602739725,-2.2027904740005884
ZCTA5 64848,292,3,289,0.010273972602739725,-2.2027904740005884
ZCTA5 62868,625,11,614,0.0176,-2.2041890488454086
ZCTA5 05461,1821,44,1777,0.02416254805052169,-2.2050242007244356
ZCTA5 64097,546,9,537,0.016483516483516484,-2.2052613502891028
ZCTA5 21654,546,9,537,0.016483516483516484,-2.2052613502891028
ZCTA5 29067,3579,96,3483,0.026823134953897737,-2.206127035096136
ZCTA5 77318,5806,164,5642,0.028246641405442644,-2.206682973303736
ZCTA5 13835,506,8,498,0.015810276679841896,-2.207164905568009
ZCTA5 75189,8731,255,8476,0.02920627648608407,-2.20737884134098
ZCTA5 64434,196,1,195,0.00510204081632653,-2.207384951506415
ZCTA5 75961,6163,175,5988,0.02839526204770404,-2.2086292559865948
ZCTA5 45659,930,19,911,0.02043010752688172,-2.2087864952715193
ZCTA5 67053,246,2,244,0.008130081300813009,-2.208848286720027
ZCTA5 36722,141,0,141,0,-2.2091438348533994
ZCTA5 43456,141,0,141,0,-2.2091438348533994
ZCTA5 42374,141,0,141,0,-2.2091438348533994
ZCTA5 49820,141,0,141,0,-2.2091438348533994
ZCTA5 52164,141,0,141,0,-2.2091438348533994
ZCTA5 59740,141,0,141,0,-2.2091438348533994
ZCTA5 58214,141,0,141,0,-2.2091438348533994
ZCTA5 62892,141,0,141,0,-2.2091438348533994
ZCTA5 58789,141,0,141,0,-2.2091438348533994
ZCTA5 62630,141,0,141,0,-2.2091438348533994
ZCTA5 65729,141,0,141,0,-2.2091438348533994
ZCTA5 67563,141,0,141,0,-2.2091438348533994
ZCTA5 68033,141,0,141,0,-2.2091438348533994
ZCTA5 56174,141,0,141,0,-2.2091438348533994
ZCTA5 76491,141,0,141,0,-2.2091438348533994
ZCTA5 84775,141,0,141,0,-2.2091438348533994
ZCTA5 12417,141,0,141,0,-2.2091438348533994
ZCTA5 12411,141,0,141,0,-2.2091438348533994
ZCTA5 13777,141,0,141,0,-2.2091438348533994
ZCTA5 17887,141,0,141,0,-2.2091438348533994
ZCTA5 26619,141,0,141,0,-2.2091438348533994
ZCTA5 24487,141,0,141,0,-2.2091438348533994
ZCTA5 39776,626,11,615,0.01757188498402556,-2.209863603451577
ZCTA5 05776,293,3,290,0.010238907849829351,-2.209897008752101
ZCTA5 11784,7741,224,7517,0.028936829866942255,-2.2103044687180287
ZCTA5 53522,424,6,418,0.014150943396226415,-2.2104351081873204
ZCTA5 01904,6164,175,5989,0.028390655418559375,-2.210819737289656
ZCTA5 45347,1753,42,1711,0.023958927552766685,-2.210872984925197
ZCTA5 04627,704,13,691,0.018465909090909092,-2.2115818677759287
ZCTA5 50466,587,10,577,0.017035775127768313,-2.212152146473765
ZCTA5 36262,507,8,499,0.015779092702169626,-2.2132496206450063
ZCTA5 73541,968,20,948,0.02066115702479339,-2.2134838626013327
ZCTA5 47358,382,5,377,0.013089005235602094,-2.213525090121395
ZCTA5 23829,382,5,377,0.013089005235602094,-2.213525090121395
ZCTA5 61087,666,12,654,0.018018018018018018,-2.2153458721420063
ZCTA5 55797,627,11,616,0.017543859649122806,-2.215530509176898
ZCTA5 73096,5062,141,4921,0.027854602923745555,-2.2155666709873896
ZCTA5 45369,1367,31,1336,0.02267739575713241,-2.2158450489351353
ZCTA5 31327,142,0,142,0,-2.2169638374835037
ZCTA5 32692,142,0,142,0,-2.2169638374835037
ZCTA5 40847,142,0,142,0,-2.2169638374835037
ZCTA5 41714,142,0,142,0,-2.2169638374835037
ZCTA5 43931,142,0,142,0,-2.2169638374835037
ZCTA5 43531,142,0,142,0,-2.2169638374835037
ZCTA5 45132,142,0,142,0,-2.2169638374835037
ZCTA5 49722,142,0,142,0,-2.2169638374835037
ZCTA5 52737,142,0,142,0,-2.2169638374835037
ZCTA5 54933,142,0,142,0,-2.2169638374835037
ZCTA5 58063,142,0,142,0,-2.2169638374835037
ZCTA5 58448,142,0,142,0,-2.2169638374835037
ZCTA5 57534,142,0,142,0,-2.2169638374835037
ZCTA5 62915,142,0,142,0,-2.2169638374835037
ZCTA5 71745,142,0,142,0,-2.2169638374835037
ZCTA5 71034,142,0,142,0,-2.2169638374835037
ZCTA5 84035,142,0,142,0,-2.2169638374835037
ZCTA5 87027,142,0,142,0,-2.2169638374835037
ZCTA5 85531,142,0,142,0,-2.2169638374835037
ZCTA5 85934,142,0,142,0,-2.2169638374835037
ZCTA5 05747,142,0,142,0,-2.2169638374835037
ZCTA5 12453,142,0,142,0,-2.2169638374835037
ZCTA5 10933,142,0,142,0,-2.2169638374835037
ZCTA5 14061,142,0,142,0,-2.2169638374835037
ZCTA5 16333,142,0,142,0,-2.2169638374835037
ZCTA5 16260,142,0,142,0,-2.2169638374835037
ZCTA5 16022,142,0,142,0,-2.2169638374835037
ZCTA5 21835,142,0,142,0,-2.2169638374835037
ZCTA5 26217,142,0,142,0,-2.2169638374835037
ZCTA5 26263,142,0,142,0,-2.2169638374835037
ZCTA5 93962,142,0,142,0,-2.2169638374835037
ZCTA5 73654,294,3,291,0.01020408163265306,-2.216985754855713
ZCTA5 15364,294,3,291,0.01020408163265306,-2.216985754855713
ZCTA5 15538,294,3,291,0.01020408163265306,-2.216985754855713
ZCTA5 80611,339,4,335,0.011799410029498525,-2.217266839988137
ZCTA5 15458,969,20,949,0.02063983488132095,-2.218317996643082
ZCTA5 76443,932,19,913,0.0203862660944206,-2.218603393006727
ZCTA5 04472,932,19,913,0.0203862660944206,-2.218603393006727
ZCTA5 22969,508,8,500,0.015748031496062992,-2.2193244965630563
ZCTA5 39756,782,15,767,0.01918158567774936,-2.2195838483994743
ZCTA5 71373,2477,63,2414,0.025433992733144933,-2.2198029023201613
ZCTA5 04069,628,11,617,0.01751592356687898,-2.221189791758039
ZCTA5 38114,10013,295,9718,0.029461699790272647,-2.221751956465001
ZCTA5 62356,198,1,197,0.005050505050505051,-2.2226513147563685
ZCTA5 82213,248,2,246,0.008064516129032258,-2.2235511553081793
ZCTA5 97364,248,2,246,0.008064516129032258,-2.2235511553081793
ZCTA5 15344,589,10,579,0.01697792869269949,-2.223724752113692
ZCTA5 76060,2749,71,2678,0.025827573663150236,-2.2237491563782603
ZCTA5 56545,295,3,292,0.010169491525423728,-2.224056831807981
ZCTA5 04648,295,3,292,0.010169491525423728,-2.224056831807981
ZCTA5 05737,340,4,336,0.011764705882352941,-2.2240933762756248
ZCTA5 31318,143,0,143,0,-2.2247563530302332
ZCTA5 42047,143,0,143,0,-2.2247563530302332
ZCTA5 49282,143,0,143,0,-2.2247563530302332
ZCTA5 55756,143,0,143,0,-2.2247563530302332
ZCTA5 66094,143,0,143,0,-2.2247563530302332
ZCTA5 67066,143,0,143,0,-2.2247563530302332
ZCTA5 56091,143,0,143,0,-2.2247563530302332
ZCTA5 72839,143,0,143,0,-2.2247563530302332
ZCTA5 72414,143,0,143,0,-2.2247563530302332
ZCTA5 73739,143,0,143,0,-2.2247563530302332
ZCTA5 84529,143,0,143,0,-2.2247563530302332
ZCTA5 13163,143,0,143,0,-2.2247563530302332
ZCTA5 15689,143,0,143,0,-2.2247563530302332
ZCTA5 16911,143,0,143,0,-2.2247563530302332
ZCTA5 21156,143,0,143,0,-2.2247563530302332
ZCTA5 25932,143,0,143,0,-2.2247563530302332
ZCTA5 48865,783,15,768,0.019157088122605363,-2.224814688084215
ZCTA5 54007,468,7,461,0.014957264957264958,-2.225291986387282
ZCTA5 35034,1081,23,1058,0.02127659574468085,-2.226586700364045
ZCTA5 63732,384,5,379,0.013020833333333334,-2.226741158936252
ZCTA5 15352,384,5,379,0.013020833333333334,-2.226741158936252
ZCTA5 33876,2000,49,1951,0.0245,-2.2269339142611173
ZCTA5 84339,1441,33,1408,0.022900763358778626,-2.22787631139349
ZCTA5 89021,971,20,951,0.02059732234809475,-2.2279730867957004
ZCTA5 31806,1862,45,1817,0.024167561761546726,-2.2285060705229465
ZCTA5 97222,15480,468,15012,0.030232558139534883,-2.2291153263286287
ZCTA5 85324,1406,32,1374,0.02275960170697013,-2.230089475393707
ZCTA5 33982,4117,112,4005,0.02720427495749332,-2.2301384158876427
ZCTA5 36314,199,1,198,0.005025125628140704,-2.2302480023564724
ZCTA5 45734,199,1,198,0.005025125628140704,-2.2302480023564724
ZCTA5 16671,199,1,198,0.005025125628140704,-2.2302480023564724
ZCTA5 28020,822,16,806,0.019464720194647202,-2.2304996211771435
ZCTA5 01515,822,16,806,0.019464720194647202,-2.2304996211771435
ZCTA5 03284,341,4,337,0.011730205278592375,-2.230904666800797
ZCTA5 74641,296,3,293,0.010135135135135136,-2.2311103578504703
ZCTA5 61421,510,8,502,0.01568627450980392,-2.231444892081794
ZCTA5 25209,510,8,502,0.01568627450980392,-2.231444892081794
ZCTA5 49436,669,12,657,0.017937219730941704,-2.23195171646684
ZCTA5 40997,144,0,144,0,-2.2325216693208567
ZCTA5 52220,144,0,144,0,-2.2325216693208567
ZCTA5 59226,144,0,144,0,-2.2325216693208567
ZCTA5 59456,144,0,144,0,-2.2325216693208567
ZCTA5 58649,144,0,144,0,-2.2325216693208567
ZCTA5 68976,144,0,144,0,-2.2325216693208567
ZCTA5 67863,144,0,144,0,-2.2325216693208567
ZCTA5 56155,144,0,144,0,-2.2325216693208567
ZCTA5 70541,144,0,144,0,-2.2325216693208567
ZCTA5 72624,144,0,144,0,-2.2325216693208567
ZCTA5 12176,144,0,144,0,-2.2325216693208567
ZCTA5 15086,144,0,144,0,-2.2325216693208567
ZCTA5 17749,144,0,144,0,-2.2325216693208567
ZCTA5 16860,144,0,144,0,-2.2325216693208567
ZCTA5 18461,144,0,144,0,-2.2325216693208567
ZCTA5 25076,144,0,144,0,-2.2325216693208567
ZCTA5 95934,144,0,144,0,-2.2325216693208567
ZCTA5 94971,144,0,144,0,-2.2325216693208567
ZCTA5 96037,144,0,144,0,-2.2325216693208567
ZCTA5 08610,11194,332,10862,0.02965874575665535,-2.233187589344355
ZCTA5 57002,385,5,380,0.012987012987012988,-2.233329060341436
ZCTA5 28762,2786,72,2714,0.025843503230437905,-2.2339885266487154
ZCTA5 30083,19711,603,19108,0.030592055197605397,-2.2346863002412745
ZCTA5 72840,898,18,880,0.0200445434298441,-2.23470689709573
ZCTA5 73566,747,14,733,0.018741633199464525,-2.236213951649585
ZCTA5 30251,861,17,844,0.019744483159117306,-2.2371482847626867
ZCTA5 23156,670,12,658,0.01791044776119403,-2.237472945280841
ZCTA5 05847,342,4,338,0.011695906432748537,-2.2377008014302353
ZCTA5 54631,709,13,696,0.018335684062059238,-2.238704873213565
ZCTA5 63015,1047,22,1025,0.021012416427889206,-2.2388286361917644
ZCTA5 64742,899,18,881,0.020022246941045607,-2.239668563663342
ZCTA5 28553,145,0,145,0,-2.240260069194196
ZCTA5 58038,145,0,145,0,-2.240260069194196
ZCTA5 57067,145,0,145,0,-2.240260069194196
ZCTA5 59927,145,0,145,0,-2.240260069194196
ZCTA5 58017,145,0,145,0,-2.240260069194196
ZCTA5 57461,145,0,145,0,-2.240260069194196
ZCTA5 65244,145,0,145,0,-2.240260069194196
ZCTA5 67351,145,0,145,0,-2.240260069194196
ZCTA5 68338,145,0,145,0,-2.240260069194196
ZCTA5 56173,145,0,145,0,-2.240260069194196
ZCTA5 74760,145,0,145,0,-2.240260069194196
ZCTA5 77961,145,0,145,0,-2.240260069194196
ZCTA5 05868,145,0,145,0,-2.240260069194196
ZCTA5 18221,145,0,145,0,-2.240260069194196
ZCTA5 22504,145,0,145,0,-2.240260069194196
ZCTA5 76802,1900,46,1854,0.024210526315789474,-2.240716293907162
ZCTA5 12917,552,9,543,0.016304347826086956,-2.2407547040685367
ZCTA5 62056,3791,102,3689,0.026905829596412557,-2.2422113648015736
ZCTA5 77880,512,8,504,0.015625,-2.2435264119204805
ZCTA5 70653,1302,29,1273,0.02227342549923195,-2.2435845716467013
ZCTA5 54821,632,11,621,0.01740506329113924,-2.243751200773168
ZCTA5 29940,1445,33,1412,0.022837370242214532,-2.2443673545869274
ZCTA5 20191,11581,344,11237,0.029703825230981782,-2.244484244803922
ZCTA5 37753,298,3,295,0.010067114093959731,-2.245165224003229
ZCTA5 52330,298,3,295,0.010067114093959731,-2.245165224003229
ZCTA5 07010,10535,311,10224,0.02952064546748932,-2.245282758041784
ZCTA5 72024,1374,31,1343,0.022561863173216887,-2.245326717071287
ZCTA5 51048,251,2,249,0.00796812749003984,-2.2454519358427407
ZCTA5 28073,2040,50,1990,0.024509803921568627,-2.2466304961285757
ZCTA5 68636,593,10,583,0.016863406408094434,-2.246771705935862
ZCTA5 07112,9582,281,9301,0.029325819244416615,-2.2473782168592122
ZCTA5 41264,146,0,146,0,-2.247971830620834
ZCTA5 43077,146,0,146,0,-2.247971830620834
ZCTA5 45617,146,0,146,0,-2.247971830620834
ZCTA5 47580,146,0,146,0,-2.247971830620834
ZCTA5 61730,146,0,146,0,-2.247971830620834
ZCTA5 61466,146,0,146,0,-2.247971830620834
ZCTA5 62091,146,0,146,0,-2.247971830620834
ZCTA5 66936,146,0,146,0,-2.247971830620834
ZCTA5 68457,146,0,146,0,-2.247971830620834
ZCTA5 67131,146,0,146,0,-2.247971830620834
ZCTA5 67485,146,0,146,0,-2.247971830620834
ZCTA5 56448,146,0,146,0,-2.247971830620834
ZCTA5 76466,146,0,146,0,-2.247971830620834
ZCTA5 73540,146,0,146,0,-2.247971830620834
ZCTA5 12071,146,0,146,0,-2.247971830620834
ZCTA5 18333,146,0,146,0,-2.247971830620834
ZCTA5 19523,146,0,146,0,-2.247971830620834
ZCTA5 18462,146,0,146,0,-2.247971830620834
ZCTA5 23899,146,0,146,0,-2.247971830620834
ZCTA5 24217,146,0,146,0,-2.247971830620834
ZCTA5 24168,146,0,146,0,-2.247971830620834
ZCTA5 26075,146,0,146,0,-2.247971830620834
ZCTA5 93541,146,0,146,0,-2.247971830620834
ZCTA5 96141,146,0,146,0,-2.247971830620834
ZCTA5 98224,146,0,146,0,-2.247971830620834
ZCTA5 62048,672,12,660,0.017857142857142856,-2.2484944569097403
ZCTA5 59327,1195,26,1169,0.021757322175732216,-2.248634584652429
ZCTA5 51006,430,6,424,0.013953488372093023,-2.248790170367181
ZCTA5 07041,2520,64,2456,0.025396825396825397,-2.2493634450468094
ZCTA5 68940,252,2,250,0.007936507936507936,-2.2527118825410724
ZCTA5 56245,252,2,250,0.007936507936507936,-2.2527118825410724
ZCTA5 05353,388,5,383,0.01288659793814433,-2.25301308091077
ZCTA5 83804,673,12,661,0.017830609212481426,-2.2539947836664536
ZCTA5 03907,634,11,623,0.017350157728706624,-2.2549868259517907
ZCTA5 38318,147,0,147,0,-2.255657226819621
ZCTA5 40958,147,0,147,0,-2.255657226819621
ZCTA5 40316,147,0,147,0,-2.255657226819621
ZCTA5 54211,147,0,147,0,-2.255657226819621
ZCTA5 70513,147,0,147,0,-2.255657226819621
ZCTA5 77974,147,0,147,0,-2.255657226819621
ZCTA5 84715,147,0,147,0,-2.255657226819621
ZCTA5 21077,147,0,147,0,-2.255657226819621
ZCTA5 95607,147,0,147,0,-2.255657226819621
ZCTA5 98613,147,0,147,0,-2.255657226819621
ZCTA5 60927,827,16,811,0.019347037484885126,-2.2560934820115093
ZCTA5 93023,7989,231,7758,0.028914757791963952,-2.2564024924656114
ZCTA5 33036,1519,35,1484,0.02304147465437788,-2.256880196837964
ZCTA5 73028,1377,31,1346,0.022512708787218592,-2.2579202170551964
ZCTA5 16210,345,4,341,0.011594202898550725,-2.2579991563271
ZCTA5 04010,595,10,585,0.01680672268907563,-2.2582465180488462
ZCTA5 76044,1484,34,1450,0.022911051212938006,-2.258668348863393
ZCTA5 16120,903,18,885,0.019933554817275746,-2.2594671082715685
ZCTA5 91364,10607,313,10294,0.02950881493353446,-2.2597180805328065
ZCTA5 59824,635,11,624,0.01732283464566929,-2.260593456175114
ZCTA5 17238,635,11,624,0.01732283464566929,-2.260593456175114
ZCTA5 37705,1626,38,1588,0.023370233702337023,-2.261293471430514
ZCTA5 97431,866,17,849,0.019630484988452657,-2.2622907282274687
ZCTA5 49833,148,0,148,0,-2.2633165263706227
ZCTA5 66962,148,0,148,0,-2.2633165263706227
ZCTA5 68321,148,0,148,0,-2.2633165263706227
ZCTA5 68357,148,0,148,0,-2.2633165263706227
ZCTA5 72655,148,0,148,0,-2.2633165263706227
ZCTA5 80747,148,0,148,0,-2.2633165263706227
ZCTA5 82923,148,0,148,0,-2.2633165263706227
ZCTA5 84756,148,0,148,0,-2.2633165263706227
ZCTA5 84306,148,0,148,0,-2.2633165263706227
ZCTA5 08353,148,0,148,0,-2.2633165263706227
ZCTA5 15841,148,0,148,0,-2.2633165263706227
ZCTA5 22972,148,0,148,0,-2.2633165263706227
ZCTA5 25846,148,0,148,0,-2.2633165263706227
ZCTA5 23894,148,0,148,0,-2.2633165263706227
ZCTA5 86445,148,0,148,0,-2.2633165263706227
ZCTA5 89425,148,0,148,0,-2.2633165263706227
ZCTA5 39175,1697,40,1657,0.02357100766057749,-2.2641410796374632
ZCTA5 29911,556,9,547,0.01618705035971223,-2.2642398888330884
ZCTA5 72027,556,9,547,0.01618705035971223,-2.2642398888330884
ZCTA5 49460,2998,78,2920,0.02601734489659773,-2.264493943562509
ZCTA5 97830,346,4,342,0.011560693641618497,-2.264735549732132
ZCTA5 77389,11245,333,10912,0.02961316140506892,-2.265150842428816
ZCTA5 21555,636,11,625,0.01729559748427673,-2.2661926644703376
ZCTA5 74002,791,15,776,0.018963337547408345,-2.266455008334755
ZCTA5 49861,254,2,252,0.007874015748031496,-2.2671722218535555
ZCTA5 72532,516,8,508,0.015503875968992248,-2.2675740838619727
ZCTA5 31018,475,7,468,0.014736842105263158,-2.268588058879518
ZCTA5 50174,597,10,587,0.01675041876046901,-2.2696891920781064
ZCTA5 56587,557,9,548,0.01615798922800718,-2.2700893593481717
ZCTA5 53965,4429,121,4308,0.027319936780311582,-2.2702928893018552
ZCTA5 32631,149,0,149,0,-2.27094999332464
ZCTA5 40310,149,0,149,0,-2.27094999332464
ZCTA5 54450,149,0,149,0,-2.27094999332464
ZCTA5 57633,149,0,149,0,-2.27094999332464
ZCTA5 58466,149,0,149,0,-2.27094999332464
ZCTA5 59074,149,0,149,0,-2.27094999332464
ZCTA5 62413,149,0,149,0,-2.27094999332464
ZCTA5 78886,149,0,149,0,-2.27094999332464
ZCTA5 84665,149,0,149,0,-2.27094999332464
ZCTA5 83466,149,0,149,0,-2.27094999332464
ZCTA5 03754,149,0,149,0,-2.27094999332464
ZCTA5 13638,149,0,149,0,-2.27094999332464
ZCTA5 24945,149,0,149,0,-2.27094999332464
ZCTA5 27826,149,0,149,0,-2.27094999332464
ZCTA5 97102,149,0,149,0,-2.27094999332464
ZCTA5 49620,1017,21,996,0.02064896755162242,-2.270977147338041
ZCTA5 04555,715,13,702,0.01818181818181818,-2.2710377051466866
ZCTA5 17073,1943,47,1896,0.024189397838394237,-2.2711091703235935
ZCTA5 67024,347,4,343,0.011527377521613832,-2.2714572244304976
ZCTA5 68764,347,4,343,0.011527377521613832,-2.2714572244304976
ZCTA5 51331,637,11,626,0.01726844583987441,-2.2717844754178995
ZCTA5 62970,302,3,299,0.009933774834437087,-2.273069412791833
ZCTA5 48457,3001,78,2923,0.02599133622125958,-2.2735501136070893
ZCTA5 97845,1309,29,1280,0.02215431627196333,-2.273572680425627
ZCTA5 11788,5478,153,5325,0.02792990142387733,-2.2738152987870053
ZCTA5 61843,906,18,888,0.019867549668874173,-2.2742658079425144
ZCTA5 05824,476,7,469,0.014705882352941176,-2.2747311239313652
ZCTA5 42634,598,10,588,0.016722408026755852,-2.275398547956477
ZCTA5 98683,13687,410,13277,0.02995543216190546,-2.276347351270584
ZCTA5 49042,1945,47,1898,0.02416452442159383,-2.278378138187036
ZCTA5 38235,150,0,150,0,-2.2785578873094234
ZCTA5 52134,150,0,150,0,-2.2785578873094234
ZCTA5 59761,150,0,150,0,-2.2785578873094234
ZCTA5 57322,150,0,150,0,-2.2785578873094234
ZCTA5 61851,150,0,150,0,-2.2785578873094234
ZCTA5 60029,150,0,150,0,-2.2785578873094234
ZCTA5 67028,150,0,150,0,-2.2785578873094234
ZCTA5 56161,150,0,150,0,-2.2785578873094234
ZCTA5 73761,150,0,150,0,-2.2785578873094234
ZCTA5 83209,150,0,150,0,-2.2785578873094234
ZCTA5 16732,150,0,150,0,-2.2785578873094234
ZCTA5 15313,150,0,150,0,-2.2785578873094234
ZCTA5 20615,150,0,150,0,-2.2785578873094234
ZCTA5 21677,150,0,150,0,-2.2785578873094234
ZCTA5 25139,150,0,150,0,-2.2785578873094234
ZCTA5 27985,150,0,150,0,-2.2785578873094234
ZCTA5 91934,150,0,150,0,-2.2785578873094234
ZCTA5 65810,9281,271,9010,0.029199439715547892,-2.2795056224246117
ZCTA5 56240,435,6,429,0.013793103448275862,-2.2804292445385035
ZCTA5 17517,5839,164,5675,0.028087001198835417,-2.280783487491107
ZCTA5 95410,477,7,470,0.014675052410901468,-2.280863804181969
ZCTA5 52626,559,9,550,0.016100178890876567,-2.2817623386560375
ZCTA5 67737,206,1,205,0.0048543689320388345,-2.2827637886958017
ZCTA5 72394,206,1,205,0.0048543689320388345,-2.2827637886958017
ZCTA5 82244,206,1,205,0.0048543689320388345,-2.2827637886958017
ZCTA5 54745,908,18,890,0.019823788546255508,-2.284107868119234
ZCTA5 30627,1020,21,999,0.020588235294117647,-2.285110757049559
ZCTA5 04364,2497,63,2434,0.02523027633159792,-2.2853572297226945
ZCTA5 42328,519,8,511,0.015414258188824663,-2.285510109610702
ZCTA5 04487,393,5,388,0.01272264631043257,-2.2855583174153944
ZCTA5 40858,151,0,151,0,-2.28614046363271
ZCTA5 49335,151,0,151,0,-2.28614046363271
ZCTA5 62452,151,0,151,0,-2.28614046363271
ZCTA5 64455,151,0,151,0,-2.28614046363271
ZCTA5 64431,151,0,151,0,-2.28614046363271
ZCTA5 67643,151,0,151,0,-2.28614046363271
ZCTA5 71661,151,0,151,0,-2.28614046363271
ZCTA5 76238,151,0,151,0,-2.28614046363271
ZCTA5 01074,151,0,151,0,-2.28614046363271
ZCTA5 82055,151,0,151,0,-2.28614046363271
ZCTA5 05041,151,0,151,0,-2.28614046363271
ZCTA5 18220,151,0,151,0,-2.28614046363271
ZCTA5 25054,151,0,151,0,-2.28614046363271
ZCTA5 26731,151,0,151,0,-2.28614046363271
ZCTA5 98647,151,0,151,0,-2.28614046363271
ZCTA5 95817,6004,169,5835,0.02814790139906729,-2.2865421606342258
ZCTA5 55065,436,6,430,0.013761467889908258,-2.2867224385446647
ZCTA5 13368,436,6,430,0.013761467889908258,-2.2867224385446647
ZCTA5 98262,436,6,430,0.013761467889908258,-2.2867224385446647
ZCTA5 45333,478,7,471,0.014644351464435146,-2.286986144613926
ZCTA5 36908,795,15,780,0.018867924528301886,-2.2871391725808263
ZCTA5 55005,1562,36,1526,0.023047375160051217,-2.2873044055487637
ZCTA5 93063,19096,582,18514,0.030477586929199833,-2.287514918965755
ZCTA5 43540,560,9,551,0.01607142857142857,-2.2875859121522195
ZCTA5 73024,257,2,255,0.007782101167315175,-2.288716074685731
ZCTA5 79532,257,2,255,0.007782101167315175,-2.288716074685731
ZCTA5 65582,909,18,891,0.019801980198019802,-2.2890218098918886
ZCTA5 26301,11862,352,11510,0.029674591131343787,-2.289257455074886
ZCTA5 85534,1021,21,1000,0.02056807051909892,-2.289813821353507
ZCTA5 30455,207,1,206,0.004830917874396135,-2.2901741062557277
ZCTA5 97039,207,1,206,0.004830917874396135,-2.2901741062557277
ZCTA5 50173,350,4,346,0.011428571428571429,-2.291534783246667
ZCTA5 54526,350,4,346,0.011428571428571429,-2.291534783246667
ZCTA5 66966,350,4,346,0.011428571428571429,-2.291534783246667
ZCTA5 68979,796,15,781,0.018844221105527637,-2.2922962119270887
ZCTA5 56338,680,12,668,0.01764705882352941,-2.2923044190191404
ZCTA5 27882,2940,76,2864,0.02585034013605442,-2.29283992571661
ZCTA5 54545,437,6,431,0.013729977116704805,-2.2930042190223068
ZCTA5 13485,437,6,431,0.013729977116704805,-2.2930042190223068
ZCTA5 22747,437,6,431,0.013729977116704805,-2.2930042190223068
ZCTA5 30470,152,0,152,0,-2.293697973382194
ZCTA5 40941,152,0,152,0,-2.293697973382194
ZCTA5 50444,152,0,152,0,-2.293697973382194
ZCTA5 62280,152,0,152,0,-2.293697973382194
ZCTA5 69125,152,0,152,0,-2.293697973382194
ZCTA5 56722,152,0,152,0,-2.293697973382194
ZCTA5 81210,152,0,152,0,-2.293697973382194
ZCTA5 84051,152,0,152,0,-2.293697973382194
ZCTA5 02872,152,0,152,0,-2.293697973382194
ZCTA5 05748,152,0,152,0,-2.293697973382194
ZCTA5 03770,152,0,152,0,-2.293697973382194
ZCTA5 15847,152,0,152,0,-2.293697973382194
ZCTA5 24974,152,0,152,0,-2.293697973382194
ZCTA5 97414,152,0,152,0,-2.293697973382194
ZCTA5 54149,641,11,630,0.0171606864274571,-2.294078233011628
ZCTA5 79226,1096,23,1073,0.020985401459854013,-2.2955922576913776
ZCTA5 62963,258,2,256,0.007751937984496124,-2.2958588327803358
ZCTA5 48877,948,19,929,0.020042194092827006,-2.2964799076262663
ZCTA5 47460,4604,126,4478,0.02736750651607298,-2.2967607510905577
ZCTA5 55812,3545,94,3451,0.026516220028208744,-2.297245439703269
ZCTA5 71835,521,8,513,0.015355086372360844,-2.2974205409370887
ZCTA5 10509,6851,195,6656,0.028462998102466792,-2.2974684857991985
ZCTA5 50430,208,1,207,0.004807692307692308,-2.297562041060315
ZCTA5 50446,208,1,207,0.004807692307692308,-2.297562041060315
ZCTA5 63361,1881,45,1836,0.023923444976076555,-2.29872543148357
ZCTA5 40078,911,18,893,0.019758507135016465,-2.2988355723490574
ZCTA5 62463,480,7,473,0.014583333333333334,-2.2991999844573
ZCTA5 55006,1565,36,1529,0.023003194888178913,-2.2992194739462275
ZCTA5 28519,153,0,153,0,-2.3012306635225386
ZCTA5 36446,153,0,153,0,-2.3012306635225386
ZCTA5 41832,153,0,153,0,-2.3012306635225386
ZCTA5 47420,153,0,153,0,-2.3012306635225386
ZCTA5 51029,153,0,153,0,-2.3012306635225386
ZCTA5 52169,153,0,153,0,-2.3012306635225386
ZCTA5 63782,153,0,153,0,-2.3012306635225386
ZCTA5 67556,153,0,153,0,-2.3012306635225386
ZCTA5 68950,153,0,153,0,-2.3012306635225386
ZCTA5 67483,153,0,153,0,-2.3012306635225386
ZCTA5 68637,153,0,153,0,-2.3012306635225386
ZCTA5 56035,153,0,153,0,-2.3012306635225386
ZCTA5 72538,153,0,153,0,-2.3012306635225386
ZCTA5 73661,153,0,153,0,-2.3012306635225386
ZCTA5 80818,153,0,153,0,-2.3012306635225386
ZCTA5 81331,153,0,153,0,-2.3012306635225386
ZCTA5 87029,153,0,153,0,-2.3012306635225386
ZCTA5 03259,153,0,153,0,-2.3012306635225386
ZCTA5 14752,153,0,153,0,-2.3012306635225386
ZCTA5 13804,153,0,153,0,-2.3012306635225386
ZCTA5 15446,153,0,153,0,-2.3012306635225386
ZCTA5 27956,153,0,153,0,-2.3012306635225386
ZCTA5 97846,874,17,857,0.019450800915331808,-2.302257307731599
ZCTA5 08226,5262,146,5116,0.02774610414291144,-2.3026799617100524
ZCTA5 12935,682,12,670,0.017595307917888565,-2.3031887465381073
ZCTA5 83323,522,8,514,0.01532567049808429,-2.3033617931884462
ZCTA5 45890,209,1,208,0.004784688995215311,-2.3049277866242854
ZCTA5 47968,396,5,391,0.012626262626262626,-2.304931549280739
ZCTA5 43435,481,7,474,0.014553014553014554,-2.3052915723468623
ZCTA5 98338,9520,278,9242,0.029201680672268908,-2.3074534991367877
ZCTA5 15436,1172,25,1147,0.021331058020477817,-2.3080430892488146
ZCTA5 65248,1389,31,1358,0.022318214542836574,-2.308048071282991
ZCTA5 98624,683,12,671,0.017569546120058566,-2.3086208020201404
ZCTA5 41834,154,0,154,0,-2.3087387769895455
ZCTA5 52077,154,0,154,0,-2.3087387769895455
ZCTA5 76077,154,0,154,0,-2.3087387769895455
ZCTA5 04275,154,0,154,0,-2.3087387769895455
ZCTA5 05059,154,0,154,0,-2.3087387769895455
ZCTA5 12970,154,0,154,0,-2.3087387769895455
ZCTA5 16326,154,0,154,0,-2.3087387769895455
ZCTA5 22931,154,0,154,0,-2.3087387769895455
ZCTA5 25028,154,0,154,0,-2.3087387769895455
ZCTA5 38379,523,8,515,0.015296367112810707,-2.309293785892807
ZCTA5 31773,1461,33,1428,0.022587268993839837,-2.3099210540897794
ZCTA5 54858,761,14,747,0.018396846254927726,-2.309965813539395
ZCTA5 27231,761,14,747,0.018396846254927726,-2.309965813539395
ZCTA5 50134,260,2,258,0.007692307692307693,-2.3100874123945725
ZCTA5 87747,564,9,555,0.015957446808510637,-2.3107948446940907
ZCTA5 12193,723,13,710,0.017980636237897647,-2.3137904804290748
ZCTA5 74555,308,3,305,0.00974025974025974,-2.3144251011135766
ZCTA5 29936,5038,139,4899,0.02759031361651449,-2.3146292175790157
ZCTA5 93021,11783,349,11434,0.029618942544343545,-2.3152143061537
ZCTA5 29580,524,8,516,0.015267175572519083,-2.3152165558131492
ZCTA5 57279,524,8,516,0.015267175572519083,-2.3152165558131492
ZCTA5 70544,3984,107,3877,0.026857429718875503,-2.3155673756602337
ZCTA5 01089,12037,357,11680,0.029658552795547063,-2.315867794805859
ZCTA5 14208,4282,116,4166,0.0270901447921532,-2.315921236044837
ZCTA5 32323,155,0,155,0,-2.316222552781572
ZCTA5 46759,155,0,155,0,-2.316222552781572
ZCTA5 50034,155,0,155,0,-2.316222552781572
ZCTA5 57324,155,0,155,0,-2.316222552781572
ZCTA5 62862,155,0,155,0,-2.316222552781572
ZCTA5 81121,155,0,155,0,-2.316222552781572
ZCTA5 85336,155,0,155,0,-2.316222552781572
ZCTA5 04417,155,0,155,0,-2.316222552781572
ZCTA5 15449,155,0,155,0,-2.316222552781572
ZCTA5 17247,155,0,155,0,-2.316222552781572
ZCTA5 23416,155,0,155,0,-2.316222552781572
ZCTA5 23423,155,0,155,0,-2.316222552781572
ZCTA5 25057,155,0,155,0,-2.316222552781572
ZCTA5 26823,155,0,155,0,-2.316222552781572
ZCTA5 98821,155,0,155,0,-2.316222552781572
ZCTA5 27406,24113,742,23371,0.03077178285572098,-2.316450779423171
ZCTA5 52033,1283,28,1255,0.021823850350740453,-2.3167068867372027
ZCTA5 45612,1816,43,1773,0.0236784140969163,-2.3167274445850485
ZCTA5 12789,877,17,860,0.019384264538198404,-2.3171629332224004
ZCTA5 57037,398,5,393,0.01256281407035176,-2.3177840034174007
ZCTA5 70075,1711,40,1671,0.023378141437755698,-2.3178267040757476
ZCTA5 54820,354,4,350,0.011299435028248588,-2.3181038748464706
ZCTA5 16943,211,1,210,0.004739336492890996,-2.3195934706604517
ZCTA5 45249,5400,150,5250,0.027777777777777776,-2.319735637785938
ZCTA5 48701,606,10,596,0.0165016501650165,-2.320789513304225
ZCTA5 28357,1065,22,1043,0.020657276995305163,-2.32244363695722
ZCTA5 78636,1571,36,1535,0.022915340547422024,-2.3229875716724577
ZCTA5 39156,156,0,156,0,-2.3236822260483
ZCTA5 42326,156,0,156,0,-2.3236822260483
ZCTA5 47849,156,0,156,0,-2.3236822260483
ZCTA5 50837,156,0,156,0,-2.3236822260483
ZCTA5 59443,156,0,156,0,-2.3236822260483
ZCTA5 62446,156,0,156,0,-2.3236822260483
ZCTA5 63460,156,0,156,0,-2.3236822260483
ZCTA5 65329,156,0,156,0,-2.3236822260483
ZCTA5 72168,156,0,156,0,-2.3236822260483
ZCTA5 77655,156,0,156,0,-2.3236822260483
ZCTA5 82643,156,0,156,0,-2.3236822260483
ZCTA5 78567,156,0,156,0,-2.3236822260483
ZCTA5 82922,156,0,156,0,-2.3236822260483
ZCTA5 12743,156,0,156,0,-2.3236822260483
ZCTA5 14173,156,0,156,0,-2.3236822260483
ZCTA5 13861,156,0,156,0,-2.3236822260483
ZCTA5 15713,156,0,156,0,-2.3236822260483
ZCTA5 25826,156,0,156,0,-2.3236822260483
ZCTA5 96129,156,0,156,0,-2.3236822260483
ZCTA5 50625,442,6,436,0.013574660633484163,-2.324243778636582
ZCTA5 61754,442,6,436,0.013574660633484163,-2.324243778636582
ZCTA5 49744,355,4,351,0.011267605633802818,-2.3247107995943654
ZCTA5 51443,686,12,674,0.01749271137026239,-2.324876784649654
ZCTA5 54205,764,14,750,0.01832460732984293,-2.325618529237574
ZCTA5 27562,764,14,750,0.01832460732984293,-2.325618529237574
ZCTA5 56634,607,10,597,0.016474464579901153,-2.32642830867808
ZCTA5 38651,2680,68,2612,0.025373134328358207,-2.3264934419956695
ZCTA5 90035,12329,366,11963,0.029686105929110227,-2.3267755847822755
ZCTA5 85625,1029,21,1008,0.02040816326530612,-2.3272930608581484
ZCTA5 75147,2510,63,2447,0.0250996015936255,-2.3277061404526043
ZCTA5 53114,992,20,972,0.020161290322580645,-2.328309174973689
ZCTA5 47665,1394,31,1363,0.02223816355810617,-2.3288196492628948
ZCTA5 54538,1537,35,1502,0.02277163305139883,-2.3290440933157455
ZCTA5 53826,485,7,478,0.01443298969072165,-2.32955672901593
ZCTA5 55990,400,5,395,0.0125,-2.330586629413714
ZCTA5 36052,157,0,157,0,-2.3311180281769484
ZCTA5 39877,157,0,157,0,-2.3311180281769484
ZCTA5 49955,157,0,157,0,-2.3311180281769484
ZCTA5 47966,157,0,157,0,-2.3311180281769484
ZCTA5 47525,157,0,157,0,-2.3311180281769484
ZCTA5 53557,157,0,157,0,-2.3311180281769484
ZCTA5 63443,157,0,157,0,-2.3311180281769484
ZCTA5 65287,157,0,157,0,-2.3311180281769484
ZCTA5 63739,157,0,157,0,-2.3311180281769484
ZCTA5 66017,157,0,157,0,-2.3311180281769484
ZCTA5 56758,157,0,157,0,-2.3311180281769484
ZCTA5 73947,157,0,157,0,-2.3311180281769484
ZCTA5 73660,157,0,157,0,-2.3311180281769484
ZCTA5 76854,157,0,157,0,-2.3311180281769484
ZCTA5 80612,157,0,157,0,-2.3311180281769484
ZCTA5 08023,157,0,157,0,-2.3311180281769484
ZCTA5 14486,157,0,157,0,-2.3311180281769484
ZCTA5 18256,157,0,157,0,-2.3311180281769484
ZCTA5 95417,157,0,157,0,-2.3311180281769484
ZCTA5 97147,157,0,157,0,-2.3311180281769484
ZCTA5 98644,157,0,157,0,-2.3311180281769484
ZCTA5 68409,356,4,352,0.011235955056179775,-2.3313037445620193
ZCTA5 51249,1395,31,1364,0.022222222222222223,-2.332965921007189
ZCTA5 72101,1141,24,1117,0.021034180543382998,-2.33308182975013
ZCTA5 54626,568,9,559,0.01584507042253521,-2.333868710243709
ZCTA5 12565,568,9,559,0.01584507042253521,-2.333868710243709
ZCTA5 71435,1251,27,1224,0.02158273381294964,-2.335059586322716
ZCTA5 47272,766,14,752,0.018276762402088774,-2.3360245371596253
ZCTA5 48761,444,6,438,0.013513513513513514,-2.3366615519532803
ZCTA5 62017,444,6,438,0.013513513513513514,-2.3366615519532803
ZCTA5 61036,3022,78,2944,0.025810721376571807,-2.336706876942465
ZCTA5 72021,1716,40,1676,0.023310023310023312,-2.3369031122775485
ZCTA5 49619,401,5,396,0.012468827930174564,-2.3369694147461697
ZCTA5 22027,609,10,599,0.016420361247947456,-2.3376828117349673
ZCTA5 21623,609,10,599,0.016420361247947456,-2.3376828117349673
ZCTA5 08311,649,11,638,0.01694915254237288,-2.3383179939190386
ZCTA5 60952,264,2,262,0.007575757575757576,-2.338320689605743
ZCTA5 67738,264,2,262,0.007575757575757576,-2.338320689605743
ZCTA5 29840,158,0,158,0,-2.3385301868760178
ZCTA5 57040,158,0,158,0,-2.3385301868760178
ZCTA5 62601,158,0,158,0,-2.3385301868760178
ZCTA5 69146,158,0,158,0,-2.3385301868760178
ZCTA5 56458,158,0,158,0,-2.3385301868760178
ZCTA5 73041,158,0,158,0,-2.3385301868760178
ZCTA5 72584,158,0,158,0,-2.3385301868760178
ZCTA5 80510,158,0,158,0,-2.3385301868760178
ZCTA5 83841,158,0,158,0,-2.3385301868760178
ZCTA5 82932,158,0,158,0,-2.3385301868760178
ZCTA5 16634,158,0,158,0,-2.3385301868760178
ZCTA5 13846,158,0,158,0,-2.3385301868760178
ZCTA5 18456,158,0,158,0,-2.3385301868760178
ZCTA5 26627,158,0,158,0,-2.3385301868760178
ZCTA5 97441,158,0,158,0,-2.3385301868760178
ZCTA5 96054,158,0,158,0,-2.3385301868760178
ZCTA5 98305,158,0,158,0,-2.3385301868760178
ZCTA5 36104,2888,74,2814,0.025623268698060944,-2.3403342734141326
ZCTA5 73433,1069,22,1047,0.0205799812909261,-2.3408551857121447
ZCTA5 19706,689,12,677,0.01741654571843251,-2.341072923217936
ZCTA5 26501,8290,239,8051,0.028829915560916766,-2.3414753336121583
ZCTA5 74867,312,3,309,0.009615384615384616,-2.3416717342624147
ZCTA5 71430,995,20,975,0.020100502512562814,-2.3424904351502924
ZCTA5 20176,17258,522,16736,0.030246842044269324,-2.3432169158273015
ZCTA5 20776,1180,25,1155,0.0211864406779661,-2.343533387400529
ZCTA5 49950,650,11,639,0.016923076923076923,-2.3438158207837967
ZCTA5 72355,958,19,939,0.019832985386221295,-2.3445705794338703
ZCTA5 88029,529,8,521,0.015122873345935728,-2.344693334783519
ZCTA5 06510,1541,35,1506,0.0227125243348475,-2.344976512173149
ZCTA5 49346,2344,58,2286,0.024744027303754267,-2.345152976867096
ZCTA5 39477,265,2,263,0.007547169811320755,-2.345333153374434
ZCTA5 50523,265,2,263,0.007547169811320755,-2.345333153374434
ZCTA5 55798,265,2,263,0.007547169811320755,-2.345333153374434
ZCTA5 73053,265,2,263,0.007547169811320755,-2.345333153374434
ZCTA5 74650,265,2,263,0.007547169811320755,-2.345333153374434
ZCTA5 80720,1107,23,1084,0.02077687443541102,-2.3456666429059583
ZCTA5 40807,159,0,159,0,-2.345918926256656
ZCTA5 50457,159,0,159,0,-2.345918926256656
ZCTA5 50848,159,0,159,0,-2.345918926256656
ZCTA5 64149,159,0,159,0,-2.345918926256656
ZCTA5 66428,159,0,159,0,-2.345918926256656
ZCTA5 66940,159,0,159,0,-2.345918926256656
ZCTA5 68761,159,0,159,0,-2.345918926256656
ZCTA5 56669,159,0,159,0,-2.345918926256656
ZCTA5 56657,159,0,159,0,-2.345918926256656
ZCTA5 76827,159,0,159,0,-2.345918926256656
ZCTA5 83454,159,0,159,0,-2.345918926256656
ZCTA5 05837,159,0,159,0,-2.345918926256656
ZCTA5 03910,159,0,159,0,-2.345918926256656
ZCTA5 22476,159,0,159,0,-2.345918926256656
ZCTA5 97493,159,0,159,0,-2.345918926256656
ZCTA5 62018,1290,28,1262,0.021705426356589147,-2.346671847884023
ZCTA5 10924,4294,116,4178,0.02701443875174662,-2.346752352565387
ZCTA5 31216,5836,163,5673,0.027930089102124744,-2.346859321566222
ZCTA5 68660,488,7,481,0.014344262295081968,-2.347650544285492
ZCTA5 97376,488,7,481,0.014344262295081968,-2.347650544285492
ZCTA5 13078,3830,102,3728,0.026631853785900782,-2.3480072342959515
ZCTA5 38370,313,3,310,0.009584664536741214,-2.348443850837561
ZCTA5 50229,313,3,310,0.009584664536741214,-2.348443850837561
ZCTA5 41425,446,6,440,0.013452914798206279,-2.3490353412824923
ZCTA5 14880,651,11,640,0.016897081413210446,-2.349306581758379
ZCTA5 27891,2069,50,2019,0.02416626389560174,-2.3494430337719354
ZCTA5 50257,403,5,398,0.01240694789081886,-2.349698241524233
ZCTA5 97437,1071,22,1049,0.02054154995331466,-2.3500382100320696
ZCTA5 38847,1291,28,1263,0.021688613477924088,-2.3509406856924144
ZCTA5 97118,359,4,355,0.011142061281337047,-2.3509994825158054
ZCTA5 43407,266,2,264,0.007518796992481203,-2.3523275384370232
ZCTA5 48465,266,2,264,0.007518796992481203,-2.3523275384370232
ZCTA5 63636,266,2,264,0.007518796992481203,-2.3523275384370232
ZCTA5 33854,160,0,160,0,-2.3532844669117208
ZCTA5 53505,160,0,160,0,-2.3532844669117208
ZCTA5 55742,160,0,160,0,-2.3532844669117208
ZCTA5 57446,160,0,160,0,-2.3532844669117208
ZCTA5 65077,160,0,160,0,-2.3532844669117208
ZCTA5 65762,160,0,160,0,-2.3532844669117208
ZCTA5 67850,160,0,160,0,-2.3532844669117208
ZCTA5 73442,160,0,160,0,-2.3532844669117208
ZCTA5 08327,160,0,160,0,-2.3532844669117208
ZCTA5 12513,160,0,160,0,-2.3532844669117208
ZCTA5 17768,160,0,160,0,-2.3532844669117208
ZCTA5 18932,160,0,160,0,-2.3532844669117208
ZCTA5 24377,160,0,160,0,-2.3532844669117208
ZCTA5 93244,160,0,160,0,-2.3532844669117208
ZCTA5 97110,489,7,482,0.014314928425357873,-2.353662031760899
ZCTA5 56549,1861,44,1817,0.023643202579258463,-2.3537031034690807
ZCTA5 43772,808,15,793,0.018564356435643563,-2.3537503743943735
ZCTA5 92091,652,11,641,0.01687116564417178,-2.354790299644992
ZCTA5 47036,314,3,311,0.009554140127388535,-2.355200349002546
ZCTA5 54103,216,1,215,0.004629629629629629,-2.3558824085689545
ZCTA5 83214,216,1,215,0.004629629629629629,-2.3558824085689545
ZCTA5 78235,531,8,523,0.015065913370998116,-2.3564207488175453
ZCTA5 97394,2313,57,2256,0.02464332036316472,-2.3565283275322537
ZCTA5 10996,885,17,868,0.0192090395480226,-2.35669636822236
ZCTA5 38547,770,14,756,0.01818181818181818,-2.356767205872208
ZCTA5 67578,572,9,563,0.015734265734265736,-2.3568094871065255
ZCTA5 27935,692,12,680,0.017341040462427744,-2.3572097662482157
ZCTA5 52332,809,15,794,0.018541409147095178,-2.358836136441694
ZCTA5 76251,267,2,265,0.00749063670411985,-2.3593039739239225
ZCTA5 54888,613,10,603,0.01631321370309951,-2.3601002053057156
ZCTA5 28524,161,0,161,0,-2.360627025992624
ZCTA5 35060,161,0,161,0,-2.360627025992624
ZCTA5 49910,161,0,161,0,-2.360627025992624
ZCTA5 51654,161,0,161,0,-2.360627025992624
ZCTA5 57481,161,0,161,0,-2.360627025992624
ZCTA5 57787,161,0,161,0,-2.360627025992624
ZCTA5 61278,161,0,161,0,-2.360627025992624
ZCTA5 72682,161,0,161,0,-2.360627025992624
ZCTA5 78419,161,0,161,0,-2.360627025992624
ZCTA5 83632,161,0,161,0,-2.360627025992624
ZCTA5 03832,161,0,161,0,-2.360627025992624
ZCTA5 12063,161,0,161,0,-2.360627025992624
ZCTA5 18245,161,0,161,0,-2.360627025992624
ZCTA5 95225,161,0,161,0,-2.360627025992624
ZCTA5 95925,161,0,161,0,-2.360627025992624
ZCTA5 98527,161,0,161,0,-2.360627025992624
ZCTA5 38483,2107,51,2056,0.02420503084954912,-2.3610242860164923
ZCTA5 75975,1402,31,1371,0.02211126961483595,-2.3619152505485976
ZCTA5 12083,1402,31,1371,0.02211126961483595,-2.3619152505485976
ZCTA5 35133,1366,30,1336,0.021961932650073207,-2.3620880505115602
ZCTA5 50258,405,5,400,0.012345679012345678,-2.362378486048696
ZCTA5 17772,962,19,943,0.01975051975051975,-2.3636842640290823
ZCTA5 54027,361,4,357,0.0110803324099723,-2.3640614968841587
ZCTA5 14873,1000,20,980,0.02,-2.366042926258107
ZCTA5 35476,2829,72,2757,0.02545068928950159,-2.367351954928147
ZCTA5 31065,449,6,443,0.013363028953229399,-2.3675144350132133
ZCTA5 59486,449,6,443,0.013363028953229399,-2.3675144350132133
ZCTA5 14740,449,6,443,0.013363028953229399,-2.3675144350132133
ZCTA5 29838,162,0,162,0,-2.3679468172840332
ZCTA5 38471,162,0,162,0,-2.3679468172840332
ZCTA5 40824,162,0,162,0,-2.3679468172840332
ZCTA5 42371,162,0,162,0,-2.3679468172840332
ZCTA5 45646,162,0,162,0,-2.3679468172840332
ZCTA5 57648,162,0,162,0,-2.3679468172840332
ZCTA5 61830,162,0,162,0,-2.3679468172840332
ZCTA5 60917,162,0,162,0,-2.3679468172840332
ZCTA5 65788,162,0,162,0,-2.3679468172840332
ZCTA5 67132,162,0,162,0,-2.3679468172840332
ZCTA5 79566,162,0,162,0,-2.3679468172840332
ZCTA5 87551,162,0,162,0,-2.3679468172840332
ZCTA5 12808,162,0,162,0,-2.3679468172840332
ZCTA5 17957,162,0,162,0,-2.3679468172840332
ZCTA5 17925,162,0,162,0,-2.3679468172840332
ZCTA5 16212,162,0,162,0,-2.3679468172840332
ZCTA5 25672,162,0,162,0,-2.3679468172840332
ZCTA5 24834,162,0,162,0,-2.3679468172840332
ZCTA5 26587,162,0,162,0,-2.3679468172840332
ZCTA5 97430,162,0,162,0,-2.3679468172840332
ZCTA5 96765,162,0,162,0,-2.3679468172840332
ZCTA5 49969,574,9,565,0.0156794425087108,-2.368230573398695
ZCTA5 50655,316,3,313,0.00949367088607595,-2.3686668788788867
ZCTA5 86334,1760,41,1719,0.023295454545454546,-2.370072708753099
ZCTA5 97841,218,1,217,0.0045871559633027525,-2.3702516157543094
ZCTA5 96027,1001,20,981,0.01998001998001998,-2.370741063088396
ZCTA5 74035,1332,29,1303,0.02177177177177177,-2.3711018857760213
ZCTA5 17929,655,11,644,0.016793893129770993,-2.3711994211177756
ZCTA5 64650,269,2,267,0.007434944237918215,-2.373203505403764
ZCTA5 73741,269,2,267,0.007434944237918215,-2.373203505403764
ZCTA5 78058,450,6,444,0.013333333333333334,-2.37365257376137
ZCTA5 53804,534,8,526,0.0149812734082397,-2.37394493193273
ZCTA5 71350,1726,40,1686,0.023174971031286212,-2.3749045966968056
ZCTA5 66537,407,5,402,0.012285012285012284,-2.375010633164691
ZCTA5 44809,163,0,163,0,-2.375244051276496
ZCTA5 52644,163,0,163,0,-2.375244051276496
ZCTA5 62282,163,0,163,0,-2.375244051276496
ZCTA5 64426,163,0,163,0,-2.375244051276496
ZCTA5 64459,163,0,163,0,-2.375244051276496
ZCTA5 68878,163,0,163,0,-2.375244051276496
ZCTA5 72429,163,0,163,0,-2.375244051276496
ZCTA5 85932,163,0,163,0,-2.375244051276496
ZCTA5 82943,163,0,163,0,-2.375244051276496
ZCTA5 04779,163,0,163,0,-2.375244051276496
ZCTA5 04003,163,0,163,0,-2.375244051276496
ZCTA5 12786,163,0,163,0,-2.375244051276496
ZCTA5 23488,163,0,163,0,-2.375244051276496
ZCTA5 26178,163,0,163,0,-2.375244051276496
ZCTA5 94528,163,0,163,0,-2.375244051276496
ZCTA5 99775,163,0,163,0,-2.375244051276496
ZCTA5 70125,6142,172,5970,0.02800390752197981,-2.375427577706952
ZCTA5 30417,4040,108,3932,0.026732673267326732,-2.375882445877129
ZCTA5 36032,889,17,872,0.019122609673790775,-2.376347277973825
ZCTA5 67867,656,11,645,0.01676829268292683,-2.376655192437969
ZCTA5 14013,735,13,722,0.017687074829931974,-2.3771724671474717
ZCTA5 74346,2662,67,2595,0.025169045830202855,-2.377225356228563
ZCTA5 51441,219,1,218,0.0045662100456621,-2.377405543524849
ZCTA5 26275,219,1,218,0.0045662100456621,-2.377405543524849
ZCTA5 38316,1151,24,1127,0.020851433536055605,-2.3777620889583906
ZCTA5 36010,1656,38,1618,0.022946859903381644,-2.3778701923470735
ZCTA5 15545,1040,21,1019,0.020192307692307693,-2.3784111380946595
ZCTA5 95382,13344,397,12947,0.029751199040767385,-2.3788429794278065
ZCTA5 61368,576,9,567,0.015625,-2.379619109460143
ZCTA5 04574,576,9,567,0.015625,-2.379619109460143
ZCTA5 29033,5557,154,5403,0.02771279467338492,-2.380155255332338
ZCTA5 03303,6145,172,5973,0.027990235964198536,-2.381967576922971
ZCTA5 37376,164,0,164,0,-2.38251893523707
ZCTA5 41650,164,0,164,0,-2.38251893523707
ZCTA5 40077,164,0,164,0,-2.38251893523707
ZCTA5 50232,164,0,164,0,-2.38251893523707
ZCTA5 61344,164,0,164,0,-2.38251893523707
ZCTA5 68860,164,0,164,0,-2.38251893523707
ZCTA5 70712,164,0,164,0,-2.38251893523707
ZCTA5 04571,164,0,164,0,-2.38251893523707
ZCTA5 07935,164,0,164,0,-2.38251893523707
ZCTA5 15482,164,0,164,0,-2.38251893523707
ZCTA5 15612,164,0,164,0,-2.38251893523707
ZCTA5 18625,164,0,164,0,-2.38251893523707
ZCTA5 25162,164,0,164,0,-2.38251893523707
ZCTA5 25632,164,0,164,0,-2.38251893523707
ZCTA5 70591,1974,47,1927,0.023809523809523808,-2.383014006454724
ZCTA5 14864,494,7,487,0.01417004048582996,-2.383572951129995
ZCTA5 70006,5951,166,5785,0.027894471517392036,-2.3851492504155054
ZCTA5 79502,536,8,528,0.014925373134328358,-2.38558349909941
ZCTA5 68835,271,2,269,0.007380073800738007,-2.387032752013462
ZCTA5 39815,658,11,647,0.016717325227963525,-2.387545964973166
ZCTA5 13682,319,3,316,0.009404388714733543,-2.3887519407040476
ZCTA5 17941,319,3,316,0.009404388714733543,-2.3887519407040476
ZCTA5 49815,165,0,165,0,-2.3897716732780103
ZCTA5 50633,165,0,165,0,-2.3897716732780103
ZCTA5 58441,165,0,165,0,-2.3897716732780103
ZCTA5 62923,165,0,165,0,-2.3897716732780103
ZCTA5 57468,165,0,165,0,-2.3897716732780103
ZCTA5 62313,165,0,165,0,-2.3897716732780103
ZCTA5 67109,165,0,165,0,-2.3897716732780103
ZCTA5 67625,165,0,165,0,-2.3897716732780103
ZCTA5 72585,165,0,165,0,-2.3897716732780103
ZCTA5 73548,165,0,165,0,-2.3897716732780103
ZCTA5 16847,165,0,165,0,-2.3897716732780103
ZCTA5 13842,165,0,165,0,-2.3897716732780103
ZCTA5 15455,165,0,165,0,-2.3897716732780103
ZCTA5 89828,165,0,165,0,-2.3897716732780103
ZCTA5 27821,165,0,165,0,-2.3897716732780103
ZCTA5 98381,165,0,165,0,-2.3897716732780103
ZCTA5 44802,365,4,361,0.010958904109589041,-2.39002389134029
ZCTA5 19029,1445,32,1413,0.022145328719723183,-2.390662267163401
ZCTA5 84326,578,9,569,0.015570934256055362,-2.390975330381712
ZCTA5 37098,2185,53,2132,0.02425629290617849,-2.3910035266238463
ZCTA5 95713,3946,105,3841,0.026609224531170806,-2.391204476037499
ZCTA5 50447,537,8,529,0.0148975791433892,-2.3913896187861976
ZCTA5 62265,1695,39,1656,0.023008849557522124,-2.39151476027253
ZCTA5 34748,17577,531,17046,0.030209933435739886,-2.391986150169854
ZCTA5 64725,968,19,949,0.01962809917355372,-2.392225391583759
ZCTA5 49782,272,2,270,0.007352941176470588,-2.393921326176098
ZCTA5 79039,366,4,362,0.01092896174863388,-2.3964812461831704
ZCTA5 48878,579,9,570,0.015544041450777202,-2.3966413954195342
ZCTA5 41821,166,0,166,0,-2.3970024664235914
ZCTA5 45854,166,0,166,0,-2.3970024664235914
ZCTA5 49839,166,0,166,0,-2.3970024664235914
ZCTA5 55026,166,0,166,0,-2.3970024664235914
ZCTA5 57261,166,0,166,0,-2.3970024664235914
ZCTA5 61050,166,0,166,0,-2.3970024664235914
ZCTA5 61378,166,0,166,0,-2.3970024664235914
ZCTA5 61812,166,0,166,0,-2.3970024664235914
ZCTA5 67653,166,0,166,0,-2.3970024664235914
ZCTA5 73557,166,0,166,0,-2.3970024664235914
ZCTA5 78107,166,0,166,0,-2.3970024664235914
ZCTA5 84643,166,0,166,0,-2.3970024664235914
ZCTA5 85912,166,0,166,0,-2.3970024664235914
ZCTA5 12177,166,0,166,0,-2.3970024664235914
ZCTA5 13802,166,0,166,0,-2.3970024664235914
ZCTA5 15734,166,0,166,0,-2.3970024664235914
ZCTA5 16054,166,0,166,0,-2.3970024664235914
ZCTA5 89430,166,0,166,0,-2.3970024664235914
ZCTA5 96006,166,0,166,0,-2.3970024664235914
ZCTA5 98267,166,0,166,0,-2.3970024664235914
ZCTA5 64834,3447,90,3357,0.02610966057441253,-2.3980115673066527
ZCTA5 04740,454,6,448,0.013215859030837005,-2.3980986314506043
ZCTA5 50629,817,15,802,0.01835985312117503,-2.3993296542288975
ZCTA5 28438,700,12,688,0.017142857142857144,-2.399955548014955
ZCTA5 41080,700,12,688,0.017142857142857144,-2.399955548014955
ZCTA5 71763,700,12,688,0.017142857142857144,-2.399955548014955
ZCTA5 84404,20155,613,19542,0.030414289258248572,-2.4000618350783993
ZCTA5 32227,411,5,406,0.012165450121654502,-2.4001325373036164
ZCTA5 06052,3111,80,3031,0.02571520411443266,-2.4004935207222267
ZCTA5 75672,5893,164,5729,0.02782962837264551,-2.401179518061861
ZCTA5 48765,321,3,318,0.009345794392523364,-2.4020665864285595
ZCTA5 57745,1008,20,988,0.01984126984126984,-2.4035137123267156
ZCTA5 73664,455,6,449,0.013186813186813187,-2.4041837611986017
ZCTA5 39866,167,0,167,0,-2.4042115126751185
ZCTA5 50654,167,0,167,0,-2.4042115126751185
ZCTA5 49626,167,0,167,0,-2.4042115126751185
ZCTA5 51343,167,0,167,0,-2.4042115126751185
ZCTA5 60973,167,0,167,0,-2.4042115126751185
ZCTA5 61476,167,0,167,0,-2.4042115126751185
ZCTA5 62555,167,0,167,0,-2.4042115126751185
ZCTA5 62833,167,0,167,0,-2.4042115126751185
ZCTA5 04918,167,0,167,0,-2.4042115126751185
ZCTA5 04478,167,0,167,0,-2.4042115126751185
ZCTA5 12085,167,0,167,0,-2.4042115126751185
ZCTA5 22641,167,0,167,0,-2.4042115126751185
ZCTA5 25285,167,0,167,0,-2.4042115126751185
ZCTA5 26422,167,0,167,0,-2.4042115126751185
ZCTA5 25650,167,0,167,0,-2.4042115126751185
ZCTA5 26161,167,0,167,0,-2.4042115126751185
ZCTA5 26377,167,0,167,0,-2.4042115126751185
ZCTA5 97424,7259,206,7053,0.028378564540570327,-2.4048953963201773
ZCTA5 62092,1194,25,1169,0.020938023450586266,-2.405130820727647
ZCTA5 02464,1194,25,1169,0.020938023450586266,-2.405130820727647
ZCTA5 27055,5699,158,5541,0.027724162133707667,-2.4056016234750097
ZCTA5 64134,8999,260,8739,0.02889209912212468,-2.4067437653915835
ZCTA5 32181,857,16,841,0.01866977829638273,-2.4069072196103614
ZCTA5 38337,498,7,491,0.014056224899598393,-2.4073282987369673
ZCTA5 62268,274,2,272,0.0072992700729927005,-2.4076469796603295
ZCTA5 96051,581,9,572,0.01549053356282272,-2.4079495787542777
ZCTA5 74563,780,14,766,0.017948717948717947,-2.4082252383803007
ZCTA5 15551,322,3,319,0.009316770186335404,-2.4087015663435234
ZCTA5 39361,540,8,532,0.014814814814814815,-2.4087557271025024
ZCTA5 67637,1121,23,1098,0.020517395182872437,-2.4087661315430173
ZCTA5 57363,368,4,364,0.010869565217391304,-2.4093565695139745
ZCTA5 38551,1700,39,1661,0.022941176470588236,-2.4105563219476256
ZCTA5 48617,3317,86,3231,0.025927042508290626,-2.410847465449288
ZCTA5 38459,168,0,168,0,-2.411399007074188
ZCTA5 41360,168,0,168,0,-2.411399007074188
ZCTA5 50561,168,0,168,0,-2.411399007074188
ZCTA5 52727,168,0,168,0,-2.411399007074188
ZCTA5 57076,168,0,168,0,-2.411399007074188
ZCTA5 57476,168,0,168,0,-2.411399007074188
ZCTA5 61850,168,0,168,0,-2.411399007074188
ZCTA5 68635,168,0,168,0,-2.411399007074188
ZCTA5 73736,168,0,168,0,-2.411399007074188
ZCTA5 03607,168,0,168,0,-2.411399007074188
ZCTA5 03597,168,0,168,0,-2.411399007074188
ZCTA5 12190,168,0,168,0,-2.411399007074188
ZCTA5 16848,168,0,168,0,-2.411399007074188
ZCTA5 18083,168,0,168,0,-2.411399007074188
ZCTA5 13856,2605,65,2540,0.02495201535508637,-2.4132374950829063
ZCTA5 46391,2157,52,2105,0.02410755679184052,-2.41404953603136
ZCTA5 48884,1701,39,1662,0.02292768959435626,-2.414358537879177
ZCTA5 58736,275,2,273,0.007272727272727273,-2.414484296368702
ZCTA5 57073,275,2,273,0.007272727272727273,-2.414484296368702
ZCTA5 30230,3453,90,3363,0.026064291920069503,-2.414923474764969
ZCTA5 38762,935,18,917,0.019251336898395723,-2.4151625331590423
ZCTA5 16029,323,3,320,0.009287925696594427,-2.4153217714426964
ZCTA5 19809,6031,168,5863,0.027856076935831538,-2.417709302410939
ZCTA5 30178,1123,23,1100,0.020480854853072127,-2.4177236004241105
ZCTA5 07075,3252,84,3168,0.025830258302583026,-2.4178023395206485
ZCTA5 28735,169,0,169,0,-2.418565141764261
ZCTA5 45782,169,0,169,0,-2.418565141764261
ZCTA5 49921,169,0,169,0,-2.418565141764261
ZCTA5 50612,169,0,169,0,-2.418565141764261
ZCTA5 51010,169,0,169,0,-2.418565141764261
ZCTA5 59247,169,0,169,0,-2.418565141764261
ZCTA5 58650,169,0,169,0,-2.418565141764261
ZCTA5 62481,169,0,169,0,-2.418565141764261
ZCTA5 67427,169,0,169,0,-2.418565141764261
ZCTA5 69121,169,0,169,0,-2.418565141764261
ZCTA5 56033,169,0,169,0,-2.418565141764261
ZCTA5 73747,169,0,169,0,-2.418565141764261
ZCTA5 06456,169,0,169,0,-2.418565141764261
ZCTA5 13153,169,0,169,0,-2.418565141764261
ZCTA5 15444,169,0,169,0,-2.418565141764261
ZCTA5 23887,169,0,169,0,-2.418565141764261
ZCTA5 24881,169,0,169,0,-2.418565141764261
ZCTA5 25841,169,0,169,0,-2.418565141764261
ZCTA5 86015,169,0,169,0,-2.418565141764261
ZCTA5 12776,936,18,918,0.019230769230769232,-2.4199530585879643
ZCTA5 54489,664,11,653,0.016566265060240965,-2.4200537022071837
ZCTA5 51358,542,8,534,0.014760147601476014,-2.42028992375126
ZCTA5 14819,276,2,274,0.007246376811594203,-2.4213047624750375
ZCTA5 96093,1703,39,1664,0.022900763358778626,-2.421956894092938
ZCTA5 59714,7720,220,7500,0.02849740932642487,-2.4220142853459072
ZCTA5 67035,370,4,366,0.010810810810810811,-2.4221798506029604
ZCTA5 28713,3422,89,3333,0.026008182349503216,-2.422312050436769
ZCTA5 81624,458,6,452,0.013100436681222707,-2.4223765821616254
ZCTA5 38351,6782,191,6591,0.028162783839575347,-2.423360416991845
ZCTA5 21084,2574,64,2510,0.024864024864024864,-2.4236613203281565
ZCTA5 37178,822,15,807,0.01824817518248175,-2.4244663486055735
ZCTA5 56361,937,18,919,0.0192102454642476,-2.424739158847117
ZCTA5 55954,584,9,575,0.015410958904109588,-2.424852414476002
ZCTA5 54962,501,7,494,0.013972055888223553,-2.4250453348754384
ZCTA5 98557,1345,29,1316,0.021561338289962824,-2.4255624492128653
ZCTA5 31631,170,0,170,0,-2.4257101060505932
ZCTA5 34739,170,0,170,0,-2.4257101060505932
ZCTA5 36754,170,0,170,0,-2.4257101060505932
ZCTA5 43939,170,0,170,0,-2.4257101060505932
ZCTA5 50460,170,0,170,0,-2.4257101060505932
ZCTA5 58079,170,0,170,0,-2.4257101060505932
ZCTA5 58231,170,0,170,0,-2.4257101060505932
ZCTA5 65064,170,0,170,0,-2.4257101060505932
ZCTA5 64623,170,0,170,0,-2.4257101060505932
ZCTA5 68820,170,0,170,0,-2.4257101060505932
ZCTA5 68973,170,0,170,0,-2.4257101060505932
ZCTA5 02791,170,0,170,0,-2.4257101060505932
ZCTA5 17862,170,0,170,0,-2.4257101060505932
ZCTA5 16879,170,0,170,0,-2.4257101060505932
ZCTA5 24823,170,0,170,0,-2.4257101060505932
ZCTA5 50464,226,1,225,0.004424778761061947,-2.426925710510124
ZCTA5 66767,226,1,225,0.004424778761061947,-2.426925710510124
ZCTA5 71725,226,1,225,0.004424778761061947,-2.426925710510124
ZCTA5 03586,277,2,275,0.007220216606498195,-2.4281084934456376
ZCTA5 66773,325,3,322,0.009230769230769232,-2.428518213488446
ZCTA5 55708,371,4,367,0.01078167115902965,-2.4285721504032667
ZCTA5 07869,9076,262,8814,0.02886734244160423,-2.430134534469319
ZCTA5 32579,4360,117,4243,0.026834862385321102,-2.430659710532473
ZCTA5 50210,666,11,655,0.016516516516516516,-2.430835332072235
ZCTA5 75925,1491,33,1458,0.022132796780684104,-2.431107261409568
ZCTA5 74469,862,16,846,0.018561484918793503,-2.431599807186464
ZCTA5 29202,171,0,171,0,-2.4328340864585853
ZCTA5 46537,171,0,171,0,-2.4328340864585853
ZCTA5 51636,171,0,171,0,-2.4328340864585853
ZCTA5 51565,171,0,171,0,-2.4328340864585853
ZCTA5 52760,171,0,171,0,-2.4328340864585853
ZCTA5 58068,171,0,171,0,-2.4328340864585853
ZCTA5 72410,171,0,171,0,-2.4328340864585853
ZCTA5 72425,171,0,171,0,-2.4328340864585853
ZCTA5 77359,171,0,171,0,-2.4328340864585853
ZCTA5 85536,171,0,171,0,-2.4328340864585853
ZCTA5 15536,171,0,171,0,-2.4328340864585853
ZCTA5 15660,171,0,171,0,-2.4328340864585853
ZCTA5 23176,171,0,171,0,-2.4328340864585853
ZCTA5 62480,227,1,226,0.004405286343612335,-2.4339222978439468
ZCTA5 03779,326,3,323,0.009202453987730062,-2.4350946264739846
ZCTA5 37853,1528,34,1494,0.02225130890052356,-2.4353245784873154
ZCTA5 56623,1127,23,1104,0.02040816326530612,-2.4355965221776903
ZCTA5 03894,2852,72,2780,0.025245441795231416,-2.4379117595865956
ZCTA5 76501,6236,174,6062,0.027902501603592048,-2.438068624639025
ZCTA5 18071,3864,102,3762,0.026397515527950312,-2.4394136100862056
ZCTA5 30641,825,15,810,0.01818181818181818,-2.4394858202398835
ZCTA5 74085,902,17,885,0.018847006651884702,-2.4396900849179617
ZCTA5 05763,1165,24,1141,0.020600858369098713,-2.4397415828068922
ZCTA5 36483,172,0,172,0,-2.439937266790599
ZCTA5 41513,172,0,172,0,-2.439937266790599
ZCTA5 40849,172,0,172,0,-2.439937266790599
ZCTA5 43735,172,0,172,0,-2.439937266790599
ZCTA5 50562,172,0,172,0,-2.439937266790599
ZCTA5 50262,172,0,172,0,-2.439937266790599
ZCTA5 55716,172,0,172,0,-2.439937266790599
ZCTA5 57788,172,0,172,0,-2.439937266790599
ZCTA5 61335,172,0,172,0,-2.439937266790599
ZCTA5 64147,172,0,172,0,-2.439937266790599
ZCTA5 66019,172,0,172,0,-2.439937266790599
ZCTA5 68792,172,0,172,0,-2.439937266790599
ZCTA5 56118,172,0,172,0,-2.439937266790599
ZCTA5 75682,172,0,172,0,-2.439937266790599
ZCTA5 79010,172,0,172,0,-2.439937266790599
ZCTA5 01242,172,0,172,0,-2.439937266790599
ZCTA5 15368,172,0,172,0,-2.439937266790599
ZCTA5 16422,172,0,172,0,-2.439937266790599
ZCTA5 25161,172,0,172,0,-2.439937266790599
ZCTA5 25114,172,0,172,0,-2.439937266790599
ZCTA5 92333,172,0,172,0,-2.439937266790599
ZCTA5 25241,668,11,657,0.016467065868263474,-2.4415901052791402
ZCTA5 39841,327,3,324,0.009174311926605505,-2.4416566167431486
ZCTA5 50050,327,3,324,0.009174311926605505,-2.4416566167431486
ZCTA5 17827,279,2,277,0.007168458781362007,-2.44166620558064
ZCTA5 65441,2235,54,2181,0.024161073825503355,-2.4432395562498477
ZCTA5 64747,1458,32,1426,0.02194787379972565,-2.443320585051058
ZCTA5 44093,418,5,413,0.011961722488038277,-2.443648670256166
ZCTA5 81403,4199,112,4087,0.026673017385091688,-2.443681973748792
ZCTA5 32621,2131,51,2080,0.023932426091037073,-2.4444152707730336
ZCTA5 65632,1017,20,997,0.01966568338249754,-2.445359555500164
ZCTA5 30530,2201,53,2148,0.02407996365288505,-2.445746011007556
ZCTA5 52147,462,6,456,0.012987012987012988,-2.446489409361642
ZCTA5 68405,1277,27,1250,0.021143304620203602,-2.446526799963009
ZCTA5 71245,1674,38,1636,0.022700119474313024,-2.446899607233312
ZCTA5 29543,173,0,173,0,-2.447019828181288
ZCTA5 51548,173,0,173,0,-2.447019828181288
ZCTA5 52207,173,0,173,0,-2.447019828181288
ZCTA5 58332,173,0,173,0,-2.447019828181288
ZCTA5 61722,173,0,173,0,-2.447019828181288
ZCTA5 67516,173,0,173,0,-2.447019828181288
ZCTA5 68648,173,0,173,0,-2.447019828181288
ZCTA5 69345,173,0,173,0,-2.447019828181288
ZCTA5 77374,173,0,173,0,-2.447019828181288
ZCTA5 01346,173,0,173,0,-2.447019828181288
ZCTA5 12849,173,0,173,0,-2.447019828181288
ZCTA5 19554,173,0,173,0,-2.447019828181288
ZCTA5 25868,173,0,173,0,-2.447019828181288
ZCTA5 95652,173,0,173,0,-2.447019828181288
ZCTA5 96016,173,0,173,0,-2.447019828181288
ZCTA5 01330,588,9,579,0.015306122448979591,-2.4472797563377324
ZCTA5 31217,6110,170,5940,0.027823240589198037,-2.44776632401555
ZCTA5 56263,229,1,228,0.004366812227074236,-2.447858705424857
ZCTA5 50075,328,3,325,0.009146341463414634,-2.4482042702550446
ZCTA5 66528,328,3,325,0.009146341463414634,-2.4482042702550446
ZCTA5 03771,328,3,325,0.009146341463414634,-2.4482042702550446
ZCTA5 56216,280,2,278,0.007142857142857143,-2.4484204114686277
ZCTA5 71766,280,2,278,0.007142857142857143,-2.4484204114686277
ZCTA5 98366,12597,372,12225,0.029530840676351512,-2.4488391510745378
ZCTA5 04747,547,8,539,0.014625228519195612,-2.448976097767805
ZCTA5 64673,866,16,850,0.018475750577367205,-2.451265661769109
ZCTA5 49916,1056,21,1035,0.019886363636363636,-2.4519255725268154
ZCTA5 76225,1056,21,1035,0.019886363636363636,-2.4519255725268154
ZCTA5 99133,710,12,698,0.016901408450704224,-2.452815389936376
ZCTA5 45692,3332,86,3246,0.02581032412965186,-2.4537599488994672
ZCTA5 18053,789,14,775,0.017743979721166033,-2.454060626900882
ZCTA5 32147,174,0,174,0,-2.4540819491514907
ZCTA5 35458,174,0,174,0,-2.4540819491514907
ZCTA5 37151,174,0,174,0,-2.4540819491514907
ZCTA5 38944,174,0,174,0,-2.4540819491514907
ZCTA5 45740,174,0,174,0,-2.4540819491514907
ZCTA5 52321,174,0,174,0,-2.4540819491514907
ZCTA5 54934,174,0,174,0,-2.4540819491514907
ZCTA5 61816,174,0,174,0,-2.4540819491514907
ZCTA5 65260,174,0,174,0,-2.4540819491514907
ZCTA5 56733,174,0,174,0,-2.4540819491514907
ZCTA5 72123,174,0,174,0,-2.4540819491514907
ZCTA5 25904,174,0,174,0,-2.4540819491514907
ZCTA5 98068,174,0,174,0,-2.4540819491514907
ZCTA5 20624,506,7,499,0.01383399209486166,-2.4543873458090513
ZCTA5 55965,1094,22,1072,0.02010968921389397,-2.45457367108543
ZCTA5 71295,4998,136,4862,0.027210884353741496,-2.454595865950536
ZCTA5 96020,1019,20,999,0.019627085377821395,-2.454614822188543
ZCTA5 42453,230,1,229,0.004347826086956522,-2.4547988199760065
ZCTA5 78016,3501,91,3410,0.025992573550414167,-2.4552492006075726
ZCTA5 07656,3299,85,3214,0.02576538344953016,-2.4559334353809965
ZCTA5 50676,867,16,851,0.01845444059976932,-2.456169973472518
ZCTA5 50020,590,9,581,0.015254237288135594,-2.45844688047905
ZCTA5 53518,590,9,581,0.015254237288135594,-2.45844688047905
ZCTA5 24165,590,9,581,0.015254237288135594,-2.45844688047905
ZCTA5 71937,829,15,814,0.018094089264173704,-2.459439561322715
ZCTA5 35988,751,13,738,0.017310252996005325,-2.460334557172713
ZCTA5 68733,549,8,541,0.014571948998178506,-2.4603915171762996
ZCTA5 41659,175,0,175,0,-2.461123805660735
ZCTA5 41263,175,0,175,0,-2.461123805660735
ZCTA5 50133,175,0,175,0,-2.461123805660735
ZCTA5 50154,175,0,175,0,-2.461123805660735
ZCTA5 50607,175,0,175,0,-2.461123805660735
ZCTA5 50256,175,0,175,0,-2.461123805660735
ZCTA5 51523,175,0,175,0,-2.461123805660735
ZCTA5 51536,175,0,175,0,-2.461123805660735
ZCTA5 52354,175,0,175,0,-2.461123805660735
ZCTA5 59223,175,0,175,0,-2.461123805660735
ZCTA5 68344,175,0,175,0,-2.461123805660735
ZCTA5 05152,175,0,175,0,-2.461123805660735
ZCTA5 12483,175,0,175,0,-2.461123805660735
ZCTA5 10517,175,0,175,0,-2.461123805660735
ZCTA5 17508,175,0,175,0,-2.461123805660735
ZCTA5 17920,175,0,175,0,-2.461123805660735
ZCTA5 21865,175,0,175,0,-2.461123805660735
ZCTA5 23056,175,0,175,0,-2.461123805660735
ZCTA5 25173,175,0,175,0,-2.461123805660735
ZCTA5 70523,330,3,327,0.00909090909090909,-2.4612569068266152
ZCTA5 68044,231,1,230,0.004329004329004329,-2.461720401487453
ZCTA5 72566,231,1,230,0.004329004329004329,-2.461720401487453
ZCTA5 49895,282,2,280,0.0070921985815602835,-2.461880075652151
ZCTA5 26621,282,2,280,0.0070921985815602835,-2.461880075652151
ZCTA5 10708,8933,257,8676,0.02876973021381395,-2.4622198703173823
ZCTA5 76271,591,9,582,0.015228426395939087,-2.4640189014779708
ZCTA5 17309,791,14,777,0.017699115044247787,-2.4641860733439853
ZCTA5 04001,1059,21,1038,0.019830028328611898,-2.4656010584872154
ZCTA5 05343,377,4,373,0.010610079575596816,-2.4666594904884414
ZCTA5 76017,16972,510,16462,0.03004949328305444,-2.4666961809755974
ZCTA5 54139,1282,27,1255,0.02106084243369735,-2.467731297626023
ZCTA5 28708,176,0,176,0,-2.4681455711583906
ZCTA5 43144,176,0,176,0,-2.4681455711583906
ZCTA5 51345,176,0,176,0,-2.4681455711583906
ZCTA5 63438,176,0,176,0,-2.4681455711583906
ZCTA5 62878,176,0,176,0,-2.4681455711583906
ZCTA5 66429,176,0,176,0,-2.4681455711583906
ZCTA5 66849,176,0,176,0,-2.4681455711583906
ZCTA5 72721,176,0,176,0,-2.4681455711583906
ZCTA5 78008,176,0,176,0,-2.4681455711583906
ZCTA5 79024,176,0,176,0,-2.4681455711583906
ZCTA5 01094,176,0,176,0,-2.4681455711583906
ZCTA5 03852,176,0,176,0,-2.4681455711583906
ZCTA5 11947,176,0,176,0,-2.4681455711583906
ZCTA5 18443,176,0,176,0,-2.4681455711583906
ZCTA5 23316,176,0,176,0,-2.4681455711583906
ZCTA5 95385,176,0,176,0,-2.4681455711583906
ZCTA5 97450,176,0,176,0,-2.4681455711583906
ZCTA5 04260,2138,51,2087,0.023854069223573433,-2.4685753014946523
ZCTA5 68626,283,2,281,0.007067137809187279,-2.468585751510884
ZCTA5 65354,232,1,231,0.004310344827586207,-2.4686235925346045
ZCTA5 75681,908,17,891,0.018722466960352423,-2.4686604915169954
ZCTA5 29001,792,14,778,0.017676767676767676,-2.4692406758822596
ZCTA5 17243,592,9,583,0.015202702702702704,-2.4695832644642133
ZCTA5 50530,466,6,460,0.012875536480686695,-2.470440015248883
ZCTA5 72073,466,6,460,0.012875536480686695,-2.470440015248883
ZCTA5 70802,9645,279,9366,0.028926905132192846,-2.472622284092058
ZCTA5 24243,674,11,663,0.016320474777448073,-2.4736949600148974
ZCTA5 17845,714,12,702,0.01680672268907563,-2.473785116685701
ZCTA5 43358,1061,21,1040,0.019792648444863337,-2.474699288551846
ZCTA5 40012,177,0,177,0,-2.475147416633518
ZCTA5 58011,177,0,177,0,-2.475147416633518
ZCTA5 64632,177,0,177,0,-2.475147416633518
ZCTA5 68431,177,0,177,0,-2.475147416633518
ZCTA5 67142,177,0,177,0,-2.475147416633518
ZCTA5 56111,177,0,177,0,-2.475147416633518
ZCTA5 72478,177,0,177,0,-2.475147416633518
ZCTA5 78349,177,0,177,0,-2.475147416633518
ZCTA5 03601,177,0,177,0,-2.475147416633518
ZCTA5 16680,177,0,177,0,-2.475147416633518
ZCTA5 13313,177,0,177,0,-2.475147416633518
ZCTA5 22448,177,0,177,0,-2.475147416633518
ZCTA5 24867,177,0,177,0,-2.475147416633518
ZCTA5 26629,177,0,177,0,-2.475147416633518
ZCTA5 95983,177,0,177,0,-2.475147416633518
ZCTA5 97874,177,0,177,0,-2.475147416633518
ZCTA5 96009,177,0,177,0,-2.475147416633518
ZCTA5 04411,634,10,624,0.015772870662460567,-2.4758475636129984
ZCTA5 57026,467,6,461,0.01284796573875803,-2.4764026522429297
ZCTA5 12815,467,6,461,0.01284796573875803,-2.4764026522429297
ZCTA5 13042,948,18,930,0.0189873417721519,-2.4770970549060225
ZCTA5 56466,1394,30,1364,0.021520803443328552,-2.4777666492854693
ZCTA5 04930,1789,41,1748,0.022917831190609278,-2.4783424504755174
ZCTA5 47882,3442,89,3353,0.025857059848925043,-2.4786861480489613
ZCTA5 75109,1718,39,1679,0.02270081490104773,-2.47868831343264
ZCTA5 06112,7296,206,7090,0.02823464912280702,-2.4793783317592117
ZCTA5 06853,1467,32,1435,0.021813224267211998,-2.479530354250336
ZCTA5 35490,1358,29,1329,0.021354933726067747,-2.4795555266291878
ZCTA5 38391,424,5,419,0.01179245283018868,-2.4805075176301674
ZCTA5 42733,424,5,419,0.01179245283018868,-2.4805075176301674
ZCTA5 43447,1322,28,1294,0.02118003025718608,-2.481834092059868
ZCTA5 57568,285,2,283,0.007017543859649123,-2.4819493260160397
ZCTA5 29939,178,0,178,0,-2.4821295106634507
ZCTA5 36538,178,0,178,0,-2.4821295106634507
ZCTA5 37680,178,0,178,0,-2.4821295106634507
ZCTA5 40813,178,0,178,0,-2.4821295106634507
ZCTA5 42154,178,0,178,0,-2.4821295106634507
ZCTA5 50577,178,0,178,0,-2.4821295106634507
ZCTA5 57631,178,0,178,0,-2.4821295106634507
ZCTA5 58418,178,0,178,0,-2.4821295106634507
ZCTA5 57065,178,0,178,0,-2.4821295106634507
ZCTA5 62434,178,0,178,0,-2.4821295106634507
ZCTA5 64620,178,0,178,0,-2.4821295106634507
ZCTA5 62996,178,0,178,0,-2.4821295106634507
ZCTA5 67347,178,0,178,0,-2.4821295106634507
ZCTA5 66404,178,0,178,0,-2.4821295106634507
ZCTA5 68879,178,0,178,0,-2.4821295106634507
ZCTA5 87419,178,0,178,0,-2.4821295106634507
ZCTA5 87936,178,0,178,0,-2.4821295106634507
ZCTA5 04216,178,0,178,0,-2.4821295106634507
ZCTA5 18920,178,0,178,0,-2.4821295106634507
ZCTA5 21612,178,0,178,0,-2.4821295106634507
ZCTA5 25142,178,0,178,0,-2.4821295106634507
ZCTA5 25639,178,0,178,0,-2.4821295106634507
ZCTA5 96728,178,0,178,0,-2.4821295106634507
ZCTA5 59028,234,1,233,0.004273504273504274,-2.4823753646958986
ZCTA5 04093,3105,79,3026,0.025442834138486314,-2.482579645557908
ZCTA5 56469,553,8,545,0.014466546112115732,-2.4831225186073174
ZCTA5 99337,10899,318,10581,0.02917698871456097,-2.4832599744517756
ZCTA5 62907,795,14,781,0.01761006289308176,-2.4843721736629845
ZCTA5 92377,5340,146,5194,0.027340823970037453,-2.484382100088528
ZCTA5 23140,2386,58,2328,0.024308466051969825,-2.4843871480002866
ZCTA5 05828,873,16,857,0.018327605956471937,-2.4854946795495194
ZCTA5 29153,6062,168,5894,0.02771362586605081,-2.485593912984123
ZCTA5 30078,11156,326,10830,0.029221943348870565,-2.4859618547501428
ZCTA5 13083,756,13,743,0.017195767195767195,-2.486016711476088
ZCTA5 93562,756,13,743,0.017195767195767195,-2.486016711476088
ZCTA5 65276,595,9,586,0.015126050420168067,-2.4862306730677814
ZCTA5 16051,1213,25,1188,0.020610057708161583,-2.4877132803882174
ZCTA5 28646,179,0,179,0,-2.4890920194611486
ZCTA5 58048,179,0,179,0,-2.4890920194611486
ZCTA5 62345,179,0,179,0,-2.4890920194611486
ZCTA5 61425,179,0,179,0,-2.4890920194611486
ZCTA5 67882,179,0,179,0,-2.4890920194611486
ZCTA5 68453,179,0,179,0,-2.4890920194611486
ZCTA5 73722,179,0,179,0,-2.4890920194611486
ZCTA5 77470,179,0,179,0,-2.4890920194611486
ZCTA5 77614,179,0,179,0,-2.4890920194611486
ZCTA5 76866,179,0,179,0,-2.4890920194611486
ZCTA5 04685,179,0,179,0,-2.4890920194611486
ZCTA5 16849,179,0,179,0,-2.4890920194611486
ZCTA5 24944,179,0,179,0,-2.4890920194611486
ZCTA5 26404,179,0,179,0,-2.4890920194611486
ZCTA5 26585,179,0,179,0,-2.4890920194611486
ZCTA5 26660,179,0,179,0,-2.4890920194611486
ZCTA5 97145,179,0,179,0,-2.4890920194611486
ZCTA5 38063,6651,186,6465,0.02796571944068561,-2.489216416488781
ZCTA5 31079,835,15,820,0.017964071856287425,-2.4892171197219084
ZCTA5 61878,637,10,627,0.015698587127158554,-2.492124519063588
ZCTA5 83855,913,17,896,0.018619934282584884,-2.4926771631817233
ZCTA5 15629,335,3,332,0.008955223880597015,-2.493643469592242
ZCTA5 25253,836,15,821,0.017942583732057416,-2.4941623560701482
ZCTA5 14005,718,12,706,0.016713091922005572,-2.494657049254631
ZCTA5 51003,678,11,667,0.016224188790560472,-2.494966956338935
ZCTA5 45232,2562,63,2499,0.02459016393442623,-2.4950924518926074
ZCTA5 54465,287,2,285,0.006968641114982578,-2.4952498980892575
ZCTA5 38947,180,0,180,0,-2.496035106921371
ZCTA5 43842,180,0,180,0,-2.496035106921371
ZCTA5 51037,180,0,180,0,-2.496035106921371
ZCTA5 60946,180,0,180,0,-2.496035106921371
ZCTA5 87558,180,0,180,0,-2.496035106921371
ZCTA5 08314,180,0,180,0,-2.496035106921371
ZCTA5 04768,180,0,180,0,-2.496035106921371
ZCTA5 17211,180,0,180,0,-2.496035106921371
ZCTA5 26323,180,0,180,0,-2.496035106921371
ZCTA5 97877,180,0,180,0,-2.496035106921371
ZCTA5 13648,914,17,897,0.018599562363238512,-2.4974669521637756
ZCTA5 62571,638,10,628,0.01567398119122257,-2.4975362091169937
ZCTA5 41093,1141,23,1118,0.020157756354075372,-2.497716131125673
ZCTA5 59218,336,3,333,0.008928571428571428,-2.5000794290192863
ZCTA5 05757,336,3,333,0.008928571428571428,-2.5000794290192863
ZCTA5 70645,556,8,548,0.014388489208633094,-2.5000843881501806
ZCTA5 30206,1216,25,1191,0.02055921052631579,-2.5006481474800575
ZCTA5 93526,288,2,286,0.006944444444444444,-2.501876816776481
ZCTA5 04258,915,17,898,0.018579234972677595,-2.50225225052203
ZCTA5 38315,1327,28,1299,0.02110022607385079,-2.502689802430721
ZCTA5 31772,181,0,181,0,-2.502958934665685
ZCTA5 35149,181,0,181,0,-2.502958934665685
ZCTA5 42516,181,0,181,0,-2.502958934665685
ZCTA5 62019,181,0,181,0,-2.502958934665685
ZCTA5 63625,181,0,181,0,-2.502958934665685
ZCTA5 71286,181,0,181,0,-2.502958934665685
ZCTA5 73079,181,0,181,0,-2.502958934665685
ZCTA5 82925,181,0,181,0,-2.502958934665685
ZCTA5 78932,181,0,181,0,-2.502958934665685
ZCTA5 87580,181,0,181,0,-2.502958934665685
ZCTA5 85357,181,0,181,0,-2.502958934665685
ZCTA5 15779,181,0,181,0,-2.502958934665685
ZCTA5 18624,181,0,181,0,-2.502958934665685
ZCTA5 21814,181,0,181,0,-2.502958934665685
ZCTA5 24474,181,0,181,0,-2.502958934665685
ZCTA5 97345,181,0,181,0,-2.502958934665685
ZCTA5 97476,181,0,181,0,-2.502958934665685
ZCTA5 98050,181,0,181,0,-2.502958934665685
ZCTA5 62060,1973,46,1927,0.02331474911302585,-2.5046280478261553
ZCTA5 48045,11423,334,11089,0.02923925413639149,-2.505245678265104
ZCTA5 43932,337,3,334,0.008902077151335312,-2.5065017902641347
ZCTA5 57383,337,3,334,0.008902077151335312,-2.5065017902641347
ZCTA5 29161,4124,109,4015,0.026430649854510185,-2.5083158048493748
ZCTA5 43754,599,9,590,0.015025041736227046,-2.5083216178548695
ZCTA5 48401,599,9,590,0.015025041736227046,-2.5083216178548695
ZCTA5 54556,599,9,590,0.015025041736227046,-2.5083216178548695
ZCTA5 05669,289,2,287,0.006920415224913495,-2.5084882929711125
ZCTA5 39090,4988,135,4853,0.02706495589414595,-2.509453803778529
ZCTA5 47959,993,19,974,0.019133937562940583,-2.5095175965557437
ZCTA5 02660,2978,75,2903,0.025184687709872398,-2.5096200926953767
ZCTA5 12822,2359,57,2302,0.024162780839338704,-2.5096402855370203
ZCTA5 69038,238,1,237,0.004201680672268907,-2.5096643034688957
ZCTA5 53015,1031,20,1011,0.019398642095053348,-2.5098172129347853
ZCTA5 29658,182,0,182,0,-2.509863662086365
ZCTA5 31630,182,0,182,0,-2.509863662086365
ZCTA5 36901,182,0,182,0,-2.509863662086365
ZCTA5 36373,182,0,182,0,-2.509863662086365
ZCTA5 50136,182,0,182,0,-2.509863662086365
ZCTA5 51556,182,0,182,0,-2.509863662086365
ZCTA5 54967,182,0,182,0,-2.509863662086365
ZCTA5 58235,182,0,182,0,-2.509863662086365
ZCTA5 67741,182,0,182,0,-2.509863662086365
ZCTA5 66842,182,0,182,0,-2.509863662086365
ZCTA5 72080,182,0,182,0,-2.509863662086365
ZCTA5 72462,182,0,182,0,-2.509863662086365
ZCTA5 87718,182,0,182,0,-2.509863662086365
ZCTA5 05681,182,0,182,0,-2.509863662086365
ZCTA5 12017,182,0,182,0,-2.509863662086365
ZCTA5 12482,182,0,182,0,-2.509863662086365
ZCTA5 15711,182,0,182,0,-2.509863662086365
ZCTA5 20626,182,0,182,0,-2.509863662086365
ZCTA5 51557,384,4,380,0.010416666666666666,-2.510531451088017
ZCTA5 80840,558,8,550,0.014336917562724014,-2.511351624656786
ZCTA5 18415,558,8,550,0.014336917562724014,-2.511351624656786
ZCTA5 67951,1727,39,1688,0.0225825130283729,-2.5125124751000376
ZCTA5 68822,2081,49,2032,0.023546371936568958,-2.5135053388333373
ZCTA5 56567,1256,26,1230,0.020700636942675158,-2.513571140150409
ZCTA5 37726,801,14,787,0.017478152309612985,-2.5144910560224236
ZCTA5 75790,1512,33,1479,0.021825396825396824,-2.514640499618398
ZCTA5 64651,290,2,288,0.006896551724137931,-2.5150844271553026
ZCTA5 70582,7087,199,6888,0.028079582333850713,-2.516204454028955
ZCTA5 63389,2361,57,2304,0.0241423125794155,-2.5162347701732815
ZCTA5 73537,239,1,238,0.0041841004184100415,-2.516442608054153
ZCTA5 39360,1367,29,1338,0.02121433796634967,-2.5166665580783327
ZCTA5 41745,183,0,183,0,-2.516749446389207
ZCTA5 50148,183,0,183,0,-2.516749446389207
ZCTA5 58783,183,0,183,0,-2.516749446389207
ZCTA5 57448,183,0,183,0,-2.516749446389207
ZCTA5 56078,183,0,183,0,-2.516749446389207
ZCTA5 76463,183,0,183,0,-2.516749446389207
ZCTA5 84714,183,0,183,0,-2.516749446389207
ZCTA5 12470,183,0,183,0,-2.516749446389207
ZCTA5 13693,183,0,183,0,-2.516749446389207
ZCTA5 21405,183,0,183,0,-2.516749446389207
ZCTA5 26676,183,0,183,0,-2.516749446389207
ZCTA5 26656,183,0,183,0,-2.516749446389207
ZCTA5 95230,183,0,183,0,-2.516749446389207
ZCTA5 56319,559,8,551,0.014311270125223614,-2.516973130156976
ZCTA5 61956,1108,22,1086,0.019855595667870037,-2.5172650220695716
ZCTA5 72365,1108,22,1086,0.019855595667870037,-2.5172650220695716
ZCTA5 15427,474,6,468,0.012658227848101266,-2.5178657830217843
ZCTA5 22664,3591,93,3498,0.025898078529657476,-2.5180979372691454
ZCTA5 99204,3591,93,3498,0.025898078529657476,-2.5180979372691454
ZCTA5 27947,517,7,510,0.013539651837524178,-2.5181404672084398
ZCTA5 57029,841,15,826,0.0178359096313912,-2.518813488194502
ZCTA5 13431,642,10,632,0.01557632398753894,-2.5191137661383833
ZCTA5 65256,601,9,592,0.014975041597337771,-2.5193223028679226
ZCTA5 84790,15244,454,14790,0.02978220939385988,-2.5212738281481193
ZCTA5 64105,3322,85,3237,0.025586995785671283,-2.521657560218415
ZCTA5 04406,291,2,289,0.006872852233676976,-2.521665318770611
ZCTA5 32102,1109,22,1087,0.019837691614066726,-2.521716454471123
ZCTA5 71764,763,13,750,0.01703800786369594,-2.52173327048525
ZCTA5 74061,763,13,750,0.01703800786369594,-2.52173327048525
ZCTA5 22724,763,13,750,0.01703800786369594,-2.52173327048525
ZCTA5 56584,560,8,552,0.014285714285714285,-2.522586600179785
ZCTA5 06027,560,8,552,0.014285714285714285,-2.522586600179785
ZCTA5 45869,1872,43,1829,0.022970085470085472,-2.522608590874791
ZCTA5 74132,3559,92,3467,0.025849957853329587,-2.5228178652102353
ZCTA5 74875,431,5,426,0.01160092807424594,-2.5230115168315628
ZCTA5 62905,240,1,239,0.004166666666666667,-2.523203601357946
ZCTA5 95432,240,1,239,0.004166666666666667,-2.523203601357946
ZCTA5 74066,12231,359,11872,0.029351647453192707,-2.5232106379819945
ZCTA5 96734,15688,468,15220,0.029831718510963796,-2.523242721303137
ZCTA5 55428,12040,353,11687,0.029318936877076412,-2.52339200206674
ZCTA5 52043,996,19,977,0.019076305220883535,-2.5234203913825834
ZCTA5 41535,184,0,184,0,-2.5236164426352867
ZCTA5 50222,184,0,184,0,-2.5236164426352867
ZCTA5 55752,184,0,184,0,-2.5236164426352867
ZCTA5 58531,184,0,184,0,-2.5236164426352867
ZCTA5 68882,184,0,184,0,-2.5236164426352867
ZCTA5 67232,184,0,184,0,-2.5236164426352867
ZCTA5 75492,184,0,184,0,-2.5236164426352867
ZCTA5 83545,184,0,184,0,-2.5236164426352867
ZCTA5 83428,184,0,184,0,-2.5236164426352867
ZCTA5 05649,184,0,184,0,-2.5236164426352867
ZCTA5 17934,184,0,184,0,-2.5236164426352867
ZCTA5 25148,184,0,184,0,-2.5236164426352867
ZCTA5 97109,184,0,184,0,-2.5236164426352867
ZCTA5 68157,2502,61,2441,0.024380495603517186,-2.5240257936544706
ZCTA5 58230,340,3,337,0.008823529411764706,-2.5256880647972753
ZCTA5 64631,340,3,337,0.008823529411764706,-2.5256880647972753
ZCTA5 66751,340,3,337,0.008823529411764706,-2.5256880647972753
ZCTA5 82639,340,3,337,0.008823529411764706,-2.5256880647972753
ZCTA5 32738,14994,446,14548,0.029745231425903695,-2.5256945830356448
ZCTA5 73128,1551,34,1517,0.02192134107027724,-2.525851909878376
ZCTA5 56277,1296,27,1269,0.020833333333333332,-2.52671654959943
ZCTA5 56653,561,8,553,0.0142602495543672,-2.5281920642825377
ZCTA5 56386,292,2,290,0.00684931506849315,-2.5282310662326113
ZCTA5 99835,3561,92,3469,0.02583543948329121,-2.5283446236888603
ZCTA5 32807,11820,346,11474,0.029272419627749575,-2.528356039968151
ZCTA5 40763,185,0,185,0,-2.5304648037817046
ZCTA5 52050,185,0,185,0,-2.5304648037817046
ZCTA5 59926,185,0,185,0,-2.5304648037817046
ZCTA5 64451,185,0,185,0,-2.5304648037817046
ZCTA5 56536,185,0,185,0,-2.5304648037817046
ZCTA5 72536,185,0,185,0,-2.5304648037817046
ZCTA5 03579,185,0,185,0,-2.5304648037817046
ZCTA5 20765,185,0,185,0,-2.5304648037817046
ZCTA5 23119,185,0,185,0,-2.5304648037817046
ZCTA5 24716,185,0,185,0,-2.5304648037817046
ZCTA5 46228,5689,156,5533,0.027421339426964318,-2.5305094017715537
ZCTA5 32826,7646,216,7430,0.028250065393669893,-2.5306549487106507
ZCTA5 51019,341,3,338,0.008797653958944282,-2.5320568096863756
ZCTA5 64163,341,3,338,0.008797653958944282,-2.5320568096863756
ZCTA5 80461,3258,83,3175,0.025475751995089013,-2.532560288807648
ZCTA5 38255,998,19,979,0.01903807615230461,-2.5326688524293828
ZCTA5 58212,293,2,291,0.006825938566552901,-2.5347817669452373
ZCTA5 04628,293,2,291,0.006825938566552901,-2.5347817669452373
ZCTA5 73565,388,4,384,0.010309278350515464,-2.535336746747602
ZCTA5 10603,6934,194,6740,0.027978079030862416,-2.5358993541963173
ZCTA5 49769,686,11,675,0.016034985422740525,-2.5372017634707307
ZCTA5 36550,186,0,186,0,-2.5372946807213346
ZCTA5 36773,186,0,186,0,-2.5372946807213346
ZCTA5 41859,186,0,186,0,-2.5372946807213346
ZCTA5 62673,186,0,186,0,-2.5372946807213346
ZCTA5 58472,186,0,186,0,-2.5372946807213346
ZCTA5 62819,186,0,186,0,-2.5372946807213346
ZCTA5 72072,186,0,186,0,-2.5372946807213346
ZCTA5 81253,186,0,186,0,-2.5372946807213346
ZCTA5 05341,186,0,186,0,-2.5372946807213346
ZCTA5 25049,186,0,186,0,-2.5372946807213346
ZCTA5 56672,961,18,943,0.018730489073881373,-2.5383036779805344
ZCTA5 36783,342,3,339,0.008771929824561403,-2.538412341090999
ZCTA5 16613,563,8,555,0.014209591474245116,-2.5393790921213273
ZCTA5 68003,1770,40,1730,0.022598870056497175,-2.539772304881096
ZCTA5 08554,1446,31,1415,0.021438450899031812,-2.5409722891214077
ZCTA5 30120,14593,433,14160,0.029671760433084355,-2.5410493689000795
ZCTA5 14822,434,5,429,0.01152073732718894,-2.5410674267235254
ZCTA5 14728,478,6,472,0.012552301255230125,-2.541346368739882
ZCTA5 02115,9234,265,8969,0.02869828893220706,-2.541536282532187
ZCTA5 75058,846,15,831,0.01773049645390071,-2.5433406872184454
ZCTA5 43126,187,0,187,0,-2.544106222321619
ZCTA5 43948,187,0,187,0,-2.544106222321619
ZCTA5 59344,187,0,187,0,-2.544106222321619
ZCTA5 68377,187,0,187,0,-2.544106222321619
ZCTA5 71959,187,0,187,0,-2.544106222321619
ZCTA5 88039,187,0,187,0,-2.544106222321619
ZCTA5 08224,187,0,187,0,-2.544106222321619
ZCTA5 05841,187,0,187,0,-2.544106222321619
ZCTA5 15006,187,0,187,0,-2.544106222321619
ZCTA5 16344,187,0,187,0,-2.544106222321619
ZCTA5 20612,187,0,187,0,-2.544106222321619
ZCTA5 24562,187,0,187,0,-2.544106222321619
ZCTA5 26032,187,0,187,0,-2.544106222321619
ZCTA5 27840,187,0,187,0,-2.544106222321619
ZCTA5 96124,187,0,187,0,-2.544106222321619
ZCTA5 97814,5201,141,5060,0.027110171120938283,-2.5443397557607508
ZCTA5 11414,10680,310,10370,0.02902621722846442,-2.544834456622614
ZCTA5 31012,564,8,556,0.014184397163120567,-2.544960714139947
ZCTA5 57445,728,12,716,0.016483516483516484,-2.5464164684457824
ZCTA5 67104,1001,19,982,0.01898101898101898,-2.5465116118254274
ZCTA5 54527,435,5,430,0.011494252873563218,-2.5470650807841055
ZCTA5 62378,435,5,430,0.011494252873563218,-2.5470650807841055
ZCTA5 83541,435,5,430,0.011494252873563218,-2.5470650807841055
ZCTA5 49113,768,13,755,0.016927083333333332,-2.5470774268157577
ZCTA5 67748,963,18,945,0.018691588785046728,-2.5476568128660033
ZCTA5 62051,295,2,293,0.006779661016949152,-2.5478384127642015
ZCTA5 68658,295,2,293,0.006779661016949152,-2.5478384127642015
ZCTA5 04455,295,2,293,0.006779661016949152,-2.5478384127642015
ZCTA5 50524,244,1,243,0.004098360655737705,-2.5500769918568036
ZCTA5 63544,244,1,243,0.004098360655737705,-2.5500769918568036
ZCTA5 12538,4939,133,4806,0.02692852804211379,-2.550416932267358
ZCTA5 38468,1986,46,1940,0.023162134944612285,-2.5506882087864415
ZCTA5 60617,28188,866,27322,0.030722293174400454,-2.550756530896956
ZCTA5 40170,188,0,188,0,-2.550899575462425
ZCTA5 42361,188,0,188,0,-2.550899575462425
ZCTA5 51033,188,0,188,0,-2.550899575462425
ZCTA5 59721,188,0,188,0,-2.550899575462425
ZCTA5 62314,188,0,188,0,-2.550899575462425
ZCTA5 65752,188,0,188,0,-2.550899575462425
ZCTA5 66952,188,0,188,0,-2.550899575462425
ZCTA5 83123,188,0,188,0,-2.550899575462425
ZCTA5 79237,188,0,188,0,-2.550899575462425
ZCTA5 80468,188,0,188,0,-2.550899575462425
ZCTA5 12843,188,0,188,0,-2.550899575462425
ZCTA5 13670,188,0,188,0,-2.550899575462425
ZCTA5 16826,188,0,188,0,-2.550899575462425
ZCTA5 15007,188,0,188,0,-2.550899575462425
ZCTA5 20758,188,0,188,0,-2.550899575462425
ZCTA5 23070,188,0,188,0,-2.550899575462425
ZCTA5 41040,2752,68,2684,0.024709302325581394,-2.5512002281200243
ZCTA5 62882,964,18,946,0.01867219917012448,-2.552327128018537
ZCTA5 70659,523,7,516,0.01338432122370937,-2.5524650782302376
ZCTA5 54541,480,6,474,0.0125,-2.5530297382996485
ZCTA5 47452,1916,44,1872,0.022964509394572025,-2.5534397903097563
ZCTA5 60468,2233,53,2180,0.02373488580385132,-2.5541437477559326
ZCTA5 31321,2581,63,2518,0.024409143742735374,-2.555470027059696
ZCTA5 68927,566,8,558,0.014134275618374558,-2.5561003188527356
ZCTA5 54773,1340,28,1312,0.020895522388059702,-2.5565904664838914
ZCTA5 71940,730,12,718,0.01643835616438356,-2.556697389907324
ZCTA5 43788,245,1,244,0.004081632653061225,-2.5567533132463542
ZCTA5 61544,245,1,244,0.004081632653061225,-2.5567533132463542
ZCTA5 63965,1192,24,1168,0.020134228187919462,-2.557444335951325
ZCTA5 29836,189,0,189,0,-2.557674885072999
ZCTA5 35254,189,0,189,0,-2.557674885072999
ZCTA5 40903,189,0,189,0,-2.557674885072999
ZCTA5 41810,189,0,189,0,-2.557674885072999
ZCTA5 43458,189,0,189,0,-2.557674885072999
ZCTA5 45360,189,0,189,0,-2.557674885072999
ZCTA5 50599,189,0,189,0,-2.557674885072999
ZCTA5 51061,189,0,189,0,-2.557674885072999
ZCTA5 59837,189,0,189,0,-2.557674885072999
ZCTA5 58210,189,0,189,0,-2.557674885072999
ZCTA5 61773,189,0,189,0,-2.557674885072999
ZCTA5 81431,189,0,189,0,-2.557674885072999
ZCTA5 82933,189,0,189,0,-2.557674885072999
ZCTA5 87531,189,0,189,0,-2.557674885072999
ZCTA5 84636,189,0,189,0,-2.557674885072999
ZCTA5 05260,189,0,189,0,-2.557674885072999
ZCTA5 08014,189,0,189,0,-2.557674885072999
ZCTA5 15489,189,0,189,0,-2.557674885072999
ZCTA5 15031,189,0,189,0,-2.557674885072999
ZCTA5 21829,189,0,189,0,-2.557674885072999
ZCTA5 21538,189,0,189,0,-2.557674885072999
ZCTA5 95537,189,0,189,0,-2.557674885072999
ZCTA5 67063,1341,28,1313,0.020879940343027592,-2.5607174734546314
ZCTA5 16845,297,2,295,0.006734006734006734,-2.56083601575557
ZCTA5 78003,3708,96,3612,0.025889967637540454,-2.561537420929924
ZCTA5 83347,1118,22,1096,0.01967799642218247,-2.5616226627252447
ZCTA5 27816,889,16,873,0.01799775028121485,-2.562861634725794
ZCTA5 93225,1812,41,1771,0.02262693156732892,-2.5630856996909115
ZCTA5 43084,246,1,245,0.0040650406504065045,-2.563413066822489
ZCTA5 68726,246,1,245,0.0040650406504065045,-2.563413066822489
ZCTA5 03282,346,3,343,0.008670520231213872,-2.5637038194015638
ZCTA5 69045,525,7,518,0.013333333333333334,-2.563837806442646
ZCTA5 74884,2201,52,2149,0.023625624716038164,-2.5642827911087767
ZCTA5 36030,190,0,190,0,-2.564432294168044
ZCTA5 58006,190,0,190,0,-2.564432294168044
ZCTA5 65676,190,0,190,0,-2.564432294168044
ZCTA5 66425,190,0,190,0,-2.564432294168044
ZCTA5 68669,190,0,190,0,-2.564432294168044
ZCTA5 56025,190,0,190,0,-2.564432294168044
ZCTA5 71862,190,0,190,0,-2.564432294168044
ZCTA5 08352,190,0,190,0,-2.564432294168044
ZCTA5 05053,190,0,190,0,-2.564432294168044
ZCTA5 17266,190,0,190,0,-2.564432294168044
ZCTA5 23480,190,0,190,0,-2.564432294168044
ZCTA5 23395,190,0,190,0,-2.564432294168044
ZCTA5 36524,482,6,476,0.012448132780082987,-2.564675586054797
ZCTA5 31638,438,5,433,0.01141552511415525,-2.5649957703561976
ZCTA5 70723,438,5,433,0.01141552511415525,-2.5649957703561976
ZCTA5 13147,438,5,433,0.01141552511415525,-2.5649957703561976
ZCTA5 92508,10244,296,9948,0.02889496290511519,-2.566225467555513
ZCTA5 32359,732,12,720,0.01639344262295082,-2.5669549740983166
ZCTA5 64485,3134,79,3055,0.02520740268028079,-2.567441538795187
ZCTA5 55707,1343,28,1315,0.02084884586746091,-2.568963330106245
ZCTA5 24378,526,7,519,0.013307984790874524,-2.569511419722134
ZCTA5 38759,347,3,344,0.008645533141210375,-2.5699943932705285
ZCTA5 56349,347,3,344,0.008645533141210375,-2.5699943932705285
ZCTA5 50143,247,1,246,0.004048582995951417,-2.570056371442677
ZCTA5 62666,247,1,246,0.004048582995951417,-2.570056371442677
ZCTA5 64071,247,1,246,0.004048582995951417,-2.570056371442677
ZCTA5 18630,1195,24,1171,0.0200836820083682,-2.570377646408002
ZCTA5 51431,191,0,191,0,-2.5711719438829403
ZCTA5 54832,191,0,191,0,-2.5711719438829403
ZCTA5 57434,191,0,191,0,-2.5711719438829403
ZCTA5 63386,191,0,191,0,-2.5711719438829403
ZCTA5 56734,191,0,191,0,-2.5711719438829403
ZCTA5 72533,191,0,191,0,-2.5711719438829403
ZCTA5 72629,191,0,191,0,-2.5711719438829403
ZCTA5 73771,191,0,191,0,-2.5711719438829403
ZCTA5 82060,191,0,191,0,-2.5711719438829403
ZCTA5 02875,191,0,191,0,-2.5711719438829403
ZCTA5 07979,191,0,191,0,-2.5711719438829403
ZCTA5 17318,191,0,191,0,-2.5711719438829403
ZCTA5 24715,191,0,191,0,-2.5711719438829403
ZCTA5 98533,191,0,191,0,-2.5711719438829403
ZCTA5 06280,1158,23,1135,0.019861830742659757,-2.572255876745429
ZCTA5 91941,11656,340,11316,0.02916952642415923,-2.572531255746645
ZCTA5 33194,1563,34,1529,0.021753039027511197,-2.572606851605057
ZCTA5 46128,852,15,837,0.017605633802816902,-2.572611905965086
ZCTA5 66854,299,2,297,0.006688963210702341,-2.5737753201379596
ZCTA5 99402,693,11,682,0.015873015873015872,-2.573825539570971
ZCTA5 43610,1708,38,1670,0.02224824355971897,-2.575478466177678
ZCTA5 32570,11658,340,11318,0.029164522216503688,-2.5757567156343835
ZCTA5 56156,2414,58,2356,0.024026512013256007,-2.575960827875921
ZCTA5 76657,3443,88,3355,0.025559105431309903,-2.576271978243918
ZCTA5 80815,348,3,345,0.008620689655172414,-2.5762721930410355
ZCTA5 15860,484,6,478,0.012396694214876033,-2.576284227077398
ZCTA5 60478,5874,161,5713,0.027408920667347635,-2.5766180021782072
ZCTA5 69131,248,1,247,0.004032258064516129,-2.5766833445819577
ZCTA5 75102,440,5,435,0.011363636363636364,-2.5768981440382164
ZCTA5 73728,774,13,761,0.016795865633074936,-2.5773089937652838
ZCTA5 74554,774,13,761,0.016795865633074936,-2.5773089937652838
ZCTA5 38475,192,0,192,0,-2.577893973508138
ZCTA5 40178,192,0,192,0,-2.577893973508138
ZCTA5 47325,192,0,192,0,-2.577893973508138
ZCTA5 58259,192,0,192,0,-2.577893973508138
ZCTA5 66552,192,0,192,0,-2.577893973508138
ZCTA5 68019,192,0,192,0,-2.577893973508138
ZCTA5 68746,192,0,192,0,-2.577893973508138
ZCTA5 78608,192,0,192,0,-2.577893973508138
ZCTA5 83525,192,0,192,0,-2.577893973508138
ZCTA5 03780,192,0,192,0,-2.577893973508138
ZCTA5 12432,192,0,192,0,-2.577893973508138
ZCTA5 15547,192,0,192,0,-2.577893973508138
ZCTA5 16689,192,0,192,0,-2.577893973508138
ZCTA5 99179,192,0,192,0,-2.577893973508138
ZCTA5 54418,395,4,391,0.010126582278481013,-2.5782973582673274
ZCTA5 28732,7183,201,6982,0.02798273701795907,-2.5788344488189443
ZCTA5 62898,814,14,800,0.0171990171990172,-2.579102046531026
ZCTA5 88043,612,9,603,0.014705882352941176,-2.579302651483217
ZCTA5 46781,300,2,298,0.006666666666666667,-2.5802233388358142
ZCTA5 50853,300,2,298,0.006666666666666667,-2.5802233388358142
ZCTA5 17362,5051,136,4915,0.02692536131459117,-2.5804238812470923
ZCTA5 57345,528,7,521,0.013257575757575758,-2.580833309439759
ZCTA5 25865,528,7,521,0.013257575757575758,-2.580833309439759
ZCTA5 65325,1309,27,1282,0.020626432391138275,-2.580986452340756
ZCTA5 12809,1346,28,1318,0.020802377414561663,-2.5813117871049127
ZCTA5 31033,775,13,762,0.016774193548387096,-2.582328555853993
ZCTA5 35959,1995,46,1949,0.02305764411027569,-2.5824156884220684
ZCTA5 31064,3513,90,3423,0.025619128949615714,-2.582544994736913
ZCTA5 91360,15002,445,14557,0.029662711638448205,-2.582575983078111
ZCTA5 14466,654,10,644,0.01529051987767584,-2.5831941378528054
ZCTA5 41721,249,1,248,0.004016064257028112,-2.583294102354969
ZCTA5 57317,249,1,248,0.004016064257028112,-2.583294102354969
ZCTA5 59868,815,14,801,0.01717791411042945,-2.584036108283021
ZCTA5 29452,193,0,193,0,-2.584598520522748
ZCTA5 28702,193,0,193,0,-2.584598520522748
ZCTA5 38564,193,0,193,0,-2.584598520522748
ZCTA5 39867,193,0,193,0,-2.584598520522748
ZCTA5 58831,193,0,193,0,-2.584598520522748
ZCTA5 58779,193,0,193,0,-2.584598520522748
ZCTA5 56158,193,0,193,0,-2.584598520522748
ZCTA5 72122,193,0,193,0,-2.584598520522748
ZCTA5 75669,193,0,193,0,-2.584598520522748
ZCTA5 12405,193,0,193,0,-2.584598520522748
ZCTA5 16113,193,0,193,0,-2.584598520522748
ZCTA5 18626,193,0,193,0,-2.584598520522748
ZCTA5 27582,193,0,193,0,-2.584598520522748
ZCTA5 63627,1347,28,1319,0.020786933927245732,-2.5854225359687177
ZCTA5 55322,1236,25,1211,0.020226537216828478,-2.5861702873077412
ZCTA5 38673,301,2,299,0.006644518272425249,-2.586657055237426
ZCTA5 64649,301,2,299,0.006644518272425249,-2.586657055237426
ZCTA5 77533,301,2,299,0.006644518272425249,-2.586657055237426
ZCTA5 05867,301,2,299,0.006644518272425249,-2.586657055237426
ZCTA5 16636,301,2,299,0.006644518272425249,-2.586657055237426
ZCTA5 95621,16303,486,15817,0.02981046433171809,-2.5873170925401516
ZCTA5 56036,776,13,763,0.01675257731958763,-2.5873427194199956
ZCTA5 68069,1199,24,1175,0.020016680567139282,-2.5875779352121704
ZCTA5 46057,486,6,480,0.012345679012345678,-2.5878559723475485
ZCTA5 74445,1124,22,1102,0.019572953736654804,-2.5880717122013097
ZCTA5 30575,442,5,437,0.011312217194570135,-2.5887598187849012
ZCTA5 75926,442,5,437,0.011312217194570135,-2.5887598187849012
ZCTA5 72855,2453,59,2394,0.02405218100285365,-2.5896157356388394
ZCTA5 52210,250,1,249,0.004,-2.5898887595375317
ZCTA5 73718,250,1,249,0.004,-2.5898887595375317
ZCTA5 84637,250,1,249,0.004,-2.5898887595375317
ZCTA5 63801,9487,272,9215,0.02867081269105091,-2.5910012661778126
ZCTA5 29082,194,0,194,0,-2.5912857206273445
ZCTA5 37765,194,0,194,0,-2.5912857206273445
ZCTA5 40070,194,0,194,0,-2.5912857206273445
ZCTA5 58416,194,0,194,0,-2.5912857206273445
ZCTA5 62553,194,0,194,0,-2.5912857206273445
ZCTA5 68336,194,0,194,0,-2.5912857206273445
ZCTA5 68517,194,0,194,0,-2.5912857206273445
ZCTA5 76435,194,0,194,0,-2.5912857206273445
ZCTA5 82412,194,0,194,0,-2.5912857206273445
ZCTA5 12124,194,0,194,0,-2.5912857206273445
ZCTA5 12766,194,0,194,0,-2.5912857206273445
ZCTA5 71861,777,13,764,0.01673101673101673,-2.592351499065963
ZCTA5 81054,1312,27,1285,0.020579268292682928,-2.593442739090276
ZCTA5 98922,2869,71,2798,0.02474729871035204,-2.5935492768006694
ZCTA5 28033,1275,26,1249,0.0203921568627451,-2.593767201304376
ZCTA5 47438,1641,36,1605,0.021937842778793418,-2.5943850108677395
ZCTA5 55748,697,11,686,0.015781922525107604,-2.594617069934467
ZCTA5 06447,2350,56,2294,0.023829787234042554,-2.5946187121204893
ZCTA5 50535,443,5,438,0.011286681715575621,-2.59467550933756
ZCTA5 50046,573,8,565,0.013961605584642234,-2.5948437058242435
ZCTA5 15757,615,9,606,0.014634146341463415,-2.5955099693375483
ZCTA5 35005,2663,65,2598,0.024408561772437103,-2.595914082657425
ZCTA5 83455,1821,41,1780,0.022515101592531575,-2.595981592882835
ZCTA5 13324,896,16,880,0.017857142857142856,-2.5963377599364397
ZCTA5 55985,738,12,726,0.016260162601626018,-2.5975890313866543
ZCTA5 55021,11160,324,10836,0.02903225806451613,-2.5978443521037917
ZCTA5 47203,10423,301,10122,0.02887844190732035,-2.597928873137273
ZCTA5 40988,195,0,195,0,-2.597955707776016
ZCTA5 41204,195,0,195,0,-2.597955707776016
ZCTA5 50681,195,0,195,0,-2.597955707776016
ZCTA5 53088,195,0,195,0,-2.597955707776016
ZCTA5 59831,195,0,195,0,-2.597955707776016
ZCTA5 62374,195,0,195,0,-2.597955707776016
ZCTA5 61724,195,0,195,0,-2.597955707776016
ZCTA5 61317,195,0,195,0,-2.597955707776016
ZCTA5 66948,195,0,195,0,-2.597955707776016
ZCTA5 12749,195,0,195,0,-2.597955707776016
ZCTA5 18231,195,0,195,0,-2.597955707776016
ZCTA5 24934,195,0,195,0,-2.597955707776016
ZCTA5 92055,195,0,195,0,-2.597955707776016
ZCTA5 92328,195,0,195,0,-2.597955707776016
ZCTA5 98542,195,0,195,0,-2.597955707776016
ZCTA5 99346,195,0,195,0,-2.597955707776016
ZCTA5 37189,1387,29,1358,0.02090843547224225,-2.5983653621850085
ZCTA5 77364,818,14,804,0.017114914425427872,-2.5988078756402975
ZCTA5 32220,4627,123,4504,0.026583099200345798,-2.599215786447021
ZCTA5 51047,303,2,301,0.006600660066006601,-2.5994819358901604
ZCTA5 66041,303,2,301,0.006600660066006601,-2.5994819358901604
ZCTA5 03445,303,2,301,0.006600660066006601,-2.5994819358901604
ZCTA5 43154,1202,24,1178,0.019966722129783693,-2.600445254832171
ZCTA5 75244,6115,168,5947,0.027473426001635323,-2.600892205833392
ZCTA5 68070,252,1,251,0.003968253968253968,-2.6030302246669774
ZCTA5 25420,1571,34,1537,0.021642266072565246,-2.60359880362641
ZCTA5 75603,2248,53,2195,0.023576512455516015,-2.604466374848481
ZCTA5 40940,196,0,196,0,-2.604608614207666
ZCTA5 57263,196,0,196,0,-2.604608614207666
ZCTA5 66780,196,0,196,0,-2.604608614207666
ZCTA5 70464,196,0,196,0,-2.604608614207666
ZCTA5 70736,196,0,196,0,-2.604608614207666
ZCTA5 72152,196,0,196,0,-2.604608614207666
ZCTA5 80469,196,0,196,0,-2.604608614207666
ZCTA5 15325,196,0,196,0,-2.604608614207666
ZCTA5 51250,2735,67,2668,0.024497257769652652,-2.604977512875062
ZCTA5 48818,1052,20,1032,0.019011406844106463,-2.6050957638561103
ZCTA5 57273,489,6,483,0.012269938650306749,-2.6051450811074317
ZCTA5 22637,898,16,882,0.017817371937639197,-2.605861605767074
ZCTA5 00652,1315,27,1288,0.02053231939163498,-2.605873962038722
ZCTA5 35208,5426,147,5279,0.027091780316992258,-2.6063259233039857
ZCTA5 24963,1608,35,1573,0.021766169154228857,-2.6064497246787552
ZCTA5 82649,445,5,440,0.011235955056179775,-2.60647682452024
ZCTA5 57332,253,1,252,0.003952569169960474,-2.609577255659668
ZCTA5 66033,253,1,252,0.003952569169960474,-2.609577255659668
ZCTA5 68329,253,1,252,0.003952569169960474,-2.609577255659668
ZCTA5 72126,1279,26,1253,0.020328381548084442,-2.61051651765164
ZCTA5 49262,490,6,484,0.012244897959183673,-2.610889999514999
ZCTA5 42069,197,0,197,0,-2.6112445704766105
ZCTA5 50074,197,0,197,0,-2.6112445704766105
ZCTA5 50141,197,0,197,0,-2.6112445704766105
ZCTA5 58656,197,0,197,0,-2.6112445704766105
ZCTA5 63381,197,0,197,0,-2.6112445704766105
ZCTA5 72752,197,0,197,0,-2.6112445704766105
ZCTA5 12008,197,0,197,0,-2.6112445704766105
ZCTA5 15483,197,0,197,0,-2.6112445704766105
ZCTA5 94548,197,0,197,0,-2.6112445704766105
ZCTA5 31058,576,8,568,0.013888888888888888,-2.6113329127025398
ZCTA5 62830,576,8,568,0.013888888888888888,-2.6113329127025398
ZCTA5 62513,618,9,609,0.014563106796116505,-2.6116538218630767
ZCTA5 73132,10816,313,10503,0.02893860946745562,-2.6116548845286696
ZCTA5 49248,305,2,303,0.006557377049180328,-2.6122506628315647
ZCTA5 59029,305,2,303,0.006557377049180328,-2.6122506628315647
ZCTA5 16942,305,2,303,0.006557377049180328,-2.6122506628315647
ZCTA5 64079,4999,134,4865,0.026805361072214443,-2.6142899372658306
ZCTA5 21780,534,7,527,0.013108614232209739,-2.614598618370535
ZCTA5 99185,534,7,527,0.013108614232209739,-2.614598618370535
ZCTA5 29685,701,11,690,0.015691868758915834,-2.615310923056659
ZCTA5 52576,254,1,253,0.003937007874015748,-2.6161086321937543
ZCTA5 65239,491,6,485,0.012219959266802444,-2.6166259213166074
ZCTA5 67074,619,9,610,0.014539579967689823,-2.617021112693482
ZCTA5 46051,1206,24,1182,0.01990049751243781,-2.617558104365219
ZCTA5 43934,198,0,198,0,-2.617863705482464
ZCTA5 46110,198,0,198,0,-2.617863705482464
ZCTA5 58265,198,0,198,0,-2.617863705482464
ZCTA5 64486,198,0,198,0,-2.617863705482464
ZCTA5 71427,198,0,198,0,-2.617863705482464
ZCTA5 83025,198,0,198,0,-2.617863705482464
ZCTA5 87715,198,0,198,0,-2.617863705482464
ZCTA5 84061,198,0,198,0,-2.617863705482464
ZCTA5 03847,198,0,198,0,-2.617863705482464
ZCTA5 12998,198,0,198,0,-2.617863705482464
ZCTA5 16921,198,0,198,0,-2.617863705482464
ZCTA5 25906,198,0,198,0,-2.617863705482464
ZCTA5 98555,198,0,198,0,-2.617863705482464
ZCTA5 59730,822,14,808,0.0170316301703163,-2.618433076034003
ZCTA5 54770,822,14,808,0.0170316301703163,-2.618433076034003
ZCTA5 53586,901,16,885,0.017758046614872364,-2.620113726258162
ZCTA5 48652,661,10,651,0.015128593040847202,-2.6201334665469216
ZCTA5 41045,535,7,528,0.013084112149532711,-2.620197286065001
ZCTA5 60474,402,4,398,0.009950248756218905,-2.6207039499633753
ZCTA5 50225,1207,24,1183,0.01988400994200497,-2.621828572052838
ZCTA5 59847,2183,51,2132,0.0233623453962437,-2.6221837628728166
ZCTA5 54026,783,13,770,0.016602809706257982,-2.6222919248059937
ZCTA5 04856,1393,29,1364,0.0208183776022972,-2.6226716079977335
ZCTA5 97536,448,5,443,0.011160714285714286,-2.624104306085033
ZCTA5 08533,2394,57,2337,0.023809523809523808,-2.6243097492997864
ZCTA5 41257,199,0,199,0,-2.6244661464993557
ZCTA5 50840,199,0,199,0,-2.6244661464993557
ZCTA5 50146,199,0,199,0,-2.6244661464993557
ZCTA5 51014,199,0,199,0,-2.6244661464993557
ZCTA5 65777,199,0,199,0,-2.6244661464993557
ZCTA5 75421,199,0,199,0,-2.6244661464993557
ZCTA5 04693,199,0,199,0,-2.6244661464993557
ZCTA5 03443,199,0,199,0,-2.6244661464993557
ZCTA5 04611,199,0,199,0,-2.6244661464993557
ZCTA5 13659,199,0,199,0,-2.6244661464993557
ZCTA5 13136,199,0,199,0,-2.6244661464993557
ZCTA5 25060,199,0,199,0,-2.6244661464993557
ZCTA5 27875,199,0,199,0,-2.6244661464993557
ZCTA5 59523,941,17,924,0.018065887353878853,-2.625127207527381
ZCTA5 19030,4571,121,4450,0.02647123167796981,-2.6254992534533343
ZCTA5 80731,536,7,529,0.013059701492537313,-2.625787785170384
ZCTA5 31711,356,3,353,0.008426966292134831,-2.6260431128082007
ZCTA5 60408,2149,50,2099,0.023266635644485806,-2.6263573918449237
ZCTA5 35441,403,4,399,0.009925558312655087,-2.6267179221372694
ZCTA5 23917,1133,22,1111,0.019417475728155338,-2.6275161744942226
ZCTA5 36545,3631,93,3538,0.025612778848801983,-2.627687921902871
ZCTA5 91390,5996,164,5832,0.027351567711807873,-2.627935332061593
ZCTA5 23229,12904,378,12526,0.029293242405455673,-2.62859553118766
ZCTA5 24592,5337,144,5193,0.026981450252951095,-2.629685891577178
ZCTA5 93428,2881,71,2810,0.02464422075668171,-2.629735653082272
ZCTA5 56285,449,5,444,0.011135857461024499,-2.629960446384038
ZCTA5 57010,200,0,200,0,-2.6310520192044815
ZCTA5 62947,200,0,200,0,-2.6310520192044815
ZCTA5 70537,200,0,200,0,-2.6310520192044815
ZCTA5 68634,200,0,200,0,-2.6310520192044815
ZCTA5 71758,200,0,200,0,-2.6310520192044815
ZCTA5 56212,200,0,200,0,-2.6310520192044815
ZCTA5 79788,200,0,200,0,-2.6310520192044815
ZCTA5 83650,200,0,200,0,-2.6310520192044815
ZCTA5 03765,200,0,200,0,-2.6310520192044815
ZCTA5 12064,200,0,200,0,-2.6310520192044815
ZCTA5 12936,200,0,200,0,-2.6310520192044815
ZCTA5 15739,200,0,200,0,-2.6310520192044815
ZCTA5 26285,200,0,200,0,-2.6310520192044815
ZCTA5 25244,200,0,200,0,-2.6310520192044815
ZCTA5 25109,200,0,200,0,-2.6310520192044815
ZCTA5 25981,200,0,200,0,-2.6310520192044815
ZCTA5 93529,200,0,200,0,-2.6310520192044815
ZCTA5 56052,308,2,306,0.006493506493506494,-2.6312999642074804
ZCTA5 19904,12938,379,12559,0.029293553872314113,-2.63185920072429
ZCTA5 56557,1058,20,1038,0.01890359168241966,-2.6320164810282387
ZCTA5 70533,2640,64,2576,0.024242424242424242,-2.632150968112745
ZCTA5 31783,357,3,354,0.008403361344537815,-2.632209066794321
ZCTA5 97738,745,12,733,0.016107382550335572,-2.6330695298559235
ZCTA5 16373,1359,28,1331,0.020603384841795438,-2.634542569405536
ZCTA5 32058,1210,24,1186,0.019834710743801654,-2.6346214756204733
ZCTA5 72331,1210,24,1186,0.019834710743801654,-2.6346214756204733
ZCTA5 37755,1322,27,1295,0.02042360060514372,-2.6347833660046702
ZCTA5 74647,1396,29,1367,0.020773638968481375,-2.6347900536234086
ZCTA5 50517,450,5,445,0.011111111111111112,-2.6358068162689285
ZCTA5 03450,450,5,445,0.011111111111111112,-2.6358068162689285
ZCTA5 66066,1059,20,1039,0.018885741265344664,-2.6364904751247478
ZCTA5 45122,3871,100,3771,0.025833118057349523,-2.6369031347123757
ZCTA5 98856,1173,23,1150,0.0196078431372549,-2.6372373739223995
ZCTA5 29915,201,0,201,0,-2.6376214477060156
ZCTA5 33001,201,0,201,0,-2.6376214477060156
ZCTA5 50642,201,0,201,0,-2.6376214477060156
ZCTA5 49636,201,0,201,0,-2.6376214477060156
ZCTA5 53920,201,0,201,0,-2.6376214477060156
ZCTA5 52550,201,0,201,0,-2.6376214477060156
ZCTA5 58071,201,0,201,0,-2.6376214477060156
ZCTA5 61007,201,0,201,0,-2.6376214477060156
ZCTA5 69133,201,0,201,0,-2.6376214477060156
ZCTA5 80726,201,0,201,0,-2.6376214477060156
ZCTA5 08006,201,0,201,0,-2.6376214477060156
ZCTA5 16868,201,0,201,0,-2.6376214477060156
ZCTA5 25169,201,0,201,0,-2.6376214477060156
ZCTA5 89310,201,0,201,0,-2.6376214477060156
ZCTA5 95527,309,2,307,0.006472491909385114,-2.637622390261537
ZCTA5 59749,746,12,734,0.0160857908847185,-2.63811568161137
ZCTA5 61349,358,3,355,0.008379888268156424,-2.638362929378815
ZCTA5 15736,358,3,355,0.008379888268156424,-2.638362929378815
ZCTA5 15772,581,8,573,0.013769363166953529,-2.6386641802598687
ZCTA5 54412,866,15,851,0.017321016166281754,-2.6402405953107495
ZCTA5 56044,866,15,851,0.017321016166281754,-2.6402405953107495
ZCTA5 62540,665,10,655,0.015037593984962405,-2.6410993060205192
ZCTA5 43832,2988,74,2914,0.024765729585006693,-2.641187525053687
ZCTA5 70657,1762,39,1723,0.02213393870601589,-2.6425574878535305
ZCTA5 45614,1798,40,1758,0.02224694104560623,-2.6427696474861926
ZCTA5 56455,747,12,735,0.01606425702811245,-2.643156257926359
ZCTA5 17244,906,16,890,0.017660044150110375,-2.6437782310855575
ZCTA5 46776,582,8,574,0.013745704467353952,-2.6441080620882507
ZCTA5 36205,202,0,202,0,-2.6441745545704007
ZCTA5 46063,202,0,202,0,-2.6441745545704007
ZCTA5 47585,202,0,202,0,-2.6441745545704007
ZCTA5 48476,202,0,202,0,-2.6441745545704007
ZCTA5 54846,202,0,202,0,-2.6441745545704007
ZCTA5 87005,202,0,202,0,-2.6441745545704007
ZCTA5 60109,202,0,202,0,-2.6441745545704007
ZCTA5 58031,202,0,202,0,-2.6441745545704007
ZCTA5 65339,202,0,202,0,-2.6441745545704007
ZCTA5 67223,202,0,202,0,-2.6441745545704007
ZCTA5 72413,202,0,202,0,-2.6441745545704007
ZCTA5 72860,202,0,202,0,-2.6441745545704007
ZCTA5 74430,202,0,202,0,-2.6441745545704007
ZCTA5 83414,202,0,202,0,-2.6441745545704007
ZCTA5 78066,202,0,202,0,-2.6441745545704007
ZCTA5 78141,202,0,202,0,-2.6441745545704007
ZCTA5 14816,202,0,202,0,-2.6441745545704007
ZCTA5 16750,202,0,202,0,-2.6441745545704007
ZCTA5 18439,202,0,202,0,-2.6441745545704007
ZCTA5 24292,202,0,202,0,-2.6441745545704007
ZCTA5 05474,406,4,402,0.009852216748768473,-2.644694852993265
ZCTA5 30562,496,6,490,0.012096774193548387,-2.6451718690857113
ZCTA5 77808,4546,120,4426,0.026396832380114386,-2.646205942979692
ZCTA5 61877,666,10,656,0.015015015015015015,-2.646324792002463
ZCTA5 92320,3298,83,3215,0.025166767738023045,-2.6467385979196343
ZCTA5 71268,1023,19,1004,0.01857282502443793,-2.6469483344073486
ZCTA5 41016,2471,59,2412,0.02387697288547147,-2.6475339891579153
ZCTA5 62047,540,7,533,0.012962962962962963,-2.6480687140476187
ZCTA5 70067,946,17,929,0.017970401691331923,-2.64842455183109
ZCTA5 74653,1473,31,1442,0.021045485403937542,-2.648457716931797
ZCTA5 47227,868,15,853,0.01728110599078341,-2.649826543131277
ZCTA5 58577,868,15,853,0.01728110599078341,-2.649826543131277
ZCTA5 03818,1764,39,1725,0.022108843537414966,-2.649918227506729
ZCTA5 41831,407,4,403,0.009828009828009828,-2.6506656765099406
ZCTA5 80226,13492,396,13096,0.029350726356359325,-2.6506853937758743
ZCTA5 36436,203,0,203,0,-2.650711460849026
ZCTA5 87530,203,0,203,0,-2.650711460849026
ZCTA5 62624,203,0,203,0,-2.650711460849026
ZCTA5 62421,203,0,203,0,-2.650711460849026
ZCTA5 69350,203,0,203,0,-2.650711460849026
ZCTA5 71473,203,0,203,0,-2.650711460849026
ZCTA5 04674,203,0,203,0,-2.650711460849026
ZCTA5 17930,203,0,203,0,-2.650711460849026
ZCTA5 16250,203,0,203,0,-2.650711460849026
ZCTA5 18087,203,0,203,0,-2.650711460849026
ZCTA5 26202,203,0,203,0,-2.650711460849026
ZCTA5 04083,1979,45,1934,0.022738756947953513,-2.6509294943130115
ZCTA5 53006,708,11,697,0.015536723163841809,-2.651293603371427
ZCTA5 65786,708,11,697,0.015536723163841809,-2.651293603371427
ZCTA5 55927,1547,33,1514,0.021331609566903685,-2.651584702000355
ZCTA5 70514,869,15,854,0.01726121979286536,-2.6546125555252016
ZCTA5 08824,4080,106,3974,0.025980392156862746,-2.6548379934536173
ZCTA5 51446,260,1,259,0.0038461538461538464,-2.6549741334244934
ZCTA5 27862,312,2,310,0.00641025641025641,-2.6565087957492133
ZCTA5 64770,408,4,404,0.00980392156862745,-2.65662584320404
ZCTA5 50005,361,3,358,0.008310249307479225,-2.656752616769291
ZCTA5 11957,361,3,358,0.008310249307479225,-2.656752616769291
ZCTA5 62667,204,0,204,0,-2.6572322861043176
ZCTA5 61932,204,0,204,0,-2.6572322861043176
ZCTA5 65731,204,0,204,0,-2.6572322861043176
ZCTA5 68346,204,0,204,0,-2.6572322861043176
ZCTA5 21676,204,0,204,0,-2.6572322861043176
ZCTA5 24161,204,0,204,0,-2.6572322861043176
ZCTA5 25214,204,0,204,0,-2.6572322861043176
ZCTA5 25206,204,0,204,0,-2.6572322861043176
ZCTA5 25205,204,0,204,0,-2.6572322861043176
ZCTA5 99117,204,0,204,0,-2.6572322861043176
ZCTA5 28460,4249,111,4138,0.026123793833843258,-2.6572809589349795
ZCTA5 79103,3980,103,3877,0.025879396984924623,-2.6575341632858023
ZCTA5 39480,1140,22,1118,0.01929824561403509,-2.658007741991743
ZCTA5 96161,6929,192,6737,0.027709626208688123,-2.6592549200774642
ZCTA5 56223,585,8,577,0.013675213675213675,-2.6603954361887108
ZCTA5 42633,7745,217,7528,0.02801807617817947,-2.6605237575396345
ZCTA5 08512,4116,107,4009,0.025996112730806608,-2.660916000307244
ZCTA5 12173,791,13,778,0.01643489254108723,-2.6619171383532154
ZCTA5 59038,313,2,311,0.006389776357827476,-2.662777575373405
ZCTA5 61777,313,2,311,0.006389776357827476,-2.662777575373405
ZCTA5 16729,362,3,359,0.008287292817679558,-2.6628587590533472
ZCTA5 70071,1440,30,1410,0.020833333333333332,-2.6633930994586685
ZCTA5 33867,205,0,205,0,-2.6637371484352537
ZCTA5 38567,205,0,205,0,-2.6637371484352537
ZCTA5 40862,205,0,205,0,-2.6637371484352537
ZCTA5 42566,205,0,205,0,-2.6637371484352537
ZCTA5 47855,205,0,205,0,-2.6637371484352537
ZCTA5 52551,205,0,205,0,-2.6637371484352537
ZCTA5 57479,205,0,205,0,-2.6637371484352537
ZCTA5 61423,205,0,205,0,-2.6637371484352537
ZCTA5 65755,205,0,205,0,-2.6637371484352537
ZCTA5 67732,205,0,205,0,-2.6637371484352537
ZCTA5 72156,205,0,205,0,-2.6637371484352537
ZCTA5 73842,205,0,205,0,-2.6637371484352537
ZCTA5 82329,205,0,205,0,-2.6637371484352537
ZCTA5 04481,205,0,205,0,-2.6637371484352537
ZCTA5 06024,205,0,205,0,-2.6637371484352537
ZCTA5 06332,205,0,205,0,-2.6637371484352537
ZCTA5 12444,205,0,205,0,-2.6637371484352537
ZCTA5 20880,205,0,205,0,-2.6637371484352537
ZCTA5 24924,205,0,205,0,-2.6637371484352537
ZCTA5 25110,205,0,205,0,-2.6637371484352537
ZCTA5 98345,205,0,205,0,-2.6637371484352537
ZCTA5 62693,543,7,536,0.01289134438305709,-2.664695144108159
ZCTA5 48729,586,8,578,0.013651877133105802,-2.665809889979918
ZCTA5 65658,711,11,700,0.015471167369901548,-2.6666257701993796
ZCTA5 68510,9304,265,9039,0.028482373172828892,-2.666971055972412
ZCTA5 24319,2859,70,2789,0.02448408534452606,-2.667292283484731
ZCTA5 71045,262,1,261,0.003816793893129771,-2.66780883970474
ZCTA5 57355,500,6,494,0.012,-2.667850403255589
ZCTA5 93430,1478,31,1447,0.02097428958051421,-2.668170325110868
ZCTA5 62037,872,15,857,0.017201834862385322,-2.6689428813967866
ZCTA5 65261,363,3,360,0.008264462809917356,-2.6689531298700198
ZCTA5 71644,363,3,360,0.008264462809917356,-2.6689531298700198
ZCTA5 29692,1877,42,1835,0.022376132125732553,-2.669077842727089
ZCTA5 45835,206,0,206,0,-2.670226164502321
ZCTA5 49915,206,0,206,0,-2.670226164502321
ZCTA5 50843,206,0,206,0,-2.670226164502321
ZCTA5 54447,206,0,206,0,-2.670226164502321
ZCTA5 59212,206,0,206,0,-2.670226164502321
ZCTA5 58655,206,0,206,0,-2.670226164502321
ZCTA5 62027,206,0,206,0,-2.670226164502321
ZCTA5 67352,206,0,206,0,-2.670226164502321
ZCTA5 68040,206,0,206,0,-2.670226164502321
ZCTA5 71466,206,0,206,0,-2.670226164502321
ZCTA5 73453,206,0,206,0,-2.670226164502321
ZCTA5 82334,206,0,206,0,-2.670226164502321
ZCTA5 79842,206,0,206,0,-2.670226164502321
ZCTA5 05056,206,0,206,0,-2.670226164502321
ZCTA5 23651,206,0,206,0,-2.670226164502321
ZCTA5 25040,206,0,206,0,-2.670226164502321
ZCTA5 27941,206,0,206,0,-2.670226164502321
ZCTA5 95979,206,0,206,0,-2.670226164502321
ZCTA5 50645,456,5,451,0.010964912280701754,-2.67068226432896
ZCTA5 73430,456,5,451,0.010964912280701754,-2.67068226432896
ZCTA5 12989,456,5,451,0.010964912280701754,-2.67068226432896
ZCTA5 16650,753,12,741,0.01593625498007968,-2.6732835000128956
ZCTA5 49665,1662,36,1626,0.021660649819494584,-2.6737760795207635
ZCTA5 65323,364,3,361,0.008241758241758242,-2.6750357915965273
ZCTA5 49637,1369,28,1341,0.020452885317750184,-2.6751848107062286
ZCTA5 38940,630,9,621,0.014285714285714285,-2.6756071366761662
ZCTA5 97834,457,5,452,0.010940919037199124,-2.6764614388540457
ZCTA5 37375,1068,20,1048,0.018726591760299626,-2.676593704675288
ZCTA5 51454,588,8,580,0.013605442176870748,-2.676616944926789
ZCTA5 29943,207,0,207,0,-2.6766994495519247
ZCTA5 45746,207,0,207,0,-2.6766994495519247
ZCTA5 49871,207,0,207,0,-2.6766994495519247
ZCTA5 58352,207,0,207,0,-2.6766994495519247
ZCTA5 61312,207,0,207,0,-2.6766994495519247
ZCTA5 66853,207,0,207,0,-2.6766994495519247
ZCTA5 78117,207,0,207,0,-2.6766994495519247
ZCTA5 88339,207,0,207,0,-2.6766994495519247
ZCTA5 05037,207,0,207,0,-2.6766994495519247
ZCTA5 14511,207,0,207,0,-2.6766994495519247
ZCTA5 17027,207,0,207,0,-2.6766994495519247
ZCTA5 25059,207,0,207,0,-2.6766994495519247
ZCTA5 25108,207,0,207,0,-2.6766994495519247
ZCTA5 95714,207,0,207,0,-2.6766994495519247
ZCTA5 97127,1295,26,1269,0.020077220077220077,-2.677057558917674
ZCTA5 63862,672,10,662,0.01488095238095238,-2.6775450497828466
ZCTA5 93065,23865,724,23141,0.030337314058244292,-2.677760020365712
ZCTA5 48032,754,12,742,0.015915119363395226,-2.678285481081476
ZCTA5 39479,2058,47,2011,0.0228377065111759,-2.678359991892234
ZCTA5 98841,3988,103,3885,0.025827482447342027,-2.6784355179706156
ZCTA5 45686,1333,27,1306,0.020255063765941484,-2.6799417668951464
ZCTA5 66777,264,1,263,0.003787878787878788,-2.6805846598649232
ZCTA5 66852,264,1,263,0.003787878787878788,-2.6805846598649232
ZCTA5 65769,953,17,936,0.017838405036726127,-2.680865761405047
ZCTA5 51653,631,9,622,0.014263074484944533,-2.680892437280054
ZCTA5 14815,365,3,362,0.00821917808219178,-2.6811068060877274
ZCTA5 42712,546,7,539,0.01282051282051282,-2.6812502464036285
ZCTA5 49659,2621,63,2558,0.024036627241510875,-2.6812537552220883
ZCTA5 17764,914,16,898,0.0175054704595186,-2.6814128255683793
ZCTA5 12401,14531,428,14103,0.02945427018099236,-2.681443363883353
ZCTA5 19140,18459,552,17907,0.029904111815374616,-2.6823312579476806
ZCTA5 48048,2691,65,2626,0.024154589371980676,-2.6827923917618994
ZCTA5 47524,208,0,208,0,-2.6831571174402695
ZCTA5 47017,208,0,208,0,-2.6831571174402695
ZCTA5 51558,208,0,208,0,-2.6831571174402695
ZCTA5 49796,208,0,208,0,-2.6831571174402695
ZCTA5 59480,208,0,208,0,-2.6831571174402695
ZCTA5 58461,208,0,208,0,-2.6831571174402695
ZCTA5 62059,208,0,208,0,-2.6831571174402695
ZCTA5 81040,208,0,208,0,-2.6831571174402695
ZCTA5 01475,3821,98,3723,0.025647736194713427,-2.683544257293242
ZCTA5 97865,547,7,540,0.012797074954296161,-2.6867529011082514
ZCTA5 60630,20952,631,20321,0.030116456662848415,-2.686799439251331
ZCTA5 64474,366,3,363,0.00819672131147541,-2.687166234682026
ZCTA5 08019,366,3,363,0.00819672131147541,-2.687166234682026
ZCTA5 52567,317,2,315,0.006309148264984227,-2.687721353203562
ZCTA5 56447,459,5,454,0.010893246187363835,-2.6879915336576246
ZCTA5 72129,459,5,454,0.010893246187363835,-2.6879915336576246
ZCTA5 24012,12016,349,11667,0.029044607190412783,-2.688106403005525
ZCTA5 50421,1335,27,1308,0.020224719101123594,-2.6881172253171957
ZCTA5 63072,1185,23,1162,0.019409282700421943,-2.6887042569732724
ZCTA5 29175,209,0,209,0,-2.6895992806567257
ZCTA5 43157,209,0,209,0,-2.6895992806567257
ZCTA5 46990,209,0,209,0,-2.6895992806567257
ZCTA5 44844,209,0,209,0,-2.6895992806567257
ZCTA5 57330,209,0,209,0,-2.6895992806567257
ZCTA5 61862,209,0,209,0,-2.6895992806567257
ZCTA5 63474,209,0,209,0,-2.6895992806567257
ZCTA5 66424,209,0,209,0,-2.6895992806567257
ZCTA5 68360,209,0,209,0,-2.6895992806567257
ZCTA5 68461,209,0,209,0,-2.6895992806567257
ZCTA5 04612,209,0,209,0,-2.6895992806567257
ZCTA5 03593,209,0,209,0,-2.6895992806567257
ZCTA5 12760,209,0,209,0,-2.6895992806567257
ZCTA5 16228,209,0,209,0,-2.6895992806567257
ZCTA5 16840,209,0,209,0,-2.6895992806567257
ZCTA5 24981,209,0,209,0,-2.6895992806567257
ZCTA5 24458,209,0,209,0,-2.6895992806567257
ZCTA5 82070,8540,241,8299,0.028220140515222484,-2.6898919274925803
ZCTA5 56732,504,6,498,0.011904761904761904,-2.6903907458260985
ZCTA5 62080,916,16,900,0.017467248908296942,-2.690778018077075
ZCTA5 91789,13264,388,12876,0.02925211097708082,-2.6913535538900235
ZCTA5 52768,633,9,624,0.014218009478672985,-2.6914429978434176
ZCTA5 56676,633,9,624,0.014218009478672985,-2.6914429978434176
ZCTA5 62893,414,4,410,0.00966183574879227,-2.692165898572133
ZCTA5 10607,2345,55,2290,0.023454157782515993,-2.6930136057652443
ZCTA5 35188,1110,21,1089,0.01891891891891892,-2.6930818050465106
ZCTA5 66423,367,3,364,0.008174386920980926,-2.693214138207198
ZCTA5 55957,266,1,265,0.0037593984962406013,-2.693302374284045
ZCTA5 68958,266,1,265,0.0037593984962406013,-2.693302374284045
ZCTA5 56710,266,1,265,0.0037593984962406013,-2.693302374284045
ZCTA5 43501,318,2,316,0.006289308176100629,-2.693924848569817
ZCTA5 51026,318,2,316,0.006289308176100629,-2.693924848569817
ZCTA5 14836,318,2,316,0.006289308176100629,-2.693924848569817
ZCTA5 37727,917,16,901,0.017448200654307525,-2.695454151004735
ZCTA5 44867,917,16,901,0.017448200654307525,-2.695454151004735
ZCTA5 70390,2521,60,2461,0.02380007933359778,-2.695656267244591
ZCTA5 38950,210,0,210,0,-2.6960260503466906
ZCTA5 40115,210,0,210,0,-2.6960260503466906
ZCTA5 52752,210,0,210,0,-2.6960260503466906
ZCTA5 60470,210,0,210,0,-2.6960260503466906
ZCTA5 68455,210,0,210,0,-2.6960260503466906
ZCTA5 75247,210,0,210,0,-2.6960260503466906
ZCTA5 87023,210,0,210,0,-2.6960260503466906
ZCTA5 01745,210,0,210,0,-2.6960260503466906
ZCTA5 07977,210,0,210,0,-2.6960260503466906
ZCTA5 15412,210,0,210,0,-2.6960260503466906
ZCTA5 18239,210,0,210,0,-2.6960260503466906
ZCTA5 23177,210,0,210,0,-2.6960260503466906
ZCTA5 93664,210,0,210,0,-2.6960260503466906
ZCTA5 17034,1111,21,1090,0.018901890189018902,-2.6974511074409957
ZCTA5 73075,3555,90,3465,0.02531645569620253,-2.698296209933269
ZCTA5 47515,368,3,365,0.008152173913043478,-2.699250576986122
ZCTA5 57368,461,5,456,0.010845986984815618,-2.699484228331775
ZCTA5 92273,461,5,456,0.010845986984815618,-2.699484228331775
ZCTA5 58456,267,1,266,0.003745318352059925,-2.6996396811193493
ZCTA5 58032,319,2,317,0.006269592476489028,-2.7001155161932866
ZCTA5 46115,799,13,786,0.016270337922403004,-2.7012113289031525
ZCTA5 45688,211,0,211,0,-2.7024375363339623
ZCTA5 59018,211,0,211,0,-2.7024375363339623
ZCTA5 62671,211,0,211,0,-2.7024375363339623
ZCTA5 64841,211,0,211,0,-2.7024375363339623
ZCTA5 68314,211,0,211,0,-2.7024375363339623
ZCTA5 56280,211,0,211,0,-2.7024375363339623
ZCTA5 01088,211,0,211,0,-2.7024375363339623
ZCTA5 04573,211,0,211,0,-2.7024375363339623
ZCTA5 15363,211,0,211,0,-2.7024375363339623
ZCTA5 15951,211,0,211,0,-2.7024375363339623
ZCTA5 24736,211,0,211,0,-2.7024375363339623
ZCTA5 46936,2207,51,2156,0.023108291798821932,-2.702931291770921
ZCTA5 52536,416,4,412,0.009615384615384616,-2.7039296122602856
ZCTA5 13622,919,16,903,0.017410228509249184,-2.704793539717143
ZCTA5 22821,1923,43,1880,0.02236089443577743,-2.7053016489486534
ZCTA5 72719,4066,105,3961,0.025823905558288243,-2.7057703934791864
ZCTA5 37015,6526,179,6347,0.02742874655225253,-2.7069483828203187
ZCTA5 19124,22667,685,21982,0.03022014382141439,-2.7077861127389604
ZCTA5 43155,959,17,942,0.017726798748696558,-2.708512103691579
ZCTA5 62677,959,17,942,0.017726798748696558,-2.708512103691579
ZCTA5 43983,212,0,212,0,-2.7088338471426363
ZCTA5 42273,212,0,212,0,-2.7088338471426363
ZCTA5 45727,212,0,212,0,-2.7088338471426363
ZCTA5 61749,212,0,212,0,-2.7088338471426363
ZCTA5 01434,212,0,212,0,-2.7088338471426363
ZCTA5 12517,212,0,212,0,-2.7088338471426363
ZCTA5 05487,594,8,586,0.013468013468013467,-2.708865103803861
ZCTA5 54750,417,4,413,0.009592326139088728,-2.7097961324133952
ZCTA5 68443,417,4,413,0.009592326139088728,-2.7097961324133952
ZCTA5 04860,720,11,709,0.015277777777777777,-2.7123078261926974
ZCTA5 68941,321,2,319,0.006230529595015576,-2.7124586663344226
ZCTA5 97630,2139,49,2090,0.022907900888265546,-2.712505680667689
ZCTA5 83251,508,6,502,0.011811023622047244,-2.712795100471949
ZCTA5 53598,999,18,981,0.018018018018018018,-2.7132334952644497
ZCTA5 33070,2175,50,2125,0.022988505747126436,-2.7143313883359097
ZCTA5 41804,213,0,213,0,-2.7152150900185377
ZCTA5 41607,213,0,213,0,-2.7152150900185377
ZCTA5 47846,213,0,213,0,-2.7152150900185377
ZCTA5 68422,213,0,213,0,-2.7152150900185377
ZCTA5 68316,213,0,213,0,-2.7152150900185377
ZCTA5 71724,213,0,213,0,-2.7152150900185377
ZCTA5 88049,213,0,213,0,-2.7152150900185377
ZCTA5 79530,213,0,213,0,-2.7152150900185377
ZCTA5 83013,213,0,213,0,-2.7152150900185377
ZCTA5 05875,213,0,213,0,-2.7152150900185377
ZCTA5 05042,213,0,213,0,-2.7152150900185377
ZCTA5 12410,213,0,213,0,-2.7152150900185377
ZCTA5 12969,213,0,213,0,-2.7152150900185377
ZCTA5 15663,213,0,213,0,-2.7152150900185377
ZCTA5 21071,213,0,213,0,-2.7152150900185377
ZCTA5 25820,213,0,213,0,-2.7152150900185377
ZCTA5 66938,464,5,459,0.010775862068965518,-2.7166538499956525
ZCTA5 67009,371,3,368,0.008086253369272238,-2.717291700619171
ZCTA5 67480,638,9,629,0.014106583072100314,-2.717703504759924
ZCTA5 83837,1305,26,1279,0.01992337164750958,-2.7182811399506046
ZCTA5 18038,1154,22,1132,0.019064124783362217,-2.7185079357795714
ZCTA5 04348,1192,23,1169,0.01929530201342282,-2.718518178622586
ZCTA5 64001,270,1,269,0.003703703703703704,-2.7185665242255075
ZCTA5 98327,3631,92,3539,0.025337372624621317,-2.7199769394622866
ZCTA5 31815,803,13,790,0.0161892901618929,-2.720736456845958
ZCTA5 37694,803,13,790,0.0161892901618929,-2.720736456845958
ZCTA5 68025,12645,368,12277,0.029102412020561488,-2.7214177773359447
ZCTA5 05155,419,4,415,0.00954653937947494,-2.721498739305788
ZCTA5 87523,214,0,214,0,-2.7215813709502013
ZCTA5 58442,214,0,214,0,-2.7215813709502013
ZCTA5 63964,214,0,214,0,-2.7215813709502013
ZCTA5 63943,214,0,214,0,-2.7215813709502013
ZCTA5 65627,214,0,214,0,-2.7215813709502013
ZCTA5 61469,1001,18,983,0.017982017982017984,-2.722282160562458
ZCTA5 05043,465,5,460,0.010752688172043012,-2.7223587040783532
ZCTA5 76366,722,11,711,0.015235457063711912,-2.7223962041860315
ZCTA5 29639,372,3,369,0.008064516129032258,-2.7232828737405352
ZCTA5 13626,923,16,907,0.01733477789815818,-2.7234210836484007
ZCTA5 67133,2284,53,2231,0.023204903677758317,-2.7240014702428863
ZCTA5 59262,271,1,270,0.0036900369003690036,-2.7248474192591994
ZCTA5 64504,4175,108,4067,0.025868263473053894,-2.725859186369103
ZCTA5 73111,4679,123,4556,0.026287668305193416,-2.726162167243209
ZCTA5 40076,963,17,946,0.017653167185877467,-2.7268617637539805
ZCTA5 72727,2108,48,2060,0.022770398481973434,-2.727886319783606
ZCTA5 33856,215,0,215,0,-2.72793279468941
ZCTA5 38030,215,0,215,0,-2.72793279468941
ZCTA5 41604,215,0,215,0,-2.72793279468941
ZCTA5 67651,215,0,215,0,-2.72793279468941
ZCTA5 68322,215,0,215,0,-2.72793279468941
ZCTA5 15435,215,0,215,0,-2.72793279468941
ZCTA5 20618,215,0,215,0,-2.72793279468941
ZCTA5 18079,215,0,215,0,-2.72793279468941
ZCTA5 24634,215,0,215,0,-2.72793279468941
ZCTA5 23440,215,0,215,0,-2.72793279468941
ZCTA5 24836,215,0,215,0,-2.72793279468941
ZCTA5 67019,466,5,461,0.01072961373390558,-2.7280544470461234
ZCTA5 75092,9920,283,9637,0.028528225806451615,-2.7284466520930573
ZCTA5 32827,3498,88,3410,0.025157232704402517,-2.728946435537453
ZCTA5 18812,682,10,672,0.01466275659824047,-2.7290821913446126
ZCTA5 97346,373,3,370,0.00804289544235925,-2.7292628763520286
ZCTA5 29112,1604,34,1570,0.02119700748129676,-2.7299713248078947
ZCTA5 16124,805,13,792,0.016149068322981366,-2.7304688997546545
ZCTA5 04009,2286,53,2233,0.023184601924759404,-2.7305918782583465
ZCTA5 68424,324,2,322,0.006172839506172839,-2.730879028668227
ZCTA5 13844,272,1,271,0.003676470588235294,-2.7311144387697412
ZCTA5 57071,1195,23,1172,0.019246861924686193,-2.7312491772857883
ZCTA5 68642,724,11,713,0.015193370165745856,-2.732461890408787
ZCTA5 36751,216,0,216,0,-2.734269464771308
ZCTA5 39352,216,0,216,0,-2.734269464771308
ZCTA5 61485,216,0,216,0,-2.734269464771308
ZCTA5 66833,216,0,216,0,-2.734269464771308
ZCTA5 68368,216,0,216,0,-2.734269464771308
ZCTA5 67575,216,0,216,0,-2.734269464771308
ZCTA5 56218,216,0,216,0,-2.734269464771308
ZCTA5 72522,216,0,216,0,-2.734269464771308
ZCTA5 82725,216,0,216,0,-2.734269464771308
ZCTA5 81327,216,0,216,0,-2.734269464771308
ZCTA5 12045,216,0,216,0,-2.734269464771308
ZCTA5 25845,216,0,216,0,-2.734269464771308
ZCTA5 25818,216,0,216,0,-2.734269464771308
ZCTA5 99102,216,0,216,0,-2.734269464771308
ZCTA5 69152,374,3,371,0.008021390374331552,-2.7352317658633005
ZCTA5 54838,556,7,549,0.012589928057553957,-2.735928887467274
ZCTA5 56382,556,7,549,0.012589928057553957,-2.735928887467274
ZCTA5 13335,556,7,549,0.012589928057553957,-2.735928887467274
ZCTA5 18334,1569,33,1536,0.021032504780114723,-2.7362590669575835
ZCTA5 69165,766,12,754,0.015665796344647518,-2.73788821830032
ZCTA5 74037,6344,173,6171,0.027269861286254728,-2.7393117969897824
ZCTA5 97413,468,5,463,0.010683760683760684,-2.7394187548938884
ZCTA5 38642,807,13,794,0.0161090458488228,-2.7401814009514007
ZCTA5 17042,14699,432,14267,0.029389754405061568,-2.7403979258022773
ZCTA5 30471,1861,41,1820,0.02203116603976357,-2.740436088651485
ZCTA5 28330,217,0,217,0,-2.740591483534088
ZCTA5 31038,217,0,217,0,-2.740591483534088
ZCTA5 40052,217,0,217,0,-2.740591483534088
ZCTA5 42722,217,0,217,0,-2.740591483534088
ZCTA5 55738,217,0,217,0,-2.740591483534088
ZCTA5 58492,217,0,217,0,-2.740591483534088
ZCTA5 67151,217,0,217,0,-2.740591483534088
ZCTA5 56132,217,0,217,0,-2.740591483534088
ZCTA5 05253,217,0,217,0,-2.740591483534088
ZCTA5 24869,217,0,217,0,-2.740591483534088
ZCTA5 37365,375,3,372,0.008,-2.7411895992171074
ZCTA5 61853,4953,131,4822,0.026448616999798103,-2.7418560710827515
ZCTA5 59716,927,16,911,0.017259978425026967,-2.7419808351979786
ZCTA5 37091,8536,240,8296,0.028116213683223992,-2.7426590477201187
ZCTA5 62418,767,12,755,0.01564537157757497,-2.742820473345682
ZCTA5 07758,1423,29,1394,0.020379479971890373,-2.742834696483283
ZCTA5 12580,1644,35,1609,0.021289537712895375,-2.7429372502691516
ZCTA5 53526,274,1,273,0.0036496350364963502,-2.7436072065442336
ZCTA5 54138,423,4,419,0.009456264775413711,-2.744783541116933
ZCTA5 65710,469,5,464,0.010660980810234541,-2.7450873967569596
ZCTA5 87830,514,6,508,0.011673151750972763,-2.7461513425639414
ZCTA5 76239,514,6,508,0.011673151750972763,-2.7461513425639414
ZCTA5 14889,601,8,593,0.013311148086522463,-2.7461655792251607
ZCTA5 25514,1424,29,1395,0.020365168539325844,-2.7468015955238583
ZCTA5 36263,218,0,218,0,-2.746898952138279
ZCTA5 41838,218,0,218,0,-2.746898952138279
ZCTA5 47339,218,0,218,0,-2.746898952138279
ZCTA5 51062,218,0,218,0,-2.746898952138279
ZCTA5 87569,218,0,218,0,-2.746898952138279
ZCTA5 56043,218,0,218,0,-2.746898952138279
ZCTA5 70637,218,0,218,0,-2.746898952138279
ZCTA5 26264,218,0,218,0,-2.746898952138279
ZCTA5 97622,218,0,218,0,-2.746898952138279
ZCTA5 56119,376,3,373,0.007978723404255319,-2.7471364328944365
ZCTA5 74338,1899,42,1857,0.022116903633491312,-2.7474956895727383
ZCTA5 39073,7235,200,7035,0.027643400138217002,-2.748666320217826
ZCTA5 99027,2327,54,2273,0.023205844434894714,-2.7492714052545715
ZCTA5 79022,3369,84,3285,0.024933214603739984,-2.7504641526855185
ZCTA5 74062,424,4,420,0.009433962264150943,-2.750579927073015
ZCTA5 49821,602,8,594,0.013289036544850499,-2.7514663286736054
ZCTA5 28391,2257,52,2205,0.02303943287549845,-2.751569889326386
ZCTA5 36078,4857,128,4729,0.02635371628577311,-2.7519348823933854
ZCTA5 58204,728,11,717,0.01510989010989011,-2.7525257064230275
ZCTA5 41046,377,3,374,0.007957559681697613,-2.7530723229195684
ZCTA5 48656,1756,38,1718,0.02164009111617312,-2.753139303713037
ZCTA5 49710,219,0,219,0,-2.7531919705856285
ZCTA5 55366,219,0,219,0,-2.7531919705856285
ZCTA5 59930,219,0,219,0,-2.7531919705856285
ZCTA5 64449,219,0,219,0,-2.7531919705856285
ZCTA5 66431,219,0,219,0,-2.7531919705856285
ZCTA5 69032,219,0,219,0,-2.7531919705856285
ZCTA5 70516,219,0,219,0,-2.7531919705856285
ZCTA5 79544,219,0,219,0,-2.7531919705856285
ZCTA5 17982,219,0,219,0,-2.7531919705856285
ZCTA5 12167,1124,21,1103,0.018683274021352312,-2.7539463515732217
ZCTA5 44625,645,9,636,0.013953488372093023,-2.7541942279930227
ZCTA5 38748,1426,29,1397,0.020336605890603085,-2.7547280585737046
ZCTA5 75491,1793,39,1754,0.021751254880089235,-2.7558164736960693
ZCTA5 87104,5724,154,5570,0.026904262753319357,-2.75583601333939
ZCTA5 73527,1684,36,1648,0.021377672209026127,-2.7559926229495817
ZCTA5 16621,276,1,275,0.0036231884057971015,-2.7560455289760455
ZCTA5 78148,7860,219,7641,0.027862595419847327,-2.756859956611174
ZCTA5 46816,7501,208,7293,0.02772963604852686,-2.7572039085099425
ZCTA5 60460,516,6,510,0.011627906976744186,-2.7572043912369937
ZCTA5 84765,2081,47,2034,0.022585295530994715,-2.7573184761302016
ZCTA5 68045,729,11,718,0.015089163237311385,-2.7575276798240487
ZCTA5 43457,560,7,553,0.0125,-2.75758728820735
ZCTA5 27938,560,7,553,0.0125,-2.75758728820735
ZCTA5 60087,9517,270,9247,0.028370284753598825,-2.7581361446142205
ZCTA5 03440,1048,19,1029,0.01812977099236641,-2.7588588964747314
ZCTA5 54003,378,3,375,0.007936507936507936,-2.75899732486507
ZCTA5 62547,378,3,375,0.007936507936507936,-2.75899732486507
ZCTA5 48724,220,0,220,0,-2.759470637737603
ZCTA5 47858,220,0,220,0,-2.759470637737603
ZCTA5 62954,220,0,220,0,-2.759470637737603
ZCTA5 64493,220,0,220,0,-2.759470637737603
ZCTA5 67565,220,0,220,0,-2.759470637737603
ZCTA5 64689,220,0,220,0,-2.759470637737603
ZCTA5 68644,220,0,220,0,-2.759470637737603
ZCTA5 73562,220,0,220,0,-2.759470637737603
ZCTA5 77580,220,0,220,0,-2.759470637737603
ZCTA5 16623,220,0,220,0,-2.759470637737603
ZCTA5 15640,220,0,220,0,-2.759470637737603
ZCTA5 16745,220,0,220,0,-2.759470637737603
ZCTA5 97824,688,10,678,0.014534883720930232,-2.759713110333442
ZCTA5 28462,5394,144,5250,0.026696329254727477,-2.7601435585863507
ZCTA5 13691,1087,20,1067,0.01839926402943882,-2.7603125231471055
ZCTA5 24011,329,2,327,0.0060790273556231,-2.7613327641378893
ZCTA5 37714,1722,37,1685,0.02148664343786295,-2.7617667745739203
ZCTA5 92688,16081,475,15606,0.029537964056961633,-2.761811254902192
ZCTA5 38559,472,5,467,0.01059322033898305,-2.762039730656904
ZCTA5 16695,426,4,422,0.009389671361502348,-2.7621432418668928
ZCTA5 16692,277,1,276,0.0036101083032490976,-2.762244488420167
ZCTA5 95043,277,1,276,0.0036101083032490976,-2.762244488420167
ZCTA5 61062,730,11,719,0.015068493150684932,-2.7625240928127823
ZCTA5 02163,517,6,511,0.01160541586073501,-2.7627187411562155
ZCTA5 03447,1010,18,992,0.01782178217821782,-2.7628121647572574
ZCTA5 29821,561,7,554,0.012477718360071301,-2.762983210861366
ZCTA5 50006,689,10,679,0.01451378809869376,-2.7647973803970425
ZCTA5 05448,379,3,376,0.0079155672823219,-2.7649114938567143
ZCTA5 41274,221,0,221,0,-2.76573505133351
ZCTA5 50440,221,0,221,0,-2.76573505133351
ZCTA5 57054,221,0,221,0,-2.76573505133351
ZCTA5 57342,221,0,221,0,-2.76573505133351
ZCTA5 58765,221,0,221,0,-2.76573505133351
ZCTA5 62425,221,0,221,0,-2.76573505133351
ZCTA5 88350,221,0,221,0,-2.76573505133351
ZCTA5 83633,221,0,221,0,-2.76573505133351
ZCTA5 82210,221,0,221,0,-2.76573505133351
ZCTA5 04783,221,0,221,0,-2.76573505133351
ZCTA5 08350,221,0,221,0,-2.76573505133351
ZCTA5 14824,221,0,221,0,-2.76573505133351
ZCTA5 13813,221,0,221,0,-2.76573505133351
ZCTA5 14808,221,0,221,0,-2.76573505133351
ZCTA5 15949,221,0,221,0,-2.76573505133351
ZCTA5 15051,221,0,221,0,-2.76573505133351
ZCTA5 23897,221,0,221,0,-2.76573505133351
ZCTA5 86338,221,0,221,0,-2.76573505133351
ZCTA5 86426,6126,166,5960,0.027097616715638262,-2.7668063058370103
ZCTA5 27705,20198,605,19593,0.029953460738686998,-2.7668347328813785
ZCTA5 03882,605,8,597,0.013223140495867768,-2.76732726174369
ZCTA5 29105,427,4,423,0.00936768149882904,-2.767910260888006
ZCTA5 79052,427,4,423,0.00936768149882904,-2.767910260888006
ZCTA5 38948,972,17,955,0.01748971193415638,-2.767914169049118
ZCTA5 14615,7049,194,6855,0.02752163427436516,-2.7699572962289927
ZCTA5 42378,1128,21,1107,0.018617021276595744,-2.7712165866053864
ZCTA5 41632,222,0,222,0,-2.771985308008247
ZCTA5 60949,222,0,222,0,-2.771985308008247
ZCTA5 62089,222,0,222,0,-2.771985308008247
ZCTA5 63345,222,0,222,0,-2.771985308008247
ZCTA5 65285,222,0,222,0,-2.771985308008247
ZCTA5 68113,222,0,222,0,-2.771985308008247
ZCTA5 71630,222,0,222,0,-2.771985308008247
ZCTA5 73716,222,0,222,0,-2.771985308008247
ZCTA5 83554,222,0,222,0,-2.771985308008247
ZCTA5 12852,222,0,222,0,-2.771985308008247
ZCTA5 24580,222,0,222,0,-2.771985308008247
ZCTA5 23180,222,0,222,0,-2.771985308008247
ZCTA5 53515,973,17,956,0.017471736896197326,-2.7724557224811686
ZCTA5 98373,9072,256,8816,0.02821869488536155,-2.773175470052019
ZCTA5 49279,331,2,329,0.006042296072507553,-2.7734294771910935
ZCTA5 66449,428,4,424,0.009345794392523364,-2.7736675805718685
ZCTA5 81154,519,6,513,0.011560693641618497,-2.7737232495926403
ZCTA5 53941,1167,22,1145,0.018851756640959727,-2.77412210804642
ZCTA5 55793,279,1,278,0.0035842293906810036,-2.774602426501627
ZCTA5 36602,649,9,640,0.01386748844375963,-2.7749049886166683
ZCTA5 49836,381,3,378,0.007874015748031496,-2.7767075512766155
ZCTA5 06256,895,15,880,0.01675977653631285,-2.7774571932236722
ZCTA5 41630,607,8,599,0.013179571663920923,-2.777867019886732
ZCTA5 37078,223,0,223,0,-2.7782215033096938
ZCTA5 49971,223,0,223,0,-2.7782215033096938
ZCTA5 54927,223,0,223,0,-2.7782215033096938
ZCTA5 06266,223,0,223,0,-2.7782215033096938
ZCTA5 15661,223,0,223,0,-2.7782215033096938
ZCTA5 15337,223,0,223,0,-2.7782215033096938
ZCTA5 25928,223,0,223,0,-2.7782215033096938
ZCTA5 71601,5502,147,5355,0.026717557251908396,-2.7788822112666653
ZCTA5 76073,1944,43,1901,0.022119341563786008,-2.779260588746858
ZCTA5 63827,332,2,330,0.006024096385542169,-2.7794599376428417
ZCTA5 63333,332,2,330,0.006024096385542169,-2.7794599376428417
ZCTA5 19944,332,2,330,0.006024096385542169,-2.7794599376428417
ZCTA5 17097,332,2,330,0.006024096385542169,-2.7794599376428417
ZCTA5 01072,650,9,641,0.013846153846153847,-2.780066850064453
ZCTA5 72458,280,1,279,0.0035714285714285713,-2.780761571644219
ZCTA5 34472,10499,300,10199,0.02857414991903991,-2.780774588069022
ZCTA5 25882,856,14,842,0.016355140186915886,-2.7821049860034845
ZCTA5 76642,2408,56,2352,0.023255813953488372,-2.7830751771935693
ZCTA5 42350,608,8,600,0.013157894736842105,-2.783126708799805
ZCTA5 50072,936,16,920,0.017094017094017096,-2.7834955829885115
ZCTA5 84056,936,16,920,0.017094017094017096,-2.7834955829885115
ZCTA5 11557,2689,64,2625,0.0238006693938267,-2.7838571512877035
ZCTA5 64630,224,0,224,0,-2.7844437317157578
ZCTA5 56123,224,0,224,0,-2.7844437317157578
ZCTA5 73646,224,0,224,0,-2.7844437317157578
ZCTA5 21872,224,0,224,0,-2.7844437317157578
ZCTA5 61379,565,7,558,0.012389380530973451,-2.7844929980445428
ZCTA5 03851,1545,32,1513,0.020711974110032363,-2.785315340198248
ZCTA5 30445,1208,23,1185,0.01903973509933775,-2.786099525576655
ZCTA5 37329,2232,51,2181,0.0228494623655914,-2.786199383912976
ZCTA5 30117,13295,387,12908,0.029108687476494925,-2.7864628429514027
ZCTA5 61334,281,1,280,0.0035587188612099642,-2.7869076104478627
ZCTA5 67522,776,12,764,0.015463917525773196,-2.786975698022664
ZCTA5 97499,776,12,764,0.015463917525773196,-2.786975698022664
ZCTA5 28442,735,11,724,0.014965986394557823,-2.7874233019105272
ZCTA5 67342,383,3,380,0.007832898172323759,-2.788460927432431
ZCTA5 32656,5473,146,5327,0.026676411474511236,-2.7884768789862733
ZCTA5 54121,1360,27,1333,0.019852941176470587,-2.7894159656821707
ZCTA5 29138,3759,95,3664,0.02527267890396382,-2.789561781721017
ZCTA5 79339,2304,53,2251,0.023003472222222224,-2.789670891359914
ZCTA5 68863,477,5,472,0.010482180293501049,-2.7901172231911073
ZCTA5 85192,694,10,684,0.01440922190201729,-2.7901303000939186
ZCTA5 28528,225,0,225,0,-2.790652086651071
ZCTA5 30454,225,0,225,0,-2.790652086651071
ZCTA5 36013,225,0,225,0,-2.790652086651071
ZCTA5 41833,225,0,225,0,-2.790652086651071
ZCTA5 41847,225,0,225,0,-2.790652086651071
ZCTA5 47521,225,0,225,0,-2.790652086651071
ZCTA5 53553,225,0,225,0,-2.790652086651071
ZCTA5 59069,225,0,225,0,-2.790652086651071
ZCTA5 62994,225,0,225,0,-2.790652086651071
ZCTA5 71663,225,0,225,0,-2.790652086651071
ZCTA5 73647,225,0,225,0,-2.790652086651071
ZCTA5 24851,225,0,225,0,-2.790652086651071
ZCTA5 97447,225,0,225,0,-2.790652086651071
ZCTA5 43569,1094,20,1074,0.018281535648994516,-2.79084085118721
ZCTA5 27812,1094,20,1074,0.018281535648994516,-2.79084085118721
ZCTA5 52574,334,2,332,0.005988023952095809,-2.791485397959476
ZCTA5 83101,1323,26,1297,0.019652305366591082,-2.7917937449152146
ZCTA5 43933,736,11,725,0.014945652173913044,-2.7923866816726792
ZCTA5 38720,282,1,281,0.0035460992907801418,-2.793040624067369
ZCTA5 21223,8401,235,8166,0.027972860373765028,-2.7939540657927306
ZCTA5 64481,384,3,381,0.0078125,-2.7943217432397818
ZCTA5 45644,1840,40,1800,0.021739130434782608,-2.7945942435587257
ZCTA5 47137,567,7,560,0.012345679012345678,-2.795203920268434
ZCTA5 56336,653,9,644,0.013782542113323124,-2.7955147647657763
ZCTA5 47941,523,6,517,0.011472275334608031,-2.7956363705676677
ZCTA5 98372,9668,274,9394,0.028340918494000826,-2.795988383752958
ZCTA5 17876,859,14,845,0.01629802095459837,-2.7962857432582466
ZCTA5 54151,1511,31,1480,0.020516214427531435,-2.79681473193022
ZCTA5 41149,226,0,226,0,-2.796846660503356
ZCTA5 51049,226,0,226,0,-2.796846660503356
ZCTA5 59008,226,0,226,0,-2.796846660503356
ZCTA5 57381,226,0,226,0,-2.796846660503356
ZCTA5 61563,226,0,226,0,-2.796846660503356
ZCTA5 65283,226,0,226,0,-2.796846660503356
ZCTA5 68743,226,0,226,0,-2.796846660503356
ZCTA5 72392,226,0,226,0,-2.796846660503356
ZCTA5 72456,226,0,226,0,-2.796846660503356
ZCTA5 87006,226,0,226,0,-2.796846660503356
ZCTA5 02858,226,0,226,0,-2.796846660503356
ZCTA5 05874,226,0,226,0,-2.796846660503356
ZCTA5 08720,226,0,226,0,-2.796846660503356
ZCTA5 23307,226,0,226,0,-2.796846660503356
ZCTA5 23845,226,0,226,0,-2.796846660503356
ZCTA5 99023,226,0,226,0,-2.796846660503356
ZCTA5 33870,8728,245,8483,0.02807057745187901,-2.797042727045043
ZCTA5 62810,335,2,333,0.005970149253731343,-2.7974805286798166
ZCTA5 04456,1057,19,1038,0.017975402081362345,-2.798589858549904
ZCTA5 27890,1057,19,1038,0.017975402081362345,-2.798589858549904
ZCTA5 05656,1287,25,1262,0.019425019425019424,-2.798892727694513
ZCTA5 72928,283,1,282,0.0035335689045936395,-2.7991606928393935
ZCTA5 50118,385,3,382,0.007792207792207792,-2.800172047732563
ZCTA5 58274,385,3,382,0.007792207792207792,-2.800172047732563
ZCTA5 03237,900,15,885,0.016666666666666666,-2.8007385343933815
ZCTA5 97741,4137,106,4031,0.025622431713802272,-2.8013571038881233
ZCTA5 30601,9315,263,9052,0.02823403113258186,-2.801839379372283
ZCTA5 55409,4811,126,4685,0.026189981292870507,-2.8020293978598882
ZCTA5 55925,433,4,429,0.009237875288683603,-2.8023102277792344
ZCTA5 36474,1250,24,1226,0.0192,-2.8026089559023597
ZCTA5 03872,1250,24,1226,0.0192,-2.8026089559023597
ZCTA5 40819,227,0,227,0,-2.8030275446394697
ZCTA5 61811,227,0,227,0,-2.8030275446394697
ZCTA5 73564,227,0,227,0,-2.8030275446394697
ZCTA5 86331,227,0,227,0,-2.8030275446394697
ZCTA5 26714,227,0,227,0,-2.8030275446394697
ZCTA5 95420,227,0,227,0,-2.8030275446394697
ZCTA5 14471,1019,18,1001,0.017664376840039256,-2.8030372085663786
ZCTA5 49866,3147,77,3070,0.024467747060692723,-2.80351063613904
ZCTA5 26261,1097,20,1077,0.018231540565177756,-2.8038733989354965
ZCTA5 98051,1587,33,1554,0.020793950850661626,-2.80475903782963
ZCTA5 30354,6277,170,6107,0.02708300143380596,-2.8071376962929677
ZCTA5 21060,13085,380,12705,0.02904088651127245,-2.8074992231461082
ZCTA5 59457,4004,102,3902,0.025474525474525476,-2.80800609006945
ZCTA5 68349,434,4,430,0.009216589861751152,-2.808010270366442
ZCTA5 46573,1327,26,1301,0.019593067068575734,-2.80801150924907
ZCTA5 67567,228,0,228,0,-2.809194829421123
ZCTA5 87565,228,0,228,0,-2.809194829421123
ZCTA5 01032,228,0,228,0,-2.809194829421123
ZCTA5 04853,228,0,228,0,-2.809194829421123
ZCTA5 04662,228,0,228,0,-2.809194829421123
ZCTA5 05744,228,0,228,0,-2.809194829421123
ZCTA5 24935,228,0,228,0,-2.809194829421123
ZCTA5 24878,228,0,228,0,-2.809194829421123
ZCTA5 40177,613,8,605,0.013050570962479609,-2.80932415886455
ZCTA5 47468,613,8,605,0.013050570962479609,-2.80932415886455
ZCTA5 07823,3356,83,3273,0.024731823599523244,-2.8100328997938067
ZCTA5 37881,862,14,848,0.016241299303944315,-2.810425573166546
ZCTA5 21716,1953,43,1910,0.022017409114183307,-2.8107377293006355
ZCTA5 61342,3425,85,3340,0.024817518248175182,-2.8108834187797305
ZCTA5 05355,285,1,284,0.0035087719298245615,-2.8113623131646595
ZCTA5 56232,1060,19,1041,0.017924528301886792,-2.8117696233291487
ZCTA5 55047,1021,18,1003,0.01762977473065622,-2.811935265981417
ZCTA5 54491,740,11,729,0.014864864864864866,-2.8121858406043443
ZCTA5 37924,4782,125,4657,0.02613969050606441,-2.812911517725807
ZCTA5 45814,1138,21,1117,0.01845342706502636,-2.8141636195875583
ZCTA5 52049,614,8,606,0.013029315960912053,-2.8145436068745835
ZCTA5 52032,614,8,606,0.013029315960912053,-2.8145436068745835
ZCTA5 46069,2978,72,2906,0.0241773002014775,-2.8153388286842183
ZCTA5 32664,229,0,229,0,-2.8153486042202966
ZCTA5 38328,229,0,229,0,-2.8153486042202966
ZCTA5 43333,229,0,229,0,-2.8153486042202966
ZCTA5 08553,229,0,229,0,-2.8153486042202966
ZCTA5 22640,229,0,229,0,-2.8153486042202966
ZCTA5 24221,229,0,229,0,-2.8153486042202966
ZCTA5 47231,338,2,336,0.005917159763313609,-2.815396296102229
ZCTA5 79410,3939,100,3839,0.025387154100025386,-2.815615339308916
ZCTA5 83255,571,7,564,0.012259194395796848,-2.816538864998943
ZCTA5 72946,1479,30,1449,0.02028397565922921,-2.816709343683864
ZCTA5 80864,527,6,521,0.011385199240986717,-2.817423259781314
ZCTA5 62992,286,1,285,0.0034965034965034965,-2.8174440214014504
ZCTA5 78605,1991,44,1947,0.022099447513812154,-2.817593499607322
ZCTA5 63102,983,17,966,0.017293997965412006,-2.8176563135672996
ZCTA5 57790,388,3,385,0.007731958762886598,-2.817660412584434
ZCTA5 33954,3599,90,3509,0.025006946373992776,-2.818202149487995
ZCTA5 30553,3187,78,3109,0.02447442736115469,-2.8191741634462013
ZCTA5 28752,12035,347,11688,0.028832571665974242,-2.8195892701321528
ZCTA5 87529,1480,30,1450,0.02027027027027027,-2.820593561683348
ZCTA5 60654,12068,348,11720,0.02883659264169705,-2.820995809813068
ZCTA5 15920,339,2,337,0.0058997050147492625,-2.8213452217541573
ZCTA5 34762,230,0,230,0,-2.8214889574343496
ZCTA5 44653,230,0,230,0,-2.8214889574343496
ZCTA5 41660,230,0,230,0,-2.8214889574343496
ZCTA5 50451,230,0,230,0,-2.8214889574343496
ZCTA5 49115,230,0,230,0,-2.8214889574343496
ZCTA5 59231,230,0,230,0,-2.8214889574343496
ZCTA5 59261,230,0,230,0,-2.8214889574343496
ZCTA5 68439,230,0,230,0,-2.8214889574343496
ZCTA5 84022,230,0,230,0,-2.8214889574343496
ZCTA5 02534,230,0,230,0,-2.8214889574343496
ZCTA5 12791,230,0,230,0,-2.8214889574343496
ZCTA5 16927,230,0,230,0,-2.8214889574343496
ZCTA5 17606,230,0,230,0,-2.8214889574343496
ZCTA5 26562,230,0,230,0,-2.8214889574343496
ZCTA5 26169,230,0,230,0,-2.8214889574343496
ZCTA5 13092,984,17,967,0.017276422764227643,-2.8221550629789776
ZCTA5 53530,1775,38,1737,0.02140845070422535,-2.82226588016498
ZCTA5 60560,8286,231,8055,0.027878349022447502,-2.8226082967893404
ZCTA5 76462,1140,21,1119,0.018421052631578946,-2.8227142355660533
ZCTA5 71639,2385,55,2330,0.023060796645702306,-2.822715988212416
ZCTA5 13460,1848,40,1808,0.021645021645021644,-2.8231608803383748
ZCTA5 76844,1293,25,1268,0.019334880123743233,-2.8234344217833662
ZCTA5 32504,9199,259,8940,0.028155234264593976,-2.8263673837706453
ZCTA5 81524,743,11,732,0.014804845222072678,-2.8269785569139207
ZCTA5 24347,743,11,732,0.014804845222072678,-2.8269785569139207
ZCTA5 32449,231,0,231,0,-2.8276159765008355
ZCTA5 38380,231,0,231,0,-2.8276159765008355
ZCTA5 42565,231,0,231,0,-2.8276159765008355
ZCTA5 46039,231,0,231,0,-2.8276159765008355
ZCTA5 61876,231,0,231,0,-2.8276159765008355
ZCTA5 66710,231,0,231,0,-2.8276159765008355
ZCTA5 68736,231,0,231,0,-2.8276159765008355
ZCTA5 85920,231,0,231,0,-2.8276159765008355
ZCTA5 15731,231,0,231,0,-2.8276159765008355
ZCTA5 21662,231,0,231,0,-2.8276159765008355
ZCTA5 11937,6617,180,6437,0.027202659815626418,-2.8280310287291313
ZCTA5 32640,4317,111,4206,0.02571230020847811,-2.828814605895021
ZCTA5 66755,390,3,387,0.007692307692307693,-2.8292677107965196
ZCTA5 96113,390,3,387,0.007692307692307693,-2.8292677107965196
ZCTA5 64653,288,1,287,0.003472222222222222,-2.829569619910929
ZCTA5 46324,8355,233,8122,0.02788749251944943,-2.829688469913612
ZCTA5 46034,2739,65,2674,0.023731288791529755,-2.829812674994205
ZCTA5 43837,617,8,609,0.012965964343598054,-2.830162265171426
ZCTA5 72687,2564,60,2504,0.0234009360374415,-2.8309446314184923
ZCTA5 78109,11721,337,11384,0.02875181298524017,-2.8311860359672862
ZCTA5 74053,1631,34,1597,0.020846106683016553,-2.8316608884249077
ZCTA5 68524,2067,46,2021,0.022254475084663765,-2.83167010016433
ZCTA5 33868,3809,96,3713,0.02520346547650302,-2.831808263621104
ZCTA5 48084,6520,177,6343,0.02714723926380368,-2.8321123038796587
ZCTA5 77905,5359,142,5217,0.026497480873297258,-2.8321260328115114
ZCTA5 63939,574,7,567,0.012195121951219513,-2.8324648429943813
ZCTA5 73003,8845,248,8597,0.028038439796495195,-2.8325360770582924
ZCTA5 70032,1778,38,1740,0.021372328458942633,-2.833120283627111
ZCTA5 84752,341,2,339,0.005865102639296188,-2.8332089525719533
ZCTA5 98650,341,2,339,0.005865102639296188,-2.8332089525719533
ZCTA5 55705,1371,27,1344,0.019693654266958426,-2.8334730760666327
ZCTA5 62242,530,6,524,0.011320754716981131,-2.833681740696293
ZCTA5 48721,232,0,232,0,-2.833729747912029
ZCTA5 57373,232,0,232,0,-2.833729747912029
ZCTA5 67446,232,0,232,0,-2.833729747912029
ZCTA5 72739,232,0,232,0,-2.833729747912029
ZCTA5 87517,232,0,232,0,-2.833729747912029
ZCTA5 01258,232,0,232,0,-2.833729747912029
ZCTA5 12945,232,0,232,0,-2.833729747912029
ZCTA5 13776,232,0,232,0,-2.833729747912029
ZCTA5 18331,232,0,232,0,-2.833729747912029
ZCTA5 26222,232,0,232,0,-2.833729747912029
ZCTA5 97130,232,0,232,0,-2.833729747912029
ZCTA5 93517,232,0,232,0,-2.833729747912029
ZCTA5 63347,947,16,931,0.01689545934530095,-2.8337839445251043
ZCTA5 81620,3399,84,3315,0.02471315092674316,-2.834031936621919
ZCTA5 54156,703,10,693,0.01422475106685633,-2.8353636221325984
ZCTA5 43164,786,12,774,0.015267175572519083,-2.835549602893053
ZCTA5 31778,987,17,970,0.017223910840932118,-2.8356282963707167
ZCTA5 38730,827,13,814,0.015719467956469165,-2.8362319279427375
ZCTA5 24593,745,11,734,0.01476510067114094,-2.836813615582646
ZCTA5 07421,2637,62,2575,0.023511566173682216,-2.8393688473363774
ZCTA5 50603,233,0,233,0,-2.8398303572291734
ZCTA5 49736,233,0,233,0,-2.8398303572291734
ZCTA5 49752,233,0,233,0,-2.8398303572291734
ZCTA5 61411,233,0,233,0,-2.8398303572291734
ZCTA5 68778,233,0,233,0,-2.8398303572291734
ZCTA5 68852,233,0,233,0,-2.8398303572291734
ZCTA5 13162,233,0,233,0,-2.8398303572291734
ZCTA5 17840,233,0,233,0,-2.8398303572291734
ZCTA5 22436,233,0,233,0,-2.8398303572291734
ZCTA5 21082,233,0,233,0,-2.8398303572291734
ZCTA5 26237,233,0,233,0,-2.8398303572291734
ZCTA5 46791,392,3,389,0.007653061224489796,-2.840834190254835
ZCTA5 85207,17981,533,17448,0.029642400311439852,-2.8425346070839477
ZCTA5 16146,6029,162,5867,0.026870127716039145,-2.843044351054735
ZCTA5 56183,576,7,569,0.012152777777777778,-2.843046715944937
ZCTA5 04973,576,7,569,0.012152777777777778,-2.843046715944937
ZCTA5 76001,10116,287,9829,0.02837089758797944,-2.8432675019038736
ZCTA5 97378,2356,54,2302,0.022920203735144314,-2.8434525476791106
ZCTA5 56151,343,2,341,0.0058309037900874635,-2.845027598566335
ZCTA5 51054,2107,47,2060,0.022306597057427623,-2.845632611330265
ZCTA5 53057,620,8,612,0.012903225806451613,-2.8457218524002306
ZCTA5 52156,234,0,234,0,-2.8459178890964463
ZCTA5 54737,234,0,234,0,-2.8459178890964463
ZCTA5 57348,234,0,234,0,-2.8459178890964463
ZCTA5 65614,234,0,234,0,-2.8459178890964463
ZCTA5 15347,234,0,234,0,-2.8459178890964463
ZCTA5 17081,234,0,234,0,-2.8459178890964463
ZCTA5 25019,234,0,234,0,-2.8459178890964463
ZCTA5 24139,234,0,234,0,-2.8459178890964463
ZCTA5 40489,1598,33,1565,0.02065081351689612,-2.8462829029912813
ZCTA5 26410,393,3,390,0.007633587786259542,-2.846602247053184
ZCTA5 56762,1068,19,1049,0.017790262172284643,-2.846761558273001
ZCTA5 75563,1891,41,1850,0.02168164992067689,-2.846959433265139
ZCTA5 24171,3644,91,3553,0.024972557628979142,-2.8473104030514014
ZCTA5 36453,950,16,934,0.016842105263157894,-2.8474141527121515
ZCTA5 89442,441,4,437,0.009070294784580499,-2.8476498207748286
ZCTA5 06750,533,6,527,0.01125703564727955,-2.8498710854249962
ZCTA5 62690,1636,34,1602,0.02078239608801956,-2.8503286111765194
ZCTA5 61480,488,5,483,0.010245901639344262,-2.851131713363086
ZCTA5 48806,664,9,655,0.01355421686746988,-2.8516811986871833
ZCTA5 36556,235,0,235,0,-2.851992427254668
ZCTA5 40845,235,0,235,0,-2.851992427254668
ZCTA5 41667,235,0,235,0,-2.851992427254668
ZCTA5 41238,235,0,235,0,-2.851992427254668
ZCTA5 46175,235,0,235,0,-2.851992427254668
ZCTA5 50453,235,0,235,0,-2.851992427254668
ZCTA5 66554,235,0,235,0,-2.851992427254668
ZCTA5 67757,235,0,235,0,-2.851992427254668
ZCTA5 77560,235,0,235,0,-2.851992427254668
ZCTA5 12448,235,0,235,0,-2.851992427254668
ZCTA5 25565,235,0,235,0,-2.851992427254668
ZCTA5 26137,235,0,235,0,-2.851992427254668
ZCTA5 78063,3646,91,3555,0.024958859023587493,-2.8526915594680697
ZCTA5 04284,442,4,438,0.00904977375565611,-2.8532758589332206
ZCTA5 62828,534,6,528,0.011235955056179775,-2.8552523048083405
ZCTA5 47431,622,8,614,0.012861736334405145,-2.856062380463597
ZCTA5 36432,749,11,738,0.014686248331108143,-2.8564200610014585
ZCTA5 57034,345,2,343,0.005797101449275362,-2.8568016433164107
ZCTA5 30176,2748,65,2683,0.023653566229985445,-2.8571159072498484
ZCTA5 40348,236,0,236,0,-2.8580540545547373
ZCTA5 41234,236,0,236,0,-2.8580540545547373
ZCTA5 42214,236,0,236,0,-2.8580540545547373
ZCTA5 57072,236,0,236,0,-2.8580540545547373
ZCTA5 59433,236,0,236,0,-2.8580540545547373
ZCTA5 61472,236,0,236,0,-2.8580540545547373
ZCTA5 68621,236,0,236,0,-2.8580540545547373
ZCTA5 84305,236,0,236,0,-2.8580540545547373
ZCTA5 87519,236,0,236,0,-2.8580540545547373
ZCTA5 84324,236,0,236,0,-2.8580540545547373
ZCTA5 14082,236,0,236,0,-2.8580540545547373
ZCTA5 15641,236,0,236,0,-2.8580540545547373
ZCTA5 20667,236,0,236,0,-2.8580540545547373
ZCTA5 24808,236,0,236,0,-2.8580540545547373
ZCTA5 73949,579,7,572,0.012089810017271158,-2.8588668530402495
ZCTA5 13684,443,4,439,0.009029345372460496,-2.858892829977656
ZCTA5 13061,443,4,439,0.009029345372460496,-2.858892829977656
ZCTA5 67337,5137,135,5002,0.02627992992018688,-2.8595562212319483
ZCTA5 01431,1110,20,1090,0.018018018018018018,-2.859999222965112
ZCTA5 48864,9088,255,8833,0.028058978873239437,-2.860293033077997
ZCTA5 37880,1264,24,1240,0.0189873417721519,-2.8603053029176424
ZCTA5 03223,1378,27,1351,0.019593613933236574,-2.861349422980329
ZCTA5 65689,2076,46,2030,0.022157996146435453,-2.86227422928462
ZCTA5 49642,346,2,344,0.005780346820809248,-2.8626720890709954
ZCTA5 12563,2433,56,2377,0.02301685162351007,-2.863033533617679
ZCTA5 41159,237,0,237,0,-2.864102852970817
ZCTA5 47965,237,0,237,0,-2.864102852970817
ZCTA5 57552,237,0,237,0,-2.864102852970817
ZCTA5 71859,237,0,237,0,-2.864102852970817
ZCTA5 71847,237,0,237,0,-2.864102852970817
ZCTA5 78614,237,0,237,0,-2.864102852970817
ZCTA5 24459,237,0,237,0,-2.864102852970817
ZCTA5 24635,237,0,237,0,-2.864102852970817
ZCTA5 04548,444,4,440,0.009009009009009009,-2.8645007737302617
ZCTA5 94553,18949,563,18386,0.02971133041321442,-2.8652776799025617
ZCTA5 39427,536,6,530,0.011194029850746268,-2.865992071241358
ZCTA5 83341,2363,54,2309,0.022852306390181973,-2.866028280520367
ZCTA5 38482,624,8,616,0.01282051282051282,-2.8663770829273107
ZCTA5 61031,624,8,616,0.01282051282051282,-2.8663770829273107
ZCTA5 70437,3169,77,3092,0.024297885768381194,-2.866469309686016
ZCTA5 31320,3204,78,3126,0.024344569288389514,-2.867560078239516
ZCTA5 50529,347,2,345,0.005763688760806916,-2.8685315621105594
ZCTA5 64018,347,2,345,0.005763688760806916,-2.8685315621105594
ZCTA5 32702,1151,21,1130,0.018245004344048653,-2.869514774323636
ZCTA5 49650,1151,21,1130,0.018245004344048653,-2.869514774323636
ZCTA5 48426,397,3,394,0.007556675062972292,-2.8695743930168667
ZCTA5 28745,238,0,238,0,-2.870138903613268
ZCTA5 28663,238,0,238,0,-2.870138903613268
ZCTA5 28575,238,0,238,0,-2.870138903613268
ZCTA5 30818,238,0,238,0,-2.870138903613268
ZCTA5 52305,238,0,238,0,-2.870138903613268
ZCTA5 57238,238,0,238,0,-2.870138903613268
ZCTA5 71759,238,0,238,0,-2.870138903613268
ZCTA5 73667,238,0,238,0,-2.870138903613268
ZCTA5 77369,238,0,238,0,-2.870138903613268
ZCTA5 83867,238,0,238,0,-2.870138903613268
ZCTA5 05359,238,0,238,0,-2.870138903613268
ZCTA5 07311,238,0,238,0,-2.870138903613268
ZCTA5 23129,238,0,238,0,-2.870138903613268
ZCTA5 26761,238,0,238,0,-2.870138903613268
ZCTA5 98280,238,0,238,0,-2.870138903613268
ZCTA5 45359,710,10,700,0.014084507042253521,-2.8702264656589644
ZCTA5 46504,1343,26,1317,0.0193596425912137,-2.8724608431100016
ZCTA5 73141,1074,19,1055,0.017690875232774673,-2.872860055797937
ZCTA5 49268,492,5,487,0.01016260162601626,-2.87306804392367
ZCTA5 65338,1152,21,1131,0.018229166666666668,-2.873750413179048
ZCTA5 28530,2613,61,2552,0.023344814389590508,-2.8738211374087963
ZCTA5 70086,835,13,822,0.015568862275449102,-2.874118887042875
ZCTA5 47597,348,2,346,0.005747126436781609,-2.87438012058237
ZCTA5 48470,348,2,346,0.005747126436781609,-2.87438012058237
ZCTA5 55781,348,2,346,0.005747126436781609,-2.87438012058237
ZCTA5 08732,582,7,575,0.012027491408934709,-2.874624369959006
ZCTA5 21750,1494,30,1464,0.020080321285140562,-2.8747324344707756
ZCTA5 29474,876,14,862,0.01598173515981735,-2.875878951745801
ZCTA5 32079,239,0,239,0,-2.87616228674134
ZCTA5 51543,239,0,239,0,-2.87616228674134
ZCTA5 58254,239,0,239,0,-2.87616228674134
ZCTA5 59452,239,0,239,0,-2.87616228674134
ZCTA5 62860,239,0,239,0,-2.87616228674134
ZCTA5 82212,239,0,239,0,-2.87616228674134
ZCTA5 05853,239,0,239,0,-2.87616228674134
ZCTA5 12857,239,0,239,0,-2.87616228674134
ZCTA5 13841,239,0,239,0,-2.87616228674134
ZCTA5 10926,1306,25,1281,0.01914241960183767,-2.8762716261840824
ZCTA5 91006,10459,297,10162,0.028396596232909455,-2.876452909156887
ZCTA5 76401,10265,291,9974,0.028348757915245982,-2.87660463700031
ZCTA5 80452,1569,32,1537,0.020395156150414276,-2.8766540780477885
ZCTA5 55037,1936,42,1894,0.02169421487603306,-2.877560204138538
ZCTA5 87579,296,1,295,0.0033783783783783786,-2.8775787376411555
ZCTA5 23958,1230,23,1207,0.01869918699186992,-2.8777744491753676
ZCTA5 05408,3997,101,3896,0.025268951713785338,-2.877827096813606
ZCTA5 32693,4405,113,4292,0.02565266742338252,-2.8795112342208116
ZCTA5 73098,1644,34,1610,0.02068126520681265,-2.8800924385583566
ZCTA5 58463,349,2,347,0.0057306590257879654,-2.880217822139326
ZCTA5 16136,349,2,347,0.0057306590257879654,-2.880217822139326
ZCTA5 38922,1307,25,1282,0.019127773527161437,-2.8803171634888365
ZCTA5 54013,1345,26,1319,0.019330855018587362,-2.8804701197356133
ZCTA5 04943,754,11,743,0.014588859416445624,-2.8808099371123723
ZCTA5 61606,2225,50,2175,0.02247191011235955,-2.8808656789432328
ZCTA5 60960,399,3,396,0.007518796992481203,-2.881001088533945
ZCTA5 56737,399,3,396,0.007518796992481203,-2.881001088533945
ZCTA5 49945,1115,20,1095,0.017937219730941704,-2.8814372758050433
ZCTA5 26624,1115,20,1095,0.017937219730941704,-2.8814372758050433
ZCTA5 73439,3105,75,3030,0.024154589371980676,-2.881781303550782
ZCTA5 49640,627,8,619,0.012759170653907496,-2.8818010810645127
ZCTA5 35544,240,0,240,0,-2.88217308177562
ZCTA5 41503,240,0,240,0,-2.88217308177562
ZCTA5 55712,240,0,240,0,-2.88217308177562
ZCTA5 58571,240,0,240,0,-2.88217308177562
ZCTA5 62469,240,0,240,0,-2.88217308177562
ZCTA5 04671,240,0,240,0,-2.88217308177562
ZCTA5 25121,240,0,240,0,-2.88217308177562
ZCTA5 25985,240,0,240,0,-2.88217308177562
ZCTA5 89821,240,0,240,0,-2.88217308177562
ZCTA5 97371,240,0,240,0,-2.88217308177562
ZCTA5 30473,1037,18,1019,0.017357762777242044,-2.8825949215171254
ZCTA5 24589,1037,18,1019,0.017357762777242044,-2.8825949215171254
ZCTA5 56014,297,1,296,0.003367003367003367,-2.8835255815236995
ZCTA5 87823,297,1,296,0.003367003367003367,-2.8835255815236995
ZCTA5 47648,1682,35,1647,0.020808561236623068,-2.8841550861596073
ZCTA5 49689,584,7,577,0.011986301369863013,-2.885094913757261
ZCTA5 17959,584,7,577,0.011986301369863013,-2.885094913757261
ZCTA5 63339,350,2,348,0.005714285714285714,-2.8860447239456817
ZCTA5 75438,350,2,348,0.005714285714285714,-2.8860447239456817
ZCTA5 71838,400,3,397,0.0075,-2.886699757195466
ZCTA5 48370,628,8,620,0.012738853503184714,-2.886929682102364
ZCTA5 71219,540,6,534,0.011111111111111112,-2.887381700992734
ZCTA5 36439,241,0,241,0,-2.8881713673102523
ZCTA5 50151,241,0,241,0,-2.8881713673102523
ZCTA5 58052,241,0,241,0,-2.8881713673102523
ZCTA5 62633,241,0,241,0,-2.8881713673102523
ZCTA5 62543,241,0,241,0,-2.8881713673102523
ZCTA5 63760,241,0,241,0,-2.8881713673102523
ZCTA5 64771,241,0,241,0,-2.8881713673102523
ZCTA5 12838,241,0,241,0,-2.8881713673102523
ZCTA5 16859,241,0,241,0,-2.8881713673102523
ZCTA5 18980,241,0,241,0,-2.8881713673102523
ZCTA5 18248,241,0,241,0,-2.8881713673102523
ZCTA5 22976,241,0,241,0,-2.8881713673102523
ZCTA5 25836,241,0,241,0,-2.8881713673102523
ZCTA5 55030,495,5,490,0.010101010101010102,-2.889434642391536
ZCTA5 47469,714,10,704,0.014005602240896359,-2.8900253315444533
ZCTA5 46536,1156,21,1135,0.018166089965397925,-2.8906616856002327
ZCTA5 97463,1684,35,1649,0.020783847980997625,-2.891509100217538
ZCTA5 56027,351,2,349,0.005698005698005698,-2.891860882682687
ZCTA5 56723,351,2,349,0.005698005698005698,-2.891860882682687
ZCTA5 46135,6879,187,6692,0.027184183747637737,-2.8919973248353448
ZCTA5 47928,839,13,826,0.015494636471990465,-2.8929511408078707
ZCTA5 76351,839,13,826,0.015494636471990465,-2.8929511408078707
ZCTA5 63377,798,12,786,0.015037593984962405,-2.8931793330373563
ZCTA5 28579,242,0,242,0,-2.8941572211249293
ZCTA5 50234,242,0,242,0,-2.8941572211249293
ZCTA5 59434,242,0,242,0,-2.8941572211249293
ZCTA5 58276,242,0,242,0,-2.8941572211249293
ZCTA5 58227,242,0,242,0,-2.8941572211249293
ZCTA5 76875,242,0,242,0,-2.8941572211249293
ZCTA5 79063,242,0,242,0,-2.8941572211249293
ZCTA5 20129,242,0,242,0,-2.8941572211249293
ZCTA5 25243,242,0,242,0,-2.8941572211249293
ZCTA5 26293,242,0,242,0,-2.8941572211249293
ZCTA5 23968,242,0,242,0,-2.8941572211249293
ZCTA5 98946,242,0,242,0,-2.8941572211249293
ZCTA5 28454,880,14,866,0.015909090909090907,-2.8944215156239825
ZCTA5 38052,1648,34,1614,0.02063106796116505,-2.8949264652988584
ZCTA5 49402,586,7,579,0.011945392491467578,-2.8955381056024367
ZCTA5 49130,630,8,622,0.012698412698412698,-2.8971679101265604
ZCTA5 12168,921,15,906,0.016286644951140065,-2.8973613303432098
ZCTA5 16045,450,4,446,0.008888888888888889,-2.8979610587764872
ZCTA5 92339,450,4,446,0.008888888888888889,-2.8979610587764872
ZCTA5 72857,542,6,536,0.01107011070110701,-2.8980320077387356
ZCTA5 75146,6783,184,6599,0.027126640129736104,-2.8981022637855403
ZCTA5 93010,15798,463,15335,0.029307507279402456,-2.8984861202752485
ZCTA5 85623,2159,48,2111,0.0222325150532654,-2.8996758394397095
ZCTA5 55735,716,10,706,0.013966480446927373,-2.8998917027016824
ZCTA5 49066,243,0,243,0,-2.9001307201966555
ZCTA5 62015,243,0,243,0,-2.9001307201966555
ZCTA5 68938,243,0,243,0,-2.9001307201966555
ZCTA5 56281,243,0,243,0,-2.9001307201966555
ZCTA5 77661,243,0,243,0,-2.9001307201966555
ZCTA5 17272,243,0,243,0,-2.9001307201966555
ZCTA5 23962,243,0,243,0,-2.9001307201966555
ZCTA5 25873,243,0,243,0,-2.9001307201966555
ZCTA5 99167,243,0,243,0,-2.9001307201966555
ZCTA5 01368,497,5,492,0.01006036217303823,-2.900305410473719
ZCTA5 72556,1312,25,1287,0.019054878048780487,-2.9005048459462515
ZCTA5 04354,631,8,623,0.012678288431061807,-2.9022775779058185
ZCTA5 43749,1002,17,985,0.016966067864271458,-2.9024835509872027
ZCTA5 01237,1002,17,985,0.016966067864271458,-2.9024835509872027
ZCTA5 32703,17678,522,17156,0.029528227175019798,-2.902902574026226
ZCTA5 30678,543,6,537,0.011049723756906077,-2.903346129821199
ZCTA5 53803,543,6,537,0.011049723756906077,-2.903346129821199
ZCTA5 66857,451,4,447,0.008869179600886918,-2.903506903691498
ZCTA5 62515,403,3,400,0.007444168734491315,-2.9037376027503057
ZCTA5 49091,7904,218,7686,0.02758097165991903,-2.9038029897535758
ZCTA5 55362,6951,189,6762,0.027190332326283987,-2.9042419065359613
ZCTA5 37845,244,0,244,0,-2.9060919407113004
ZCTA5 50167,244,0,244,0,-2.9060919407113004
ZCTA5 68464,244,0,244,0,-2.9060919407113004
ZCTA5 68342,244,0,244,0,-2.9060919407113004
ZCTA5 56185,244,0,244,0,-2.9060919407113004
ZCTA5 14878,244,0,244,0,-2.9060919407113004
ZCTA5 22811,244,0,244,0,-2.9060919407113004
ZCTA5 21864,244,0,244,0,-2.9060919407113004
ZCTA5 99153,244,0,244,0,-2.9060919407113004
ZCTA5 66783,1003,17,986,0.01694915254237288,-2.9069106952485497
ZCTA5 69122,301,1,300,0.0033222591362126247,-2.9071953332503586
ZCTA5 56673,301,1,300,0.0033222591362126247,-2.9071953332503586
ZCTA5 72653,12702,366,12336,0.028814359943316013,-2.908083221737323
ZCTA5 76230,4111,104,4007,0.02529798102651423,-2.9082275914046565
ZCTA5 71237,544,6,538,0.011029411764705883,-2.908652933763695
ZCTA5 27025,4586,118,4468,0.02573048408198866,-2.908769041356845
ZCTA5 77568,5660,150,5510,0.026501766784452298,-2.9087826521774156
ZCTA5 63055,1043,18,1025,0.01725790987535954,-2.9088556655019953
ZCTA5 78233,16920,498,16422,0.029432624113475178,-2.909142026164797
ZCTA5 50557,354,2,352,0.005649717514124294,-2.909245460161161
ZCTA5 52749,354,2,352,0.005649717514124294,-2.909245460161161
ZCTA5 41640,404,3,401,0.007425742574257425,-2.909397650195033
ZCTA5 65648,2234,50,2184,0.022381378692927483,-2.910482274345902
ZCTA5 40218,13602,394,13208,0.02896632848110572,-2.910782287370141
ZCTA5 22652,589,7,582,0.011884550084889643,-2.9111520192058085
ZCTA5 30903,245,0,245,0,-2.912040958074933
ZCTA5 37340,245,0,245,0,-2.912040958074933
ZCTA5 40863,245,0,245,0,-2.912040958074933
ZCTA5 41663,245,0,245,0,-2.912040958074933
ZCTA5 46162,245,0,245,0,-2.912040958074933
ZCTA5 46950,245,0,245,0,-2.912040958074933
ZCTA5 50271,245,0,245,0,-2.912040958074933
ZCTA5 65250,245,0,245,0,-2.912040958074933
ZCTA5 84723,245,0,245,0,-2.912040958074933
ZCTA5 15754,245,0,245,0,-2.912040958074933
ZCTA5 18327,245,0,245,0,-2.912040958074933
ZCTA5 26690,245,0,245,0,-2.912040958074933
ZCTA5 25875,245,0,245,0,-2.912040958074933
ZCTA5 26563,245,0,245,0,-2.912040958074933
ZCTA5 26590,245,0,245,0,-2.912040958074933
ZCTA5 15052,1315,25,1290,0.019011406844106463,-2.9125856079395005
ZCTA5 28392,590,7,583,0.011864406779661017,-2.9163431835139395
ZCTA5 54723,500,5,495,0.01,-2.9165517546355937
ZCTA5 18210,2768,65,2703,0.02348265895953757,-2.9174983603320923
ZCTA5 74421,1728,36,1692,0.020833333333333332,-2.9176009601542265
ZCTA5 38352,246,0,246,0,-2.9179778469249507
ZCTA5 47866,246,0,246,0,-2.9179778469249507
ZCTA5 52222,246,0,246,0,-2.9179778469249507
ZCTA5 87061,246,0,246,0,-2.9179778469249507
ZCTA5 15315,246,0,246,0,-2.9179778469249507
ZCTA5 24185,246,0,246,0,-2.9179778469249507
ZCTA5 39648,7879,217,7662,0.027541566188602616,-2.9186586481572268
ZCTA5 43332,720,10,710,0.013888888888888888,-2.9195589523427015
ZCTA5 42355,762,11,751,0.014435695538057743,-2.919564825559299
ZCTA5 54761,454,4,450,0.00881057268722467,-2.920092277411901
ZCTA5 72437,1355,26,1329,0.01918819188191882,-2.920362506795092
ZCTA5 41175,2021,44,1977,0.02177140029688273,-2.920754601500375
ZCTA5 64456,591,7,584,0.011844331641285956,-2.921527649383724
ZCTA5 17502,1046,18,1028,0.017208413001912046,-2.921938451910131
ZCTA5 40004,11682,334,11348,0.02859099469268961,-2.9231342377769396
ZCTA5 37731,247,0,247,0,-2.9239026811410076
ZCTA5 46731,247,0,247,0,-2.9239026811410076
ZCTA5 63471,247,0,247,0,-2.9239026811410076
ZCTA5 68413,247,0,247,0,-2.9239026811410076
ZCTA5 71855,247,0,247,0,-2.9239026811410076
ZCTA5 72550,247,0,247,0,-2.9239026811410076
ZCTA5 75448,247,0,247,0,-2.9239026811410076
ZCTA5 78944,247,0,247,0,-2.9239026811410076
ZCTA5 01037,247,0,247,0,-2.9239026811410076
ZCTA5 14113,247,0,247,0,-2.9239026811410076
ZCTA5 24873,247,0,247,0,-2.9239026811410076
ZCTA5 98572,247,0,247,0,-2.9239026811410076
ZCTA5 79101,1164,21,1143,0.01804123711340206,-2.9243352594377616
ZCTA5 97538,763,11,752,0.014416775884665793,-2.9243862100251956
ZCTA5 50063,927,15,912,0.016181229773462782,-2.9246323507896057
ZCTA5 72064,1086,19,1067,0.017495395948434623,-2.9246893607147673
ZCTA5 62621,455,4,451,0.008791208791208791,-2.9256034722464195
ZCTA5 04952,846,13,833,0.015366430260047281,-2.9257319507634656
ZCTA5 44305,9548,268,9280,0.028068705488060328,-2.926502637551572
ZCTA5 67344,357,2,355,0.0056022408963585435,-2.92653534532349
ZCTA5 06268,3536,87,3449,0.024604072398190045,-2.926652976449238
ZCTA5 47384,679,9,670,0.013254786450662739,-2.9271019985446447
ZCTA5 63771,1165,21,1144,0.018025751072961373,-2.9285306003725236
ZCTA5 14098,1165,21,1144,0.018025751072961373,-2.9285306003725236
ZCTA5 43522,1319,25,1294,0.018953752843062926,-2.9286563755776966
ZCTA5 17834,1583,32,1551,0.02021478205938092,-2.929369232103307
ZCTA5 31557,1204,22,1182,0.018272425249169437,-2.9295461643843232
ZCTA5 29333,248,0,248,0,-2.929815533855736
ZCTA5 32212,248,0,248,0,-2.929815533855736
ZCTA5 36317,248,0,248,0,-2.929815533855736
ZCTA5 59648,248,0,248,0,-2.929815533855736
ZCTA5 62877,248,0,248,0,-2.929815533855736
ZCTA5 06785,248,0,248,0,-2.929815533855736
ZCTA5 12863,248,0,248,0,-2.929815533855736
ZCTA5 12778,248,0,248,0,-2.929815533855736
ZCTA5 15957,248,0,248,0,-2.929815533855736
ZCTA5 19492,248,0,248,0,-2.929815533855736
ZCTA5 25011,248,0,248,0,-2.929815533855736
ZCTA5 58482,456,4,452,0.008771929824561403,-2.931106096886313
ZCTA5 96044,456,4,452,0.008771929824561403,-2.931106096886313
ZCTA5 21226,2312,52,2260,0.02249134948096886,-2.931450125415951
ZCTA5 95666,2312,52,2260,0.02249134948096886,-2.931450125415951
ZCTA5 62014,1658,34,1624,0.020506634499396863,-2.93187319228191
ZCTA5 39862,593,7,586,0.011804384485666104,-2.931876576974263
ZCTA5 79358,408,3,405,0.007352941176470588,-2.9319428667491274
ZCTA5 38256,1320,25,1295,0.01893939393939394,-2.932667503907148
ZCTA5 89508,4461,114,4347,0.025554808338937456,-2.9341047829350826
ZCTA5 88317,723,10,713,0.013831258644536652,-2.9342525732101414
ZCTA5 81067,2313,52,2261,0.02248162559446606,-2.93468472452263
ZCTA5 14806,848,13,835,0.015330188679245283,-2.935057276615721
ZCTA5 37050,549,6,543,0.01092896174863388,-2.9350781156489623
ZCTA5 52619,249,0,249,0,-2.935716477465283
ZCTA5 58710,249,0,249,0,-2.935716477465283
ZCTA5 63039,249,0,249,0,-2.935716477465283
ZCTA5 79054,249,0,249,0,-2.935716477465283
ZCTA5 77376,249,0,249,0,-2.935716477465283
ZCTA5 04464,249,0,249,0,-2.935716477465283
ZCTA5 14872,249,0,249,0,-2.935716477465283
ZCTA5 15698,249,0,249,0,-2.935716477465283
ZCTA5 19536,249,0,249,0,-2.935716477465283
ZCTA5 23857,249,0,249,0,-2.935716477465283
ZCTA5 24132,249,0,249,0,-2.935716477465283
ZCTA5 51248,807,12,795,0.01486988847583643,-2.9359424933954688
ZCTA5 48466,594,7,587,0.011784511784511785,-2.9370410839766476
ZCTA5 13660,594,7,587,0.011784511784511785,-2.9370410839766476
ZCTA5 45380,1917,41,1876,0.02138758476786646,-2.938065303968877
ZCTA5 07921,3781,94,3687,0.024861147844485586,-2.9384372980330453
ZCTA5 29456,10626,301,10325,0.028326745718050064,-2.93936846033906
ZCTA5 37408,849,13,836,0.015312131919905771,-2.9397132249139344
ZCTA5 97836,808,12,796,0.01485148514851485,-2.940670121343659
ZCTA5 36511,250,0,250,0,-2.9416055836396513
ZCTA5 36738,250,0,250,0,-2.9416055836396513
ZCTA5 65333,250,0,250,0,-2.9416055836396513
ZCTA5 24484,250,0,250,0,-2.9416055836396513
ZCTA5 93665,250,0,250,0,-2.9416055836396513
ZCTA5 56358,1284,24,1260,0.018691588785046728,-2.941780693421942
ZCTA5 56554,1090,19,1071,0.01743119266055046,-2.941858403048747
ZCTA5 04986,682,9,673,0.013196480938416423,-2.9420289137478646
ZCTA5 41844,458,4,454,0.008733624454148471,-2.9420857810732524
ZCTA5 56324,458,4,454,0.008733624454148471,-2.9420857810732524
ZCTA5 51036,307,1,306,0.003257328990228013,-2.9423544494252556
ZCTA5 63846,639,8,631,0.012519561815336464,-2.942930862903949
ZCTA5 31007,410,3,407,0.007317073170731708,-2.9431591088210522
ZCTA5 68874,410,3,407,0.007317073170731708,-2.9431591088210522
ZCTA5 21849,1323,25,1298,0.01889644746787604,-2.944685203974586
ZCTA5 49237,1130,20,1110,0.017699115044247787,-2.945265693584112
ZCTA5 52155,596,7,589,0.01174496644295302,-2.947350296704547
ZCTA5 45340,251,0,251,0,-2.947482923332851
ZCTA5 47120,251,0,251,0,-2.947482923332851
ZCTA5 59919,251,0,251,0,-2.947482923332851
ZCTA5 61453,251,0,251,0,-2.947482923332851
ZCTA5 62349,251,0,251,0,-2.947482923332851
ZCTA5 64780,251,0,251,0,-2.947482923332851
ZCTA5 18915,251,0,251,0,-2.947482923332851
ZCTA5 24726,251,0,251,0,-2.947482923332851
ZCTA5 23085,251,0,251,0,-2.947482923332851
ZCTA5 24811,251,0,251,0,-2.947482923332851
ZCTA5 59324,459,4,455,0.008714596949891068,-2.947562912757395
ZCTA5 40511,12374,355,12019,0.028689187005010507,-2.947723817092139
ZCTA5 00901,2743,64,2679,0.023332118118847976,-2.948139398702332
ZCTA5 62244,411,3,408,0.0072992700729927005,-2.9487532904604383
ZCTA5 95757,13852,401,13451,0.028948888247184522,-2.948824961074148
ZCTA5 67570,506,5,501,0.009881422924901186,-2.9488322262911364
ZCTA5 15829,506,5,501,0.009881422924901186,-2.9488322262911364
ZCTA5 97020,361,2,359,0.00554016620498615,-2.949443736654424
ZCTA5 53946,1737,36,1701,0.02072538860103627,-2.950207698663126
ZCTA5 53502,1013,17,996,0.01678183613030602,-2.950980472036279
ZCTA5 53080,2390,54,2336,0.022594142259414227,-2.9525428256695685
ZCTA5 59910,252,0,252,0,-2.953348566792882
ZCTA5 57428,252,0,252,0,-2.953348566792882
ZCTA5 61532,252,0,252,0,-2.953348566792882
ZCTA5 61418,252,0,252,0,-2.953348566792882
ZCTA5 88065,252,0,252,0,-2.953348566792882
ZCTA5 01012,252,0,252,0,-2.953348566792882
ZCTA5 15633,252,0,252,0,-2.953348566792882
ZCTA5 25267,252,0,252,0,-2.953348566792882
ZCTA5 24082,252,0,252,0,-2.953348566792882
ZCTA5 03222,2283,51,2232,0.022339027595269383,-2.9534813622734393
ZCTA5 44672,1958,42,1916,0.021450459652706845,-2.9538461342830966
ZCTA5 32814,3165,76,3089,0.02401263823064771,-2.9539022069448215
ZCTA5 42647,1287,24,1263,0.018648018648018648,-2.9539077809503604
ZCTA5 62807,309,1,308,0.003236245954692557,-2.953984095345694
ZCTA5 15470,309,1,308,0.003236245954692557,-2.953984095345694
ZCTA5 51234,507,5,502,0.009861932938856016,-2.9541851530096506
ZCTA5 49623,412,3,409,0.007281553398058253,-2.954338236280352
ZCTA5 13325,412,3,409,0.007281553398058253,-2.954338236280352
ZCTA5 27511,13760,398,13362,0.028924418604651163,-2.954978596209626
ZCTA5 60918,362,2,360,0.0055248618784530384,-2.95514532985794
ZCTA5 47513,974,16,958,0.01642710472279261,-2.95518348238852
ZCTA5 29851,2816,66,2750,0.0234375,-2.9560125877221677
ZCTA5 63336,553,6,547,0.0108499095840868,-2.9560892324453003
ZCTA5 53208,11993,343,11650,0.028600016676394564,-2.9562942140155646
ZCTA5 83254,1440,28,1412,0.019444444444444445,-2.956490452877101
ZCTA5 66502,17719,522,17197,0.029459901800327332,-2.956845290860245
ZCTA5 62476,685,9,676,0.013138686131386862,-2.9569045125318096
ZCTA5 95252,5011,130,4881,0.02594292556375973,-2.956935368514264
ZCTA5 49128,1478,29,1449,0.01962110960757781,-2.957475316043282
ZCTA5 46031,853,13,840,0.015240328253223915,-2.9582925088142358
ZCTA5 54423,894,14,880,0.015659955257270694,-2.958779975103752
ZCTA5 37171,253,0,253,0,-2.959202583571522
ZCTA5 52217,253,0,253,0,-2.959202583571522
ZCTA5 62871,253,0,253,0,-2.959202583571522
ZCTA5 66416,253,0,253,0,-2.959202583571522
ZCTA5 68982,253,0,253,0,-2.959202583571522
ZCTA5 67622,253,0,253,0,-2.959202583571522
ZCTA5 03751,253,0,253,0,-2.959202583571522
ZCTA5 03853,253,0,253,0,-2.959202583571522
ZCTA5 10527,253,0,253,0,-2.959202583571522
ZCTA5 14885,253,0,253,0,-2.959202583571522
ZCTA5 20625,253,0,253,0,-2.959202583571522
ZCTA5 17265,253,0,253,0,-2.959202583571522
ZCTA5 18616,253,0,253,0,-2.959202583571522
ZCTA5 21766,253,0,253,0,-2.959202583571522
ZCTA5 25666,253,0,253,0,-2.959202583571522
ZCTA5 62995,1591,32,1559,0.02011313639220616,-2.9593088877616065
ZCTA5 81062,310,1,309,0.0032258064516129032,-2.959782315514335
ZCTA5 98315,1250,23,1227,0.0184,-2.9599015014068946
ZCTA5 29018,1173,21,1152,0.017902813299232736,-2.961983618036252
ZCTA5 17859,1134,20,1114,0.01763668430335097,-2.9621653924770377
ZCTA5 55109,13220,381,12839,0.02881996974281392,-2.9632009770054974
ZCTA5 83318,5985,159,5826,0.026566416040100252,-2.963315230099917
ZCTA5 04422,462,4,458,0.008658008658008658,-2.9639438939578695
ZCTA5 75010,11482,327,11155,0.028479358996690473,-2.9645271493361114
ZCTA5 47974,509,5,504,0.009823182711198428,-2.964868004271242
ZCTA5 17812,509,5,504,0.009823182711198428,-2.964868004271242
ZCTA5 40202,2678,62,2616,0.02315160567587752,-2.9649482206157933
ZCTA5 31629,254,0,254,0,-2.965045042533953
ZCTA5 50516,254,0,254,0,-2.965045042533953
ZCTA5 58651,254,0,254,0,-2.965045042533953
ZCTA5 48822,1056,18,1038,0.017045454545454544,-2.965321527915586
ZCTA5 48456,311,1,310,0.003215434083601286,-2.9655695491994027
ZCTA5 64436,311,1,310,0.003215434083601286,-2.9655695491994027
ZCTA5 26146,311,1,310,0.003215434083601286,-2.9655695491994027
ZCTA5 95726,3343,81,3262,0.024229733772061023,-2.966025662308585
ZCTA5 37317,1174,21,1153,0.01788756388415673,-2.966151614051262
ZCTA5 58438,364,2,362,0.005494505494505495,-2.966518271274331
ZCTA5 23410,687,9,678,0.013100436681222707,-2.966793295581537
ZCTA5 24311,772,11,761,0.014248704663212436,-2.96755260388065
ZCTA5 85730,15369,448,14921,0.02914958683063309,-2.967734610960798
ZCTA5 84312,1443,28,1415,0.019404019404019403,-2.9681083099323877
ZCTA5 81423,644,8,636,0.012422360248447204,-2.9681398797813547
ZCTA5 38562,2502,57,2445,0.022781774580335732,-2.9687384463815696
ZCTA5 61847,463,4,459,0.008639308855291577,-2.9693875338574953
ZCTA5 72373,463,4,459,0.008639308855291577,-2.9693875338574953
ZCTA5 02639,1519,30,1489,0.019749835418038184,-2.9703149559543642
ZCTA5 37019,255,0,255,0,-2.9708760118682114
ZCTA5 38061,255,0,255,0,-2.9708760118682114
ZCTA5 54524,255,0,255,0,-2.9708760118682114
ZCTA5 57450,255,0,255,0,-2.9708760118682114
ZCTA5 65773,255,0,255,0,-2.9708760118682114
ZCTA5 88341,255,0,255,0,-2.9708760118682114
ZCTA5 84301,255,0,255,0,-2.9708760118682114
ZCTA5 14478,255,0,255,0,-2.9708760118682114
ZCTA5 16343,255,0,255,0,-2.9708760118682114
ZCTA5 26576,255,0,255,0,-2.9708760118682114
ZCTA5 66015,312,1,311,0.003205128205128205,-2.9713458572360114
ZCTA5 68460,312,1,311,0.003205128205128205,-2.9713458572360114
ZCTA5 55732,688,9,679,0.01308139534883721,-2.971729252658217
ZCTA5 31535,4136,104,4032,0.025145067698259187,-2.9717458564284307
ZCTA5 54107,1368,26,1342,0.019005847953216373,-2.9718439045566516
ZCTA5 60915,3725,92,3633,0.024697986577181207,-2.9719744537708883
ZCTA5 71008,365,2,363,0.005479452054794521,-2.972189720835165
ZCTA5 54209,601,7,594,0.011647254575707155,-2.9730088555823992
ZCTA5 75432,1292,24,1268,0.018575851393188854,-2.9740658137229214
ZCTA5 79373,1137,20,1117,0.01759014951627089,-2.9748071312711004
ZCTA5 27855,2397,54,2343,0.02252816020025031,-2.974828298394092
ZCTA5 01039,511,5,506,0.009784735812133072,-2.9755203832632175
ZCTA5 36043,1445,28,1417,0.019377162629757784,-2.975841917469295
ZCTA5 66713,2146,47,2099,0.02190121155638397,-2.9762828387132583
ZCTA5 38901,7152,194,6958,0.027125279642058166,-2.9765276232023274
ZCTA5 71325,416,3,413,0.007211538461538462,-2.976586505560696
ZCTA5 76704,3173,76,3097,0.023952095808383235,-2.976598284585941
ZCTA5 87571,4614,118,4496,0.025574338968357174,-2.9766188023865725
ZCTA5 54865,256,0,256,0,-2.976695559094475
ZCTA5 57471,256,0,256,0,-2.976695559094475
ZCTA5 62013,256,0,256,0,-2.976695559094475
ZCTA5 72412,256,0,256,0,-2.976695559094475
ZCTA5 80481,256,0,256,0,-2.976695559094475
ZCTA5 12503,256,0,256,0,-2.976695559094475
ZCTA5 24351,256,0,256,0,-2.976695559094475
ZCTA5 25245,256,0,256,0,-2.976695559094475
ZCTA5 25107,256,0,256,0,-2.976695559094475
ZCTA5 26376,256,0,256,0,-2.976695559094475
ZCTA5 98220,256,0,256,0,-2.976695559094475
ZCTA5 54141,857,13,844,0.015169194865810968,-2.976801096814099
ZCTA5 67731,313,1,312,0.003194888178913738,-2.9771112999092497
ZCTA5 47140,1019,17,1002,0.016683022571148183,-2.9772484017552974
ZCTA5 33637,6258,167,6091,0.026685842122083733,-2.9776072097325152
ZCTA5 85306,8860,246,8614,0.02776523702031603,-2.97794644601732
ZCTA5 47561,646,8,638,0.01238390092879257,-2.9781812393057012
ZCTA5 70748,1559,31,1528,0.019884541372674792,-2.979591362185804
ZCTA5 03037,1671,34,1637,0.020347097546379412,-2.9796119104919176
ZCTA5 41141,690,9,681,0.013043478260869565,-2.981584381134036
ZCTA5 36569,257,0,257,0,-2.982503751074183
ZCTA5 58771,257,0,257,0,-2.982503751074183
ZCTA5 57365,257,0,257,0,-2.982503751074183
ZCTA5 04475,257,0,257,0,-2.982503751074183
ZCTA5 13473,257,0,257,0,-2.982503751074183
ZCTA5 22720,257,0,257,0,-2.982503751074183
ZCTA5 26270,257,0,257,0,-2.982503751074183
ZCTA5 23138,257,0,257,0,-2.982503751074183
ZCTA5 25978,257,0,257,0,-2.982503751074183
ZCTA5 26278,257,0,257,0,-2.982503751074183
ZCTA5 13830,2292,51,2241,0.02225130890052356,-2.982651287676223
ZCTA5 53544,314,1,313,0.0031847133757961785,-2.9828659369610264
ZCTA5 05655,1217,22,1195,0.018077239112571898,-2.983186053001098
ZCTA5 46985,603,7,596,0.011608623548922056,-2.9832269494188446
ZCTA5 52563,603,7,596,0.011608623548922056,-2.9832269494188446
ZCTA5 81130,367,2,365,0.005449591280653951,-2.983502827968955
ZCTA5 48657,3384,82,3302,0.024231678486997636,-2.9835294249392805
ZCTA5 45887,1635,33,1602,0.02018348623853211,-2.984131264408995
ZCTA5 35648,1256,23,1233,0.018312101910828025,-2.984320331119269
ZCTA5 31094,466,4,462,0.008583690987124463,-2.9856688788433647
ZCTA5 71461,900,14,886,0.015555555555555555,-2.9861095769872987
ZCTA5 54621,513,5,508,0.009746588693957114,-2.9861425242390554
ZCTA5 51245,559,6,553,0.01073345259391771,-2.9873947131588525
ZCTA5 67752,559,6,553,0.01073345259391771,-2.9873947131588525
ZCTA5 50472,941,15,926,0.015940488841657812,-2.98770260458431
ZCTA5 75462,4449,113,4336,0.025398966059788718,-2.987962678939518
ZCTA5 43548,258,0,258,0,-2.988300654018998
ZCTA5 42028,258,0,258,0,-2.988300654018998
ZCTA5 61567,258,0,258,0,-2.988300654018998
ZCTA5 63942,258,0,258,0,-2.988300654018998
ZCTA5 95251,258,0,258,0,-2.988300654018998
ZCTA5 58653,315,1,314,0.0031746031746031746,-2.988609827596811
ZCTA5 72131,1895,40,1855,0.021108179419525065,-2.9887974708930676
ZCTA5 53929,1101,19,1082,0.01725703905540418,-2.9888011912711527
ZCTA5 56120,368,2,366,0.005434782608695652,-2.9891445844582702
ZCTA5 72834,3594,88,3506,0.02448525319977741,-2.99017097349208
ZCTA5 44666,1022,17,1005,0.016634050880626222,-2.9903340852473974
ZCTA5 15724,901,14,887,0.01553829078801332,-2.9906500151019753
ZCTA5 54754,777,11,766,0.014157014157014158,-2.9913604456510376
ZCTA5 62935,735,10,725,0.013605442176870748,-2.992548719292055
ZCTA5 35755,259,0,259,0,-2.9940863334996153
ZCTA5 41268,259,0,259,0,-2.9940863334996153
ZCTA5 48853,259,0,259,0,-2.9940863334996153
ZCTA5 50672,259,0,259,0,-2.9940863334996153
ZCTA5 58544,259,0,259,0,-2.9940863334996153
ZCTA5 57219,259,0,259,0,-2.9940863334996153
ZCTA5 68436,259,0,259,0,-2.9940863334996153
ZCTA5 67481,259,0,259,0,-2.9940863334996153
ZCTA5 71004,259,0,259,0,-2.9940863334996153
ZCTA5 14126,259,0,259,0,-2.9940863334996153
ZCTA5 23110,259,0,259,0,-2.9940863334996153
ZCTA5 25111,259,0,259,0,-2.9940863334996153
ZCTA5 25154,259,0,259,0,-2.9940863334996153
ZCTA5 58081,369,2,367,0.005420054200542005,-2.9947765415135024
ZCTA5 61919,369,2,367,0.005420054200542005,-2.9947765415135024
ZCTA5 68004,369,2,367,0.005420054200542005,-2.9947765415135024
ZCTA5 36206,4486,114,4372,0.02541239411502452,-2.995360048020129
ZCTA5 35019,820,12,808,0.014634146341463415,-2.997036758962782
ZCTA5 15759,1103,19,1084,0.017225747960108794,-2.9972938362311767
ZCTA5 52201,561,6,555,0.0106951871657754,-2.9977743574401945
ZCTA5 68862,1298,24,1274,0.01848998459167951,-2.9981673956128034
ZCTA5 52316,606,7,599,0.01155115511551155,-2.998506061091979
ZCTA5 04434,420,3,417,0.007142857142857143,-2.9986903419566855
ZCTA5 55074,862,13,849,0.015081206496519721,-2.999838456156587
ZCTA5 67425,260,0,260,0,-2.9998608544544143
ZCTA5 71441,260,0,260,0,-2.9998608544544143
ZCTA5 87829,260,0,260,0,-2.9998608544544143
ZCTA5 13454,260,0,260,0,-2.9998608544544143
ZCTA5 23844,260,0,260,0,-2.9998608544544143
ZCTA5 99125,260,0,260,0,-2.9998608544544143
ZCTA5 55333,317,1,316,0.0031545741324921135,-3.000065603799768
ZCTA5 87521,370,2,368,0.005405405405405406,-3.0003987476094096
ZCTA5 59070,370,2,368,0.005405405405405406,-3.0003987476094096
ZCTA5 43527,779,11,768,0.014120667522464698,-3.000849375503634
ZCTA5 13736,779,11,768,0.014120667522464698,-3.000849375503634
ZCTA5 03254,1714,35,1679,0.020420070011668612,-3.0009050082192332
ZCTA5 14507,469,4,465,0.008528784648187633,-3.0018765799890224
ZCTA5 24138,737,10,727,0.013568521031207599,-3.002191513585727
ZCTA5 67735,2334,52,2282,0.022279348757497857,-3.0023218138750853
ZCTA5 30345,9982,280,9702,0.028050490883590462,-3.002395214170023
ZCTA5 83832,562,6,556,0.010676156583629894,-3.0029538811621452
ZCTA5 47125,607,7,600,0.011532125205930808,-3.0035863754910577
ZCTA5 27979,607,7,600,0.011532125205930808,-3.0035863754910577
ZCTA5 94020,607,7,600,0.011532125205930808,-3.0035863754910577
ZCTA5 27105,14755,428,14327,0.029007116231785837,-3.004089614747565
ZCTA5 59086,421,3,418,0.007125890736342043,-3.0041940386902692
ZCTA5 83539,863,13,850,0.015063731170336037,-3.004432916599539
ZCTA5 28511,261,0,261,0,-3.005624281197963
ZCTA5 38848,261,0,261,0,-3.005624281197963
ZCTA5 58384,261,0,261,0,-3.005624281197963
ZCTA5 87527,261,0,261,0,-3.005624281197963
ZCTA5 68859,261,0,261,0,-3.005624281197963
ZCTA5 01718,261,0,261,0,-3.005624281197963
ZCTA5 02826,261,0,261,0,-3.005624281197963
ZCTA5 18471,261,0,261,0,-3.005624281197963
ZCTA5 21810,261,0,261,0,-3.005624281197963
ZCTA5 13334,371,2,369,0.005390835579514825,-3.006011250835076
ZCTA5 48454,470,4,466,0.00851063829787234,-3.0072629392624717
ZCTA5 62376,470,4,466,0.00851063829787234,-3.0072629392624717
ZCTA5 14894,470,4,466,0.00851063829787234,-3.0072629392624717
ZCTA5 29053,6671,179,6492,0.026832558836756108,-3.0076513874903874
ZCTA5 00983,13764,397,13367,0.02884335948852078,-3.008293656408738
ZCTA5 49633,1567,31,1536,0.019783024888321635,-3.0095742293860965
ZCTA5 74825,781,11,770,0.014084507042253521,-3.0103189134352637
ZCTA5 53543,696,9,687,0.01293103448275862,-3.0110166644934724
ZCTA5 13616,823,12,811,0.014580801944106925,-3.011024575385876
ZCTA5 29848,262,0,262,0,-3.0113766774293733
ZCTA5 34215,262,0,262,0,-3.0113766774293733
ZCTA5 42236,262,0,262,0,-3.0113766774293733
ZCTA5 52078,262,0,262,0,-3.0113766774293733
ZCTA5 68935,262,0,262,0,-3.0113766774293733
ZCTA5 68454,262,0,262,0,-3.0113766774293733
ZCTA5 05742,262,0,262,0,-3.0113766774293733
ZCTA5 15433,262,0,262,0,-3.0113766774293733
ZCTA5 20680,262,0,262,0,-3.0113766774293733
ZCTA5 26716,262,0,262,0,-3.0113766774293733
ZCTA5 51639,372,2,370,0.005376344086021506,-3.0116140988980975
ZCTA5 52766,372,2,370,0.005376344086021506,-3.0116140988980975
ZCTA5 69123,372,2,370,0.005376344086021506,-3.0116140988980975
ZCTA5 23413,372,2,370,0.005376344086021506,-3.0116140988980975
ZCTA5 12981,1027,17,1010,0.016553067185978577,-3.012072713379513
ZCTA5 80530,1606,32,1574,0.019925280199252802,-3.0150923881737373
ZCTA5 05143,1829,38,1791,0.02077638053581192,-3.0152008968295934
ZCTA5 07457,1829,38,1791,0.02077638053581192,-3.0152008968295934
ZCTA5 62262,697,9,688,0.01291248206599713,-3.0159028049478875
ZCTA5 40826,263,0,263,0,-3.017118106240518
ZCTA5 65054,263,0,263,0,-3.017118106240518
ZCTA5 72742,263,0,263,0,-3.017118106240518
ZCTA5 04564,263,0,263,0,-3.017118106240518
ZCTA5 03609,263,0,263,0,-3.017118106240518
ZCTA5 15623,263,0,263,0,-3.017118106240518
ZCTA5 25266,263,0,263,0,-3.017118106240518
ZCTA5 56029,320,1,319,0.003125,-3.0171701200034886
ZCTA5 99130,373,2,371,0.005361930294906166,-3.0172073391287144
ZCTA5 38645,519,5,514,0.009633911368015413,-3.0178298195836097
ZCTA5 26337,472,4,468,0.00847457627118644,-3.018011545714868
ZCTA5 75457,2303,51,2252,0.02214502822405558,-3.018163843485068
ZCTA5 42129,2837,66,2771,0.02326401127952062,-3.018402456346737
ZCTA5 47320,1532,30,1502,0.0195822454308094,-3.0194770484403013
ZCTA5 61914,783,11,772,0.0140485312899106,-3.019769161527773
ZCTA5 29638,1148,20,1128,0.017421602787456445,-3.0209205956367517
ZCTA5 70357,1069,18,1051,0.01683816651075772,-3.0212081573186023
ZCTA5 41764,264,0,264,0,-3.0228486301241038
ZCTA5 47535,264,0,264,0,-3.0228486301241038
ZCTA5 55763,264,0,264,0,-3.0228486301241038
ZCTA5 66851,264,0,264,0,-3.0228486301241038
ZCTA5 68527,264,0,264,0,-3.0228486301241038
ZCTA5 79059,264,0,264,0,-3.0228486301241038
ZCTA5 87582,264,0,264,0,-3.0228486301241038
ZCTA5 07976,264,0,264,0,-3.0228486301241038
ZCTA5 18830,264,0,264,0,-3.0228486301241038
ZCTA5 25031,264,0,264,0,-3.0228486301241038
ZCTA5 70584,2909,68,2841,0.023375730491577863,-3.022955267773025
ZCTA5 63751,520,5,515,0.009615384615384616,-3.0230852096943237
ZCTA5 43462,473,4,469,0.008456659619450317,-3.0233738586623122
ZCTA5 47541,473,4,469,0.008456659619450317,-3.0233738586623122
ZCTA5 56282,611,7,604,0.011456628477905073,-3.0238445778863685
ZCTA5 31781,784,11,773,0.01403061224489796,-3.0244870835584488
ZCTA5 84049,2088,45,2043,0.021551724137931036,-3.0245969130747183
ZCTA5 39663,1149,20,1129,0.017406440382941687,-3.025094232156366
ZCTA5 45160,425,3,422,0.007058823529411765,-3.0261209689794866
ZCTA5 75852,425,3,422,0.007058823529411765,-3.0261209689794866
ZCTA5 79042,425,3,422,0.007058823529411765,-3.0261209689794866
ZCTA5 42262,3086,73,3013,0.023655217109526897,-3.0272221663407475
ZCTA5 00780,4021,100,3921,0.02486943546381497,-3.0273390869982952
ZCTA5 54922,521,5,516,0.009596928982725527,-3.0283332953165387
ZCTA5 66548,375,2,373,0.005333333333333333,-3.0283651835512466
ZCTA5 04623,375,2,373,0.005333333333333333,-3.0283651835512466
ZCTA5 56214,322,1,321,0.003105590062111801,-3.0285210260233306
ZCTA5 51020,265,0,265,0,-3.028568310981605
ZCTA5 87821,265,0,265,0,-3.028568310981605
ZCTA5 64427,265,0,265,0,-3.028568310981605
ZCTA5 68401,265,0,265,0,-3.028568310981605
ZCTA5 05766,265,0,265,0,-3.028568310981605
ZCTA5 18371,265,0,265,0,-3.028568310981605
ZCTA5 24850,265,0,265,0,-3.028568310981605
ZCTA5 27965,265,0,265,0,-3.028568310981605
ZCTA5 97486,265,0,265,0,-3.028568310981605
ZCTA5 97065,265,0,265,0,-3.028568310981605
ZCTA5 20853,9802,274,9528,0.027953478881860845,-3.0286146578259827
ZCTA5 12992,1981,42,1939,0.02120141342756184,-3.0327876508352745
ZCTA5 55614,1151,20,1131,0.01737619461337967,-3.0334323361120505
ZCTA5 46764,522,5,517,0.009578544061302681,-3.033574103943296
ZCTA5 83353,568,6,562,0.01056338028169014,-3.0338883651514754
ZCTA5 85205,17300,507,16793,0.02930635838150289,-3.033985710346533
ZCTA5 54473,1072,18,1054,0.016791044776119403,-3.034024379498131
ZCTA5 45771,1307,24,1283,0.018362662586074982,-3.034141607311354
ZCTA5 46133,323,1,322,0.0030959752321981426,-3.0341810144968533
ZCTA5 56129,323,1,322,0.0030959752321981426,-3.0341810144968533
ZCTA5 49894,266,0,266,0,-3.0342772101310667
ZCTA5 57312,266,0,266,0,-3.0342772101310667
ZCTA5 65264,266,0,266,0,-3.0342772101310667
ZCTA5 87549,266,0,266,0,-3.0342772101310667
ZCTA5 85322,266,0,266,0,-3.0342772101310667
ZCTA5 12412,266,0,266,0,-3.0342772101310667
ZCTA5 15331,266,0,266,0,-3.0342772101310667
ZCTA5 16726,266,0,266,0,-3.0342772101310667
ZCTA5 24483,266,0,266,0,-3.0342772101310667
ZCTA5 72936,5516,144,5372,0.02610587382160986,-3.0350553685871495
ZCTA5 75803,6052,160,5892,0.026437541308658295,-3.0356102693902365
ZCTA5 05462,744,10,734,0.013440860215053764,-3.0357797160752904
ZCTA5 24085,870,13,857,0.014942528735632184,-3.0364739577419715
ZCTA5 05148,427,3,424,0.00702576112412178,-3.0370322659423996
ZCTA5 46545,11236,318,10918,0.02830188679245283,-3.037214245548339
ZCTA5 35503,3473,84,3389,0.02418658220558595,-3.037287944605965
ZCTA5 33603,8467,233,8234,0.027518601629857094,-3.037358431368445
ZCTA5 03043,658,8,650,0.0121580547112462,-3.037932370814233
ZCTA5 55945,523,5,518,0.009560229445506692,-3.0388076629050986
ZCTA5 24868,523,5,518,0.009560229445506692,-3.0388076629050986
ZCTA5 15423,829,12,817,0.014475271411338963,-3.0388777795444053
ZCTA5 65281,993,16,977,0.016112789526686808,-3.0389490971284556
ZCTA5 12125,614,7,607,0.011400651465798045,-3.038972600343156
ZCTA5 73084,2738,63,2675,0.023009495982468955,-3.0393314124175843
ZCTA5 05738,476,4,472,0.008403361344537815,-3.03941322655415
ZCTA5 39656,267,0,267,0,-3.0399753883147755
ZCTA5 42753,267,0,267,0,-3.0399753883147755
ZCTA5 55787,267,0,267,0,-3.0399753883147755
ZCTA5 62880,267,0,267,0,-3.0399753883147755
ZCTA5 62942,267,0,267,0,-3.0399753883147755
ZCTA5 64461,267,0,267,0,-3.0399753883147755
ZCTA5 67552,267,0,267,0,-3.0399753883147755
ZCTA5 05866,267,0,267,0,-3.0399753883147755
ZCTA5 21542,267,0,267,0,-3.0399753883147755
ZCTA5 21402,267,0,267,0,-3.0399753883147755
ZCTA5 23879,267,0,267,0,-3.0399753883147755
ZCTA5 98581,267,0,267,0,-3.0399753883147755
ZCTA5 84701,2915,68,2847,0.023327615780445968,-3.0405176043664706
ZCTA5 32736,3370,81,3289,0.024035608308605343,-3.040649374646253
ZCTA5 54771,1538,30,1508,0.01950585175552666,-3.0420449945414716
ZCTA5 62546,659,8,651,0.012139605462822459,-3.0428737642068064
ZCTA5 53093,788,11,777,0.013959390862944163,-3.0433110511832613
ZCTA5 03071,1837,38,1799,0.020685900925421885,-3.0433538509927107
ZCTA5 15222,2526,57,2469,0.022565320665083134,-3.043441609504584
ZCTA5 49043,830,12,818,0.014457831325301205,-3.0435042417482134
ZCTA5 62974,615,7,608,0.011382113821138212,-3.0440028826177596
ZCTA5 16317,524,5,519,0.009541984732824428,-3.044033999371211
ZCTA5 54644,570,6,564,0.010526315789473684,-3.0441460839272345
ZCTA5 35130,1232,22,1210,0.017857142857142856,-3.0444758867576343
ZCTA5 58533,477,4,473,0.008385744234800839,-3.044743932695677
ZCTA5 08403,477,4,473,0.008385744234800839,-3.044743932695677
ZCTA5 27054,913,14,899,0.015334063526834611,-3.044816911871611
ZCTA5 35464,268,0,268,0,-3.0456629057067968
ZCTA5 44308,268,0,268,0,-3.0456629057067968
ZCTA5 67445,268,0,268,0,-3.0456629057067968
ZCTA5 72079,268,0,268,0,-3.0456629057067968
ZCTA5 87742,268,0,268,0,-3.0456629057067968
ZCTA5 11547,268,0,268,0,-3.0456629057067968
ZCTA5 20617,268,0,268,0,-3.0456629057067968
ZCTA5 27943,268,0,268,0,-3.0456629057067968
ZCTA5 27917,268,0,268,0,-3.0456629057067968
ZCTA5 97627,268,0,268,0,-3.0456629057067968
ZCTA5 29601,5319,138,5181,0.025944726452340666,-3.0457235993292584
ZCTA5 80536,1035,17,1018,0.01642512077294686,-3.046672319569458
ZCTA5 55709,1577,31,1546,0.019657577679137603,-3.046865780144256
ZCTA5 30728,7584,206,7378,0.027162447257383968,-3.0471046018824626
ZCTA5 62433,429,3,426,0.006993006993006993,-3.047909193378636
ZCTA5 45660,2847,66,2781,0.023182297154899896,-3.0479642617722864
ZCTA5 43521,1115,19,1096,0.017040358744394617,-3.047980018912398
ZCTA5 95814,6425,171,6254,0.0266147859922179,-3.0487494891283826
ZCTA5 67202,1036,17,1019,0.016409266409266408,-3.050981652319718
ZCTA5 36115,269,0,269,0,-3.051339821920392
ZCTA5 47861,269,0,269,0,-3.051339821920392
ZCTA5 47590,269,0,269,0,-3.051339821920392
ZCTA5 64483,269,0,269,0,-3.051339821920392
ZCTA5 65069,269,0,269,0,-3.051339821920392
ZCTA5 73735,269,0,269,0,-3.051339821920392
ZCTA5 12768,269,0,269,0,-3.051339821920392
ZCTA5 14717,269,0,269,0,-3.051339821920392
ZCTA5 24872,269,0,269,0,-3.051339821920392
ZCTA5 26384,269,0,269,0,-3.051339821920392
ZCTA5 26151,269,0,269,0,-3.051339821920392
ZCTA5 61723,996,16,980,0.01606425702811245,-3.0520539540480547
ZCTA5 86332,832,12,820,0.014423076923076924,-3.0527437766008108
ZCTA5 54835,430,3,427,0.0069767441860465115,-3.053334862929642
ZCTA5 13673,915,14,901,0.015300546448087432,-3.0537882376877707
ZCTA5 55769,1037,17,1020,0.01639344262295082,-3.0552875378025326
ZCTA5 62074,479,4,475,0.008350730688935281,-3.055381910976874
ZCTA5 52057,3271,78,3193,0.023845918679302965,-3.055985999843811
ZCTA5 44490,380,2,378,0.005263157894736842,-3.0560948997855566
ZCTA5 59911,3584,87,3497,0.024274553571428572,-3.0561554204857933
ZCTA5 38957,270,0,270,0,-3.0570061960153057
ZCTA5 42764,270,0,270,0,-3.0570061960153057
ZCTA5 46915,270,0,270,0,-3.0570061960153057
ZCTA5 52745,270,0,270,0,-3.0570061960153057
ZCTA5 54125,270,0,270,0,-3.0570061960153057
ZCTA5 87575,270,0,270,0,-3.0570061960153057
ZCTA5 08555,270,0,270,0,-3.0570061960153057
ZCTA5 15324,270,0,270,0,-3.0570061960153057
ZCTA5 18342,270,0,270,0,-3.0570061960153057
ZCTA5 24246,270,0,270,0,-3.0570061960153057
ZCTA5 10993,1655,33,1622,0.019939577039274924,-3.0575084519648885
ZCTA5 65737,3411,82,3329,0.024039871005570215,-3.0577055024195126
ZCTA5 72712,19260,568,18692,0.02949117341640706,-3.0586070303450708
ZCTA5 97116,9363,260,9103,0.027768877496528892,-3.05935260369128
ZCTA5 61605,5829,153,5676,0.02624806999485332,-3.0596041557536355
ZCTA5 72201,706,9,697,0.012747875354107648,-3.0596345171961845
ZCTA5 61272,527,5,522,0.009487666034155597,-3.059669943096232
ZCTA5 27814,792,11,781,0.013888888888888888,-3.062059261971403
ZCTA5 41828,328,1,327,0.003048780487804878,-3.062328483966995
ZCTA5 30513,4955,127,4828,0.025630676084762865,-3.0625989600846286
ZCTA5 45695,271,0,271,0,-3.062662086504936
ZCTA5 50275,271,0,271,0,-3.062662086504936
ZCTA5 59241,271,0,271,0,-3.062662086504936
ZCTA5 61930,271,0,271,0,-3.062662086504936
ZCTA5 62479,271,0,271,0,-3.062662086504936
ZCTA5 70646,271,0,271,0,-3.062662086504936
ZCTA5 72835,271,0,271,0,-3.062662086504936
ZCTA5 07878,271,0,271,0,-3.062662086504936
ZCTA5 23889,271,0,271,0,-3.062662086504936
ZCTA5 24915,271,0,271,0,-3.062662086504936
ZCTA5 56142,432,3,429,0.006944444444444444,-3.064160800200509
ZCTA5 85342,707,9,698,0.01272984441301273,-3.0644668213429145
ZCTA5 78833,528,5,523,0.00946969696969697,-3.0648676580919534
ZCTA5 15067,999,16,983,0.016016016016016016,-3.065126309782437
ZCTA5 99702,999,16,983,0.016016016016016016,-3.065126309782437
ZCTA5 24966,664,8,656,0.012048192771084338,-3.0674949469271833
ZCTA5 76013,13193,378,12815,0.02865155764420526,-3.06774769131973
ZCTA5 74864,1881,39,1842,0.02073365231259968,-3.068068419548451
ZCTA5 47162,272,0,272,0,-3.0683075513633846
ZCTA5 52621,272,0,272,0,-3.0683075513633846
ZCTA5 57220,272,0,272,0,-3.0683075513633846
ZCTA5 60961,272,0,272,0,-3.0683075513633846
ZCTA5 65076,272,0,272,0,-3.0683075513633846
ZCTA5 68415,272,0,272,0,-3.0683075513633846
ZCTA5 77565,3589,87,3502,0.024240735580941766,-3.069553206811121
ZCTA5 54442,433,3,430,0.006928406466512702,-3.0695611417423767
ZCTA5 47141,575,6,569,0.010434782608695653,-3.069674513386898
ZCTA5 01440,8222,225,7997,0.027365604475796643,-3.070241429902818
ZCTA5 54932,482,4,478,0.008298755186721992,-3.0712807634057993
ZCTA5 69155,482,4,478,0.008298755186721992,-3.0712807634057993
ZCTA5 81131,665,8,657,0.012030075187969926,-3.0724021484519657
ZCTA5 13101,878,13,865,0.014806378132118452,-3.072838012050103
ZCTA5 07721,1121,19,1102,0.01694915254237288,-3.073151917272996
ZCTA5 01730,5230,135,5095,0.02581261950286807,-3.0732648504533655
ZCTA5 33109,273,0,273,0,-3.073942648032388
ZCTA5 36371,273,0,273,0,-3.073942648032388
ZCTA5 43136,273,0,273,0,-3.073942648032388
ZCTA5 61925,273,0,273,0,-3.073942648032388
ZCTA5 63463,273,0,273,0,-3.073942648032388
ZCTA5 70436,273,0,273,0,-3.073942648032388
ZCTA5 80436,273,0,273,0,-3.073942648032388
ZCTA5 24318,273,0,273,0,-3.073942648032388
ZCTA5 42343,621,7,614,0.011272141706924315,-3.0740558662108763
ZCTA5 51004,434,3,431,0.0069124423963133645,-3.0749531140093587
ZCTA5 52146,434,3,431,0.0069124423963133645,-3.0749531140093587
ZCTA5 50585,530,5,525,0.009433962264150943,-3.075241847240838
ZCTA5 27018,3138,74,3064,0.023581899298916506,-3.0754605675646123
ZCTA5 23837,1772,36,1736,0.020316027088036117,-3.075612453554357
ZCTA5 11040,12876,368,12508,0.02858030444237341,-3.0756311250372246
ZCTA5 17744,1279,23,1256,0.017982799061767005,-3.077013812599817
ZCTA5 76093,666,8,658,0.012012012012012012,-3.07730371186292
ZCTA5 17267,1122,19,1103,0.01693404634581105,-3.0773362698670335
ZCTA5 41007,1623,32,1591,0.019716574245224893,-3.077766359060768
ZCTA5 56353,3488,84,3404,0.02408256880733945,-3.0780017444897556
ZCTA5 37760,4520,114,4406,0.025221238938053097,-3.0781588595152556
ZCTA5 68752,331,1,330,0.0030211480362537764,-3.079096896564216
ZCTA5 61477,274,0,274,0,-3.0795674334281378
ZCTA5 63533,274,0,274,0,-3.0795674334281378
ZCTA5 67954,274,0,274,0,-3.0795674334281378
ZCTA5 78358,274,0,274,0,-3.0795674334281378
ZCTA5 75959,274,0,274,0,-3.0795674334281378
ZCTA5 87514,274,0,274,0,-3.0795674334281378
ZCTA5 23459,274,0,274,0,-3.0795674334281378
ZCTA5 25567,274,0,274,0,-3.0795674334281378
ZCTA5 25247,274,0,274,0,-3.0795674334281378
ZCTA5 71072,577,6,571,0.010398613518197574,-3.0798400176566396
ZCTA5 32694,838,12,826,0.014319809069212411,-3.080356057863473
ZCTA5 44423,962,15,947,0.015592515592515593,-3.0808765382756804
ZCTA5 49651,3315,79,3236,0.023831070889894418,-3.0812252879148274
ZCTA5 08343,1662,33,1629,0.019855595667870037,-3.0830074257131432
ZCTA5 50456,754,10,744,0.013262599469496022,-3.083334393143269
ZCTA5 16341,754,10,744,0.013262599469496022,-3.083334393143269
ZCTA5 01379,385,2,383,0.005194805194805195,-3.083593541428126
ZCTA5 56316,578,6,572,0.010380622837370242,-3.0849130311370137
ZCTA5 52336,922,14,908,0.015184381778741865,-3.085062787320063
ZCTA5 38259,275,0,275,0,-3.0851819639479885
ZCTA5 41267,275,0,275,0,-3.0851819639479885
ZCTA5 42265,275,0,275,0,-3.0851819639479885
ZCTA5 61482,275,0,275,0,-3.0851819639479885
ZCTA5 87930,275,0,275,0,-3.0851819639479885
ZCTA5 16863,275,0,275,0,-3.0851819639479885
ZCTA5 24366,275,0,275,0,-3.0851819639479885
ZCTA5 26855,275,0,275,0,-3.0851819639479885
ZCTA5 49885,881,13,868,0.014755959137343927,-3.086405595300294
ZCTA5 14838,755,10,745,0.013245033112582781,-3.0880625884572384
ZCTA5 83610,386,2,384,0.0051813471502590676,-3.0890660223651056
ZCTA5 31512,840,12,828,0.014285714285714285,-3.089525001211337
ZCTA5 61019,1321,24,1297,0.018168054504163512,-3.0896831697406637
ZCTA5 42223,4559,115,4444,0.02522483000658039,-3.090061595798632
ZCTA5 47280,276,0,276,0,-3.0907862954770535
ZCTA5 25086,276,0,276,0,-3.0907862954770535
ZCTA5 97011,276,0,276,0,-3.0907862954770535
ZCTA5 98535,276,0,276,0,-3.0907862954770535
ZCTA5 28741,1888,39,1849,0.02065677966101695,-3.09234721826315
ZCTA5 45402,4424,111,4313,0.025090415913200725,-3.0936849307903405
ZCTA5 27046,965,15,950,0.015544041450777202,-3.094050737097054
ZCTA5 44021,2327,51,2276,0.02191663085517834,-3.095120155269061
ZCTA5 16137,4493,113,4380,0.025150233696861785,-3.0954195117464245
ZCTA5 03279,334,1,333,0.0029940119760479044,-3.0957769629990812
ZCTA5 64756,277,0,277,0,-3.0963804833946957
ZCTA5 72346,277,0,277,0,-3.0963804833946957
ZCTA5 01259,277,0,277,0,-3.0963804833946957
ZCTA5 13310,277,0,277,0,-3.0963804833946957
ZCTA5 16854,277,0,277,0,-3.0963804833946957
ZCTA5 62902,2000,42,1958,0.021,-3.0973886440911342
ZCTA5 43971,487,4,483,0.008213552361396304,-3.09762593026324
ZCTA5 68339,487,4,483,0.008213552361396304,-3.09762593026324
ZCTA5 57003,714,9,705,0.012605042016806723,-3.098145438973829
ZCTA5 21001,9614,267,9347,0.027771999167880174,-3.0983862560259117
ZCTA5 20872,4255,106,4149,0.02491186839012926,-3.098787997011698
ZCTA5 88345,3461,83,3378,0.023981508234614275,-3.099128725225894
ZCTA5 98155,13665,392,13273,0.028686425173801683,-3.099475422290328
ZCTA5 57015,335,1,334,0.0029850746268656717,-3.1013175877673906
ZCTA5 32506,14117,406,13711,0.02875965148402635,-3.1019354192757276
ZCTA5 29941,278,0,278,0,-3.1019645825809117
ZCTA5 40953,278,0,278,0,-3.1019645825809117
ZCTA5 41605,278,0,278,0,-3.1019645825809117
ZCTA5 39097,278,0,278,0,-3.1019645825809117
ZCTA5 43535,278,0,278,0,-3.1019645825809117
ZCTA5 49618,278,0,278,0,-3.1019645825809117
ZCTA5 52580,278,0,278,0,-3.1019645825809117
ZCTA5 65059,278,0,278,0,-3.1019645825809117
ZCTA5 72001,278,0,278,0,-3.1019645825809117
ZCTA5 72661,278,0,278,0,-3.1019645825809117
ZCTA5 13337,278,0,278,0,-3.1019645825809117
ZCTA5 29810,1817,37,1780,0.020363236103467255,-3.1032293441498697
ZCTA5 54909,843,12,831,0.014234875444839857,-3.1032457588201723
ZCTA5 61473,627,7,620,0.011164274322169059,-3.103891271693718
ZCTA5 40828,1286,23,1263,0.017884914463452566,-3.1049434280990647
ZCTA5 61325,389,2,387,0.005141388174807198,-3.105429737479992
ZCTA5 23874,389,2,387,0.005141388174807198,-3.105429737479992
ZCTA5 30425,536,5,531,0.009328358208955223,-3.106196357312332
ZCTA5 54546,536,5,531,0.009328358208955223,-3.106196357312332
ZCTA5 50216,1049,17,1032,0.016205910390848427,-3.1066917893840524
ZCTA5 66535,1049,17,1032,0.016205910390848427,-3.1066917893840524
ZCTA5 61075,440,3,437,0.006818181818181818,-3.107131206766471
ZCTA5 50479,279,0,279,0,-3.1075386474226137
ZCTA5 54560,279,0,279,0,-3.1075386474226137
ZCTA5 71962,279,0,279,0,-3.1075386474226137
ZCTA5 87014,279,0,279,0,-3.1075386474226137
ZCTA5 48419,1009,16,993,0.015857284440039643,-3.108468698233455
ZCTA5 03467,628,7,621,0.011146496815286623,-3.1088429788838057
ZCTA5 30625,886,13,873,0.014672686230248307,-3.1089357178678396
ZCTA5 65063,1209,21,1188,0.017369727047146403,-3.1101724137386544
ZCTA5 00982,5953,156,5797,0.02620527465143625,-3.1103386176911183
ZCTA5 11697,1365,25,1340,0.018315018315018316,-3.1105220882581994
ZCTA5 38626,537,5,532,0.00931098696461825,-3.111331202649222
ZCTA5 08104,8573,235,8338,0.027411641199113497,-3.1113867034704517
ZCTA5 01821,11509,325,11184,0.028238769658528107,-3.111545822681546
ZCTA5 65604,1404,26,1378,0.018518518518518517,-3.11224071161144
ZCTA5 47357,337,1,336,0.002967359050445104,-3.112370037824627
ZCTA5 16669,845,12,833,0.014201183431952662,-3.1123712830270285
ZCTA5 13731,441,3,438,0.006802721088435374,-3.1124655959089957
ZCTA5 12920,1010,16,994,0.015841584158415842,-3.1127834851614113
ZCTA5 47283,1288,23,1265,0.017857142857142856,-3.1128996185675777
ZCTA5 38924,280,0,280,0,-3.1131027318198106
ZCTA5 52236,280,0,280,0,-3.1131027318198106
ZCTA5 62551,280,0,280,0,-3.1131027318198106
ZCTA5 04773,280,0,280,0,-3.1131027318198106
ZCTA5 17760,280,0,280,0,-3.1131027318198106
ZCTA5 24879,280,0,280,0,-3.1131027318198106
ZCTA5 89411,280,0,280,0,-3.1131027318198106
ZCTA5 54428,490,4,486,0.00816326530612245,-3.11334260537517
ZCTA5 32424,1968,41,1927,0.020833333333333332,-3.113626903853479
ZCTA5 41314,1783,36,1747,0.020190689848569827,-3.1145758293140706
ZCTA5 77079,12159,345,11814,0.02837404391808537,-3.115253202496644
ZCTA5 72202,4740,120,4620,0.02531645569620253,-3.1157240863166398
ZCTA5 84017,1405,26,1379,0.018505338078291814,-3.1160963211905153
ZCTA5 95562,1405,26,1379,0.018505338078291814,-3.1160963211905153
ZCTA5 53922,391,2,389,0.005115089514066497,-3.116294525139387
ZCTA5 14718,761,10,751,0.013140604467805518,-3.1163292188517713
ZCTA5 39040,1289,23,1266,0.017843289371605897,-3.116873785487799
ZCTA5 50476,338,1,337,0.0029585798816568047,-3.117881960534027
ZCTA5 53576,888,13,875,0.01463963963963964,-3.1179191109007274
ZCTA5 95655,1367,25,1342,0.018288222384784197,-3.118309576364726
ZCTA5 36482,281,0,281,0,-3.1186568891916866
ZCTA5 46958,281,0,281,0,-3.1186568891916866
ZCTA5 50435,281,0,281,0,-3.1186568891916866
ZCTA5 50223,281,0,281,0,-3.1186568891916866
ZCTA5 57427,281,0,281,0,-3.1186568891916866
ZCTA5 69346,281,0,281,0,-3.1186568891916866
ZCTA5 69040,281,0,281,0,-3.1186568891916866
ZCTA5 56221,281,0,281,0,-3.1186568891916866
ZCTA5 26568,281,0,281,0,-3.1186568891916866
ZCTA5 26866,281,0,281,0,-3.1186568891916866
ZCTA5 95629,281,0,281,0,-3.1186568891916866
ZCTA5 16154,1092,18,1074,0.016483516483516484,-3.118710510156054
ZCTA5 36544,4057,100,3957,0.02464875523786049,-3.119028780822459
ZCTA5 16153,1052,17,1035,0.016159695817490494,-3.119466831149849
ZCTA5 01982,2658,60,2598,0.022573363431151242,-3.1196429621052326
ZCTA5 30738,1559,30,1529,0.01924310455420141,-3.120435926175108
ZCTA5 02715,1290,23,1267,0.017829457364341085,-3.1208453392607263
ZCTA5 51466,392,2,390,0.00510204081632653,-3.121713735798648
ZCTA5 49284,1212,21,1191,0.017326732673267328,-3.12235268290707
ZCTA5 57276,443,3,440,0.006772009029345372,-3.1231101506177508
ZCTA5 56736,443,3,440,0.006772009029345372,-3.1231101506177508
ZCTA5 64430,339,1,338,0.0029498525073746312,-3.1233844126371677
ZCTA5 07857,1407,26,1381,0.01847903340440654,-3.1238004976958655
ZCTA5 46260,13166,376,12790,0.028558408020659273,-3.124045906206627
ZCTA5 40041,282,0,282,0,-3.1242011724825867
ZCTA5 61560,282,0,282,0,-3.1242011724825867
ZCTA5 66953,282,0,282,0,-3.1242011724825867
ZCTA5 25617,282,0,282,0,-3.1242011724825867
ZCTA5 37762,1291,23,1268,0.017815646785437646,-3.124814284169475
ZCTA5 13808,586,6,580,0.010238907849829351,-3.1252663212249554
ZCTA5 46779,848,12,836,0.014150943396226415,-3.126027308744148
ZCTA5 36618,6596,175,6421,0.02653123104912068,-3.126791700427734
ZCTA5 98226,17434,509,16925,0.02919582425146266,-3.1268761581798095
ZCTA5 18346,806,11,795,0.013647642679900745,-3.127092625964173
ZCTA5 47537,393,2,391,0.005089058524173028,-3.1271242118720783
ZCTA5 73102,1134,19,1115,0.01675485008818342,-3.1273070426712084
ZCTA5 28088,1054,17,1037,0.016129032258064516,-3.127966822468505
ZCTA5 32837,17084,498,16586,0.02915008194802154,-3.1285786898276964
ZCTA5 02644,1485,28,1457,0.018855218855218854,-3.1286025135844415
ZCTA5 23089,2046,43,2003,0.021016617790811338,-3.1286259959069156
ZCTA5 55307,1331,24,1307,0.018031555221637866,-3.129049406616738
ZCTA5 20747,15228,440,14788,0.028894142369319673,-3.129389441088916
ZCTA5 41240,2518,56,2462,0.022239872915011914,-3.1294364758529065
ZCTA5 38920,283,0,283,0,-3.1297356341679032
ZCTA5 45778,283,0,283,0,-3.1297356341679032
ZCTA5 80833,283,0,283,0,-3.1297356341679032
ZCTA5 02666,283,0,283,0,-3.1297356341679032
ZCTA5 15671,283,0,283,0,-3.1297356341679032
ZCTA5 15678,283,0,283,0,-3.1297356341679032
ZCTA5 19456,283,0,283,0,-3.1297356341679032
ZCTA5 92258,283,0,283,0,-3.1297356341679032
ZCTA5 15622,587,6,581,0.010221465076660987,-3.130281955679321
ZCTA5 42021,677,8,669,0.011816838995568686,-3.130853621086462
ZCTA5 42078,721,9,712,0.012482662968099861,-3.1315695628405784
ZCTA5 49264,721,9,712,0.012482662968099861,-3.1315695628405784
ZCTA5 99360,541,5,536,0.009242144177449169,-3.1318022486454185
ZCTA5 55339,394,2,392,0.005076142131979695,-3.1325259936267713
ZCTA5 15771,394,2,392,0.005076142131979695,-3.1325259936267713
ZCTA5 97462,1638,32,1606,0.019536019536019536,-3.132593909411188
ZCTA5 26362,1332,24,1308,0.018018018018018018,-3.1329721777304775
ZCTA5 57701,18364,538,17826,0.029296449575255935,-3.1333604751985935
ZCTA5 97544,974,15,959,0.015400410677618069,-3.1333736223070616
ZCTA5 14805,445,3,442,0.006741573033707865,-3.133722634955284
ZCTA5 55935,341,1,340,0.002932551319648094,-3.134361095457532
ZCTA5 29834,765,10,755,0.013071895424836602,-3.135076938732336
ZCTA5 02199,765,10,755,0.013071895424836602,-3.135076938732336
ZCTA5 45894,284,0,284,0,-3.135260326259873
ZCTA5 54769,284,0,284,0,-3.135260326259873
ZCTA5 68652,284,0,284,0,-3.135260326259873
ZCTA5 12022,284,0,284,0,-3.135260326259873
ZCTA5 15937,284,0,284,0,-3.135260326259873
ZCTA5 23092,284,0,284,0,-3.135260326259873
ZCTA5 24272,284,0,284,0,-3.135260326259873
ZCTA5 24916,284,0,284,0,-3.135260326259873
ZCTA5 26581,284,0,284,0,-3.135260326259873
ZCTA5 98830,284,0,284,0,-3.135260326259873
ZCTA5 35772,1789,36,1753,0.020122973728339856,-3.1357398493007005
ZCTA5 36502,5965,156,5809,0.026152556580050293,-3.1361146176885013
ZCTA5 16822,808,11,797,0.013613861386138614,-3.136310036993421
ZCTA5 04966,722,9,713,0.012465373961218837,-3.1363239555137556
ZCTA5 71743,1677,33,1644,0.01967799642218247,-3.13733421861321
ZCTA5 42140,395,2,393,0.005063291139240506,-3.1379191210305173
ZCTA5 08020,934,14,920,0.014989293361884369,-3.1382306686186867
ZCTA5 03227,446,3,443,0.006726457399103139,-3.1390169352698147
ZCTA5 80645,1526,29,1497,0.019003931847968544,-3.139191455787613
ZCTA5 26184,893,13,880,0.014557670772676373,-3.140306618470574
ZCTA5 40856,285,0,285,0,-3.1407753003132792
ZCTA5 41825,285,0,285,0,-3.1407753003132792
ZCTA5 47550,285,0,285,0,-3.1407753003132792
ZCTA5 58529,285,0,285,0,-3.1407753003132792
ZCTA5 87745,285,0,285,0,-3.1407753003132792
ZCTA5 61440,285,0,285,0,-3.1407753003132792
ZCTA5 62032,285,0,285,0,-3.1407753003132792
ZCTA5 56080,285,0,285,0,-3.1407753003132792
ZCTA5 05759,723,9,714,0.012448132780082987,-3.1410732708038305
ZCTA5 27886,8491,232,8259,0.02732304793310564,-3.1418695646039754
ZCTA5 62827,543,5,538,0.009208103130755065,-3.141997115534238
ZCTA5 14212,4615,116,4499,0.02513542795232936,-3.1427569847488663
ZCTA5 37846,1791,36,1755,0.020100502512562814,-3.142780709783471
ZCTA5 43779,396,2,394,0.005050505050505051,-3.1433036337548472
ZCTA5 24070,635,7,628,0.011023622047244094,-3.14334050836564
ZCTA5 29691,4445,111,4334,0.024971878515185602,-3.144968393215395
ZCTA5 51034,810,11,799,0.013580246913580247,-3.1455094588161967
ZCTA5 59832,286,0,286,0,-3.146280607431061
ZCTA5 02542,286,0,286,0,-3.146280607431061
ZCTA5 14069,286,0,286,0,-3.146280607431061
ZCTA5 19545,286,0,286,0,-3.146280607431061
ZCTA5 22726,286,0,286,0,-3.146280607431061
ZCTA5 24220,286,0,286,0,-3.146280607431061
ZCTA5 23843,286,0,286,0,-3.146280607431061
ZCTA5 20151,6839,182,6657,0.02661207778915046,-3.146686006048849
ZCTA5 32409,3618,87,3531,0.02404643449419569,-3.1469235362884502
ZCTA5 38753,544,5,539,0.009191176470588236,-3.1470844702480587
ZCTA5 76633,1867,38,1829,0.020353508302088912,-3.1479742314645143
ZCTA5 57382,636,7,629,0.0110062893081761,-3.148245460122329
ZCTA5 98102,15370,444,14926,0.02888744307091737,-3.1485650524013478
ZCTA5 62894,397,2,395,0.005037783375314861,-3.1486795711780284
ZCTA5 85632,397,2,395,0.005037783375314861,-3.1486795711780284
ZCTA5 05476,1258,22,1236,0.017488076311605722,-3.1492294177450293
ZCTA5 13408,895,13,882,0.01452513966480447,-3.149233428496164
ZCTA5 57020,497,4,493,0.008048289738430584,-3.149756240252061
ZCTA5 20137,497,4,493,0.008048289738430584,-3.149756240252061
ZCTA5 53577,591,6,585,0.01015228426395939,-3.1502820233366005
ZCTA5 41642,287,0,287,0,-3.1517762982698447
ZCTA5 41616,287,0,287,0,-3.1517762982698447
ZCTA5 51531,287,0,287,0,-3.1517762982698447
ZCTA5 56289,287,0,287,0,-3.1517762982698447
ZCTA5 72544,287,0,287,0,-3.1517762982698447
ZCTA5 24733,287,0,287,0,-3.1517762982698447
ZCTA5 24862,287,0,287,0,-3.1517762982698447
ZCTA5 25187,287,0,287,0,-3.1517762982698447
ZCTA5 71720,1100,18,1082,0.016363636363636365,-3.1522244237891863
ZCTA5 18466,5367,138,5229,0.025712688652878703,-3.1539693472495105
ZCTA5 49912,449,3,446,0.0066815144766146995,-3.1548524691256876
ZCTA5 83128,449,3,446,0.0066815144766146995,-3.1548524691256876
ZCTA5 87714,498,4,494,0.008032128514056224,-3.1549290525840843
ZCTA5 16235,498,4,494,0.008032128514056224,-3.1549290525840843
ZCTA5 16720,498,4,494,0.008032128514056224,-3.1549290525840843
ZCTA5 53594,2237,48,2189,0.021457308895842648,-3.1554887972191605
ZCTA5 82007,8202,223,7979,0.027188490612045844,-3.1557071823778196
ZCTA5 62471,3307,78,3229,0.023586332022981556,-3.15577293460483
ZCTA5 57528,345,1,344,0.002898550724637681,-3.156202886811066
ZCTA5 22079,11375,320,11055,0.028131868131868132,-3.1567837181801113
ZCTA5 45332,288,0,288,0,-3.157262423045377
ZCTA5 47387,288,0,288,0,-3.157262423045377
ZCTA5 48841,288,0,288,0,-3.157262423045377
ZCTA5 52337,288,0,288,0,-3.157262423045377
ZCTA5 62311,288,0,288,0,-3.157262423045377
ZCTA5 71044,288,0,288,0,-3.157262423045377
ZCTA5 75412,288,0,288,0,-3.157262423045377
ZCTA5 75850,288,0,288,0,-3.157262423045377
ZCTA5 74869,288,0,288,0,-3.157262423045377
ZCTA5 77978,288,0,288,0,-3.157262423045377
ZCTA5 06262,288,0,288,0,-3.157262423045377
ZCTA5 12136,288,0,288,0,-3.157262423045377
ZCTA5 12861,288,0,288,0,-3.157262423045377
ZCTA5 26320,288,0,288,0,-3.157262423045377
ZCTA5 55011,3658,88,3570,0.02405686167304538,-3.160764517884074
ZCTA5 55115,3519,84,3435,0.023870417732310314,-3.1616366373222218
ZCTA5 29627,7113,190,6923,0.026711654716715872,-3.1623985505134535
ZCTA5 32784,4315,107,4208,0.024797219003476246,-3.162441403628397
ZCTA5 75207,1494,28,1466,0.018741633199464525,-3.1624840987907756
ZCTA5 04252,1834,37,1797,0.020174482006543076,-3.1626656334631997
ZCTA5 29922,289,0,289,0,-3.1627390315378796
ZCTA5 42541,289,0,289,0,-3.1627390315378796
ZCTA5 47942,289,0,289,0,-3.1627390315378796
ZCTA5 05342,289,0,289,0,-3.1627390315378796
ZCTA5 03595,289,0,289,0,-3.1627390315378796
ZCTA5 12836,289,0,289,0,-3.1627390315378796
ZCTA5 13782,289,0,289,0,-3.1627390315378796
ZCTA5 94933,289,0,289,0,-3.1627390315378796
ZCTA5 97492,289,0,289,0,-3.1627390315378796
ZCTA5 95615,289,0,289,0,-3.1627390315378796
ZCTA5 37101,2312,50,2262,0.02162629757785467,-3.1627626923343857
ZCTA5 54664,639,7,632,0.010954616588419406,-3.1629258162146816
ZCTA5 63546,639,7,632,0.010954616588419406,-3.1629258162146816
ZCTA5 03082,639,7,632,0.010954616588419406,-3.1629258162146816
ZCTA5 72444,728,9,719,0.012362637362637362,-3.1647441823775195
ZCTA5 52751,400,2,398,0.005,-3.164756321086342
ZCTA5 62460,500,4,496,0.008,-3.165253106015599
ZCTA5 50575,451,3,448,0.0066518847006651885,-3.1653703482809257
ZCTA5 50668,451,3,448,0.0066518847006651885,-3.1653703482809257
ZCTA5 02657,1760,35,1725,0.019886363636363636,-3.16542230284548
ZCTA5 49706,1835,37,1798,0.020163487738419618,-3.1661468200056095
ZCTA5 50650,347,1,346,0.002881844380403458,-3.1670687309505903
ZCTA5 54864,548,5,543,0.009124087591240875,-3.167367257403678
ZCTA5 29581,1947,40,1907,0.02054442732408834,-3.167862903523526
ZCTA5 37742,2350,51,2299,0.02170212765957447,-3.1682056074380194
ZCTA5 41464,290,0,290,0,-3.16820617309732
ZCTA5 47335,290,0,290,0,-3.16820617309732
ZCTA5 55603,290,0,290,0,-3.16820617309732
ZCTA5 62885,290,0,290,0,-3.16820617309732
ZCTA5 69166,290,0,290,0,-3.16820617309732
ZCTA5 72333,290,0,290,0,-3.16820617309732
ZCTA5 80832,290,0,290,0,-3.16820617309732
ZCTA5 25075,290,0,290,0,-3.16820617309732
ZCTA5 12518,2314,50,2264,0.021607605877268798,-3.169130645688299
ZCTA5 37323,12129,343,11786,0.02827933053013439,-3.169415567311706
ZCTA5 49021,2495,55,2440,0.022044088176352707,-3.169495951612943
ZCTA5 04022,452,3,449,0.00663716814159292,-3.170617642432193
ZCTA5 32148,4043,99,3944,0.024486767252040565,-3.170921833668658
ZCTA5 71486,2022,42,1980,0.020771513353115726,-3.171514309764782
ZCTA5 36088,1303,23,1280,0.017651573292402148,-3.1722396762211655
ZCTA5 28721,4319,107,4212,0.024774253299374854,-3.172300188015523
ZCTA5 68301,549,5,544,0.009107468123861567,-3.1724214148852936
ZCTA5 57031,348,1,347,0.0028735632183908046,-3.172488048123704
ZCTA5 38647,291,0,291,0,-3.1736638966485984
ZCTA5 58275,291,0,291,0,-3.1736638966485984
ZCTA5 61771,291,0,291,0,-3.1736638966485984
ZCTA5 12433,291,0,291,0,-3.1736638966485984
ZCTA5 14841,291,0,291,0,-3.1736638966485984
ZCTA5 21524,291,0,291,0,-3.1736638966485984
ZCTA5 24270,291,0,291,0,-3.1736638966485984
ZCTA5 06475,4354,108,4246,0.02480477721635278,-3.1739272173004918
ZCTA5 65649,686,8,678,0.011661807580174927,-3.1741766999339616
ZCTA5 64759,3279,77,3202,0.02348276913693199,-3.175363785940523
ZCTA5 61437,402,2,400,0.004975124378109453,-3.17543198685769
ZCTA5 05770,402,2,400,0.004975124378109453,-3.17543198685769
ZCTA5 19539,1875,38,1837,0.020266666666666665,-3.1756232940378077
ZCTA5 97886,453,3,450,0.006622516556291391,-3.175857215839567
ZCTA5 27808,901,13,888,0.014428412874583796,-3.175918159523882
ZCTA5 45761,774,10,764,0.012919896640826873,-3.1769812016007286
ZCTA5 27053,1265,22,1243,0.017391304347826087,-3.1771197366460586
ZCTA5 03592,550,5,545,0.00909090909090909,-3.1774690036258204
ZCTA5 16693,1498,28,1470,0.018691588785046728,-3.177486310941679
ZCTA5 63353,1913,39,1874,0.020386826973340304,-3.178414704973395
ZCTA5 35670,2570,57,2513,0.02217898832684825,-3.1787495640517878
ZCTA5 31756,292,0,292,0,-3.179112250696657
ZCTA5 31307,292,0,292,0,-3.179112250696657
ZCTA5 37819,292,0,292,0,-3.179112250696657
ZCTA5 41232,292,0,292,0,-3.179112250696657
ZCTA5 58271,292,0,292,0,-3.179112250696657
ZCTA5 64437,292,0,292,0,-3.179112250696657
ZCTA5 67430,292,0,292,0,-3.179112250696657
ZCTA5 68875,292,0,292,0,-3.179112250696657
ZCTA5 04653,292,0,292,0,-3.179112250696657
ZCTA5 12473,292,0,292,0,-3.179112250696657
ZCTA5 17964,292,0,292,0,-3.179112250696657
ZCTA5 26451,292,0,292,0,-3.179112250696657
ZCTA5 24613,292,0,292,0,-3.179112250696657
ZCTA5 18942,1383,25,1358,0.018076644974692697,-3.1802621526844814
ZCTA5 21917,860,12,848,0.013953488372093023,-3.18026955786457
ZCTA5 77861,902,13,889,0.014412416851441241,-3.1803517545741697
ZCTA5 55373,2135,45,2090,0.02107728337236534,-3.180360011251425
ZCTA5 57315,454,3,451,0.006607929515418502,-3.1810891003925494
ZCTA5 71369,1026,16,1010,0.015594541910331383,-3.181347926728488
ZCTA5 43342,1107,18,1089,0.016260162601626018,-3.1813838441738502
ZCTA5 74330,1107,18,1089,0.016260162601626018,-3.1813838441738502
ZCTA5 40444,5717,148,5569,0.025887703340913067,-3.181595184542592
ZCTA5 14129,551,5,546,0.009074410163339383,-3.1825100468863687
ZCTA5 66720,4700,118,4582,0.025106382978723404,-3.182640351933293
ZCTA5 95928,14463,415,14048,0.02869390859434419,-3.183687132123851
ZCTA5 53004,1306,23,1283,0.01761102603369066,-3.184038274173199
ZCTA5 55437,7887,213,7674,0.02700646633701027,-3.184413684324207
ZCTA5 48705,293,0,293,0,-3.18455128333151
ZCTA5 68653,293,0,293,0,-3.18455128333151
ZCTA5 11739,293,0,293,0,-3.18455128333151
ZCTA5 16405,293,0,293,0,-3.18455128333151
ZCTA5 19979,293,0,293,0,-3.18455128333151
ZCTA5 22623,293,0,293,0,-3.18455128333151
ZCTA5 29853,2572,57,2515,0.022161741835147745,-3.1848502563047716
ZCTA5 61377,598,6,592,0.010033444816053512,-3.1850448254789967
ZCTA5 15732,598,6,592,0.010033444816053512,-3.1850448254789967
ZCTA5 03084,504,4,500,0.007936507936507936,-3.185815696408611
ZCTA5 45836,552,5,547,0.009057971014492754,-3.1875445677983185
ZCTA5 99323,1346,24,1322,0.017830609212481426,-3.187629992579309
ZCTA5 35768,4497,112,4385,0.02490549255058928,-3.18806783251505
ZCTA5 49408,3773,91,3682,0.02411873840445269,-3.1889274759420085
ZCTA5 66090,1149,19,1130,0.016536118363794605,-3.189154392981569
ZCTA5 41547,294,0,294,0,-3.189981042233193
ZCTA5 44815,294,0,294,0,-3.189981042233193
ZCTA5 51467,294,0,294,0,-3.189981042233193
ZCTA5 61526,294,0,294,0,-3.189981042233193
ZCTA5 06409,294,0,294,0,-3.189981042233193
ZCTA5 43766,599,6,593,0.01001669449081803,-3.189986610065962
ZCTA5 32508,505,4,501,0.007920792079207921,-3.190938686237478
ZCTA5 22942,3530,84,3446,0.02379603399433428,-3.19115122183569
ZCTA5 49835,405,2,403,0.0049382716049382715,-3.1913829906487123
ZCTA5 12206,6226,163,6063,0.026180533247671056,-3.1917146116084187
ZCTA5 60707,15626,451,15175,0.028862152822219378,-3.192258602198637
ZCTA5 70360,10844,303,10541,0.027941718922906675,-3.192338249217996
ZCTA5 24951,690,8,682,0.011594202898550725,-3.1932930307047918
ZCTA5 59845,600,6,594,0.01,-3.194922372290374
ZCTA5 29133,295,0,295,0,-3.1954015746766427
ZCTA5 36583,295,0,295,0,-3.1954015746766427
ZCTA5 49922,295,0,295,0,-3.1954015746766427
ZCTA5 67008,295,0,295,0,-3.1954015746766427
ZCTA5 04774,295,0,295,0,-3.1954015746766427
ZCTA5 93067,295,0,295,0,-3.1954015746766427
ZCTA5 32410,506,4,502,0.007905138339920948,-3.196054666532179
ZCTA5 32427,406,2,404,0.0049261083743842365,-3.1966834754318785
ZCTA5 95357,3602,86,3516,0.02387562465297057,-3.1969670410525204
ZCTA5 06031,646,7,639,0.010835913312693499,-3.1969810229874858
ZCTA5 56178,735,9,726,0.012244897959183673,-3.1976741366735832
ZCTA5 75490,906,13,893,0.01434878587196468,-3.198046865800122
ZCTA5 13112,691,8,683,0.011577424023154847,-3.1980589896490144
ZCTA5 81003,5691,147,5544,0.025830258302583026,-3.1984518548408953
ZCTA5 46071,1388,25,1363,0.018011527377521614,-3.1994971890808563
ZCTA5 04730,4158,102,4056,0.024531024531024532,-3.1998323513151066
ZCTA5 30822,296,0,296,0,-3.200812927536498
ZCTA5 46959,296,0,296,0,-3.200812927536498
ZCTA5 47453,296,0,296,0,-3.200812927536498
ZCTA5 49816,296,0,296,0,-3.200812927536498
ZCTA5 57375,296,0,296,0,-3.200812927536498
ZCTA5 57559,296,0,296,0,-3.200812927536498
ZCTA5 61840,296,0,296,0,-3.200812927536498
ZCTA5 22714,296,0,296,0,-3.200812927536498
ZCTA5 27042,296,0,296,0,-3.200812927536498
ZCTA5 27923,296,0,296,0,-3.200812927536498
ZCTA5 16239,507,4,503,0.007889546351084813,-3.2011636637978658
ZCTA5 68015,458,3,455,0.006550218340611353,-3.201940380529066
ZCTA5 57384,407,2,405,0.004914004914004914,-3.20197576320044
ZCTA5 45896,736,9,727,0.012228260869565218,-3.202358718690478
ZCTA5 29014,692,8,684,0.011560693641618497,-3.2028197296196685
ZCTA5 54216,2722,61,2661,0.022409992652461425,-3.2043776947183162
ZCTA5 16950,1272,22,1250,0.01729559748427673,-3.2048804010443726
ZCTA5 36749,297,0,297,0,-3.206215147291829
ZCTA5 50448,297,0,297,0,-3.206215147291829
ZCTA5 65634,297,0,297,0,-3.206215147291829
ZCTA5 68856,297,0,297,0,-3.206215147291829
ZCTA5 72060,297,0,297,0,-3.206215147291829
ZCTA5 13406,297,0,297,0,-3.206215147291829
ZCTA5 18063,297,0,297,0,-3.206215147291829
ZCTA5 19730,297,0,297,0,-3.206215147291829
ZCTA5 17832,297,0,297,0,-3.206215147291829
ZCTA5 73505,18357,536,17821,0.029198670806776707,-3.206436265732004
ZCTA5 71749,991,15,976,0.015136226034308779,-3.2068495251617364
ZCTA5 29706,7601,204,7397,0.026838573871858964,-3.207544623819864
ZCTA5 38680,2180,46,2134,0.02110091743119266,-3.2075652860856323
ZCTA5 97111,1273,22,1251,0.01728201099764336,-3.2088357139974297
ZCTA5 07452,3781,91,3690,0.02406770695583179,-3.209756832563937
ZCTA5 49302,2938,67,2871,0.022804628999319263,-3.210134055161265
ZCTA5 56260,355,1,354,0.0028169014084507044,-3.2101734061518084
ZCTA5 55370,298,0,298,0,-3.2116082800307955
ZCTA5 56051,298,0,298,0,-3.2116082800307955
ZCTA5 85545,298,0,298,0,-3.2116082800307955
ZCTA5 23337,298,0,298,0,-3.2116082800307955
ZCTA5 92278,298,0,298,0,-3.2116082800307955
ZCTA5 50073,460,3,457,0.006521739130434782,-3.2123207013165156
ZCTA5 52553,694,8,686,0.011527377521613832,-3.2123256131399565
ZCTA5 04649,557,5,552,0.008976660682226212,-3.2126201377682535
ZCTA5 30121,8497,231,8266,0.027186065670236553,-3.213199352984462
ZCTA5 66402,1155,19,1136,0.01645021645021645,-3.21370549981439
ZCTA5 71454,782,10,772,0.01278772378516624,-3.2139120908547794
ZCTA5 18621,2072,43,2029,0.020752895752895753,-3.2152002690808015
ZCTA5 41034,356,1,355,0.0028089887640449437,-3.215521849300564
ZCTA5 54529,510,4,506,0.00784313725490196,-3.2164490200973552
ZCTA5 35587,299,0,299,0,-3.2169923714552335
ZCTA5 62461,299,0,299,0,-3.2169923714552335
ZCTA5 68627,299,0,299,0,-3.2169923714552335
ZCTA5 68034,299,0,299,0,-3.2169923714552335
ZCTA5 12150,299,0,299,0,-3.2169923714552335
ZCTA5 24602,299,0,299,0,-3.2169923714552335
ZCTA5 26039,299,0,299,0,-3.2169923714552335
ZCTA5 80728,410,2,408,0.004878048780487805,-3.217803806518758
ZCTA5 56017,651,7,644,0.010752688172043012,-3.221138258308643
ZCTA5 60124,7774,209,7565,0.026884486750707485,-3.2213290714801373
ZCTA5 60444,696,8,688,0.011494252873563218,-3.221810801583418
ZCTA5 39348,300,0,300,0,-3.222367466885173
ZCTA5 57036,300,0,300,0,-3.222367466885173
ZCTA5 60553,300,0,300,0,-3.222367466885173
ZCTA5 68926,300,0,300,0,-3.222367466885173
ZCTA5 74422,300,0,300,0,-3.222367466885173
ZCTA5 04576,300,0,300,0,-3.222367466885173
ZCTA5 25839,300,0,300,0,-3.222367466885173
ZCTA5 63532,559,5,554,0.008944543828264758,-3.222605504659791
ZCTA5 55919,462,3,459,0.006493506493506494,-3.222671136255983
ZCTA5 06377,1117,18,1099,0.01611459265890779,-3.222776799126015
ZCTA5 53039,1663,32,1631,0.019242333132892364,-3.2230119109121085
ZCTA5 21217,13652,389,13263,0.028493993554058013,-3.2230375140951533
ZCTA5 50542,411,2,409,0.004866180048661801,-3.223063667038849
ZCTA5 14817,912,13,899,0.01425438596491228,-3.2244727050516184
ZCTA5 56039,358,1,357,0.002793296089385475,-3.226192771070666
ZCTA5 62550,1118,18,1100,0.016100178890876567,-3.2268992454395193
ZCTA5 31830,828,11,817,0.013285024154589372,-3.2275095109747647
ZCTA5 68756,785,10,775,0.012738853503184714,-3.2276855077213713
ZCTA5 43345,301,0,301,0,-3.2277336112632913
ZCTA5 45741,301,0,301,0,-3.2277336112632913
ZCTA5 50667,301,0,301,0,-3.2277336112632913
ZCTA5 65580,301,0,301,0,-3.2277336112632913
ZCTA5 68378,301,0,301,0,-3.2277336112632913
ZCTA5 14777,301,0,301,0,-3.2277336112632913
ZCTA5 14859,301,0,301,0,-3.2277336112632913
ZCTA5 21657,301,0,301,0,-3.2277336112632913
ZCTA5 26575,301,0,301,0,-3.2277336112632913
ZCTA5 51439,412,2,410,0.0048543689320388345,-3.2283155096677927
ZCTA5 55378,9985,276,9709,0.027641462193289935,-3.230141912291234
ZCTA5 49249,1589,30,1559,0.018879798615481436,-3.230853698479721
ZCTA5 52329,359,1,358,0.002785515320334262,-3.2315153318953533
ZCTA5 67484,359,1,358,0.002785515320334262,-3.2315153318953533
ZCTA5 61465,513,4,509,0.007797270955165692,-3.2316724682175813
ZCTA5 32568,1038,16,1022,0.015414258188824663,-3.2321993939522735
ZCTA5 04351,1038,16,1022,0.015414258188824663,-3.2321993939522735
ZCTA5 57048,464,3,461,0.00646551724137931,-3.232991926636305
ZCTA5 61875,302,0,302,0,-3.2330908491592942
ZCTA5 68831,302,0,302,0,-3.2330908491592942
ZCTA5 79528,302,0,302,0,-3.2330908491592942
ZCTA5 92322,302,0,302,0,-3.2330908491592942
ZCTA5 62803,413,2,411,0.004842615012106538,-3.2335593694700813
ZCTA5 66512,1160,19,1141,0.016379310344827588,-3.234084052970057
ZCTA5 20777,1160,19,1141,0.016379310344827588,-3.234084052970057
ZCTA5 75287,27735,831,26904,0.02996214169821525,-3.234184980056572
ZCTA5 35072,1855,37,1818,0.019946091644204852,-3.235424178130397
ZCTA5 53504,830,11,819,0.01325301204819277,-3.23653392636568
ZCTA5 30313,2189,46,2143,0.021014161717679305,-3.2367523188445904
ZCTA5 50579,998,15,983,0.01503006012024048,-3.2368069911939656
ZCTA5 50106,360,1,359,0.002777777777777778,-3.2368293469491483
ZCTA5 61052,360,1,359,0.002777777777777778,-3.2368293469491483
ZCTA5 47354,465,3,462,0.0064516129032258064,-3.23814127966884
ZCTA5 48432,303,0,303,0,-3.238439224774238
ZCTA5 47929,303,0,303,0,-3.238439224774238
ZCTA5 47531,303,0,303,0,-3.238439224774238
ZCTA5 61872,303,0,303,0,-3.238439224774238
ZCTA5 56727,303,0,303,0,-3.238439224774238
ZCTA5 78948,303,0,303,0,-3.238439224774238
ZCTA5 85554,303,0,303,0,-3.238439224774238
ZCTA5 03260,303,0,303,0,-3.238439224774238
ZCTA5 18923,303,0,303,0,-3.238439224774238
ZCTA5 25521,303,0,303,0,-3.238439224774238
ZCTA5 97737,303,0,303,0,-3.238439224774238
ZCTA5 98326,303,0,303,0,-3.238439224774238
ZCTA5 01719,2263,48,2215,0.021210782147591693,-3.238991784910517
ZCTA5 27925,1553,29,1524,0.018673535093367676,-3.239248724361911
ZCTA5 64734,744,9,735,0.012096774193548387,-3.2396606806120287
ZCTA5 35121,5710,147,5563,0.02574430823117338,-3.2399049011253167
ZCTA5 91326,12888,365,12523,0.028320918684047177,-3.2408218000390683
ZCTA5 39330,999,15,984,0.015015015015015015,-3.24107271704143
ZCTA5 72908,5542,142,5400,0.025622518946228797,-3.242307024212723
ZCTA5 61370,563,5,558,0.008880994671403197,-3.2425003114191027
ZCTA5 61858,1242,21,1221,0.016908212560386472,-3.2427833231365826
ZCTA5 24216,1122,18,1104,0.016042780748663103,-3.2433586817754874
ZCTA5 57243,304,0,304,0,-3.2437787819447808
ZCTA5 12929,304,0,304,0,-3.2437787819447808
ZCTA5 15676,304,0,304,0,-3.2437787819447808
ZCTA5 20317,304,0,304,0,-3.2437787819447808
ZCTA5 28679,745,9,736,0.012080536912751677,-3.24430178703609
ZCTA5 13365,3163,73,3090,0.023079355042681,-3.244863441128652
ZCTA5 59427,1593,30,1563,0.018832391713747645,-3.2454400137267205
ZCTA5 72396,5000,126,4874,0.0252,-3.2458297292366916
ZCTA5 66413,789,10,779,0.012674271229404309,-3.245986691341936
ZCTA5 98346,3865,93,3772,0.024062095730918498,-3.2471554787615755
ZCTA5 49318,564,5,559,0.008865248226950355,-3.2474583224775166
ZCTA5 16360,564,5,559,0.008865248226950355,-3.2474583224775166
ZCTA5 70706,7622,204,7418,0.02676462870637628,-3.247873531746652
ZCTA5 04579,1283,22,1261,0.0171473109898675,-3.2482459459658193
ZCTA5 98258,11302,316,10986,0.02795965315873297,-3.248452940585968
ZCTA5 38850,1042,16,1026,0.015355086372360844,-3.249043287467763
ZCTA5 54550,305,0,305,0,-3.249109564147378
ZCTA5 61318,305,0,305,0,-3.249109564147378
ZCTA5 61863,305,0,305,0,-3.249109564147378
ZCTA5 68407,305,0,305,0,-3.249109564147378
ZCTA5 77616,305,0,305,0,-3.249109564147378
ZCTA5 75960,305,0,305,0,-3.249109564147378
ZCTA5 25165,305,0,305,0,-3.249109564147378
ZCTA5 24282,305,0,305,0,-3.249109564147378
ZCTA5 24991,305,0,305,0,-3.249109564147378
ZCTA5 25958,305,0,305,0,-3.249109564147378
ZCTA5 43044,1859,37,1822,0.019903173749327596,-3.2492012407967676
ZCTA5 92086,702,8,694,0.011396011396011397,-3.250143383487957
ZCTA5 39752,1164,19,1145,0.01632302405498282,-3.2503345483767547
ZCTA5 55943,1323,23,1300,0.017384731670445956,-3.250468122093328
ZCTA5 48871,790,10,780,0.012658227848101266,-3.250550748542956
ZCTA5 65686,2083,43,2040,0.020643302928468554,-3.251539222637334
ZCTA5 67144,960,14,946,0.014583333333333334,-3.251559800627523
ZCTA5 71469,960,14,946,0.014583333333333334,-3.251559800627523
ZCTA5 16401,1747,34,1713,0.019461934745277618,-3.252364118755212
ZCTA5 91905,565,5,560,0.008849557522123894,-3.252410100521287
ZCTA5 84720,7259,193,7066,0.026587684254029482,-3.2534271545098585
ZCTA5 52253,1324,23,1301,0.017371601208459216,-3.2543533090837653
ZCTA5 31527,306,0,306,0,-3.25443161450241
ZCTA5 43323,306,0,306,0,-3.25443161450241
ZCTA5 58741,306,0,306,0,-3.25443161450241
ZCTA5 04544,306,0,306,0,-3.25443161450241
ZCTA5 17936,306,0,306,0,-3.25443161450241
ZCTA5 62431,417,2,415,0.004796163069544364,-3.254455673083859
ZCTA5 43009,834,11,823,0.013189448441247002,-3.2545317597561305
ZCTA5 78377,1245,21,1224,0.016867469879518072,-3.2546919786165165
ZCTA5 06242,518,4,514,0.007722007722007722,-3.256909177812229
ZCTA5 61531,1364,24,1340,0.017595307917888565,-3.2572007620592807
ZCTA5 62292,364,1,363,0.0027472527472527475,-3.258000750952136
ZCTA5 51109,1206,20,1186,0.01658374792703151,-3.258102867221149
ZCTA5 50002,613,6,607,0.009787928221859706,-3.2585481124233846
ZCTA5 56037,613,6,607,0.009787928221859706,-3.2585481124233846
ZCTA5 61326,920,13,907,0.014130434782608696,-3.259492021389467
ZCTA5 05444,659,7,652,0.010622154779969651,-3.259504682156473
ZCTA5 56713,418,2,416,0.004784688995215311,-3.2596601361346633
ZCTA5 39767,307,0,307,0,-3.2597449757782533
ZCTA5 64638,307,0,307,0,-3.2597449757782533
ZCTA5 65754,307,0,307,0,-3.2597449757782533
ZCTA5 72374,307,0,307,0,-3.2597449757782533
ZCTA5 13355,307,0,307,0,-3.2597449757782533
ZCTA5 25268,307,0,307,0,-3.2597449757782533
ZCTA5 05764,1286,22,1264,0.017107309486780714,-3.260018739881292
ZCTA5 98270,17984,523,17461,0.029081405693950176,-3.261146015656003
ZCTA5 31052,3098,71,3027,0.022918011620400257,-3.2612899724069155
ZCTA5 00601,5517,141,5376,0.0255573681348559,-3.2618970106670533
ZCTA5 61329,519,4,515,0.007707129094412331,-3.2619363895745788
ZCTA5 38829,6796,179,6617,0.026339022954679225,-3.2619594329528376
ZCTA5 47615,749,9,740,0.012016021361815754,-3.2628186899395724
ZCTA5 67547,836,11,825,0.013157894736842105,-3.2635053441350292
ZCTA5 83276,1405,25,1380,0.017793594306049824,-3.264459108942058
ZCTA5 47943,308,0,308,0,-3.265049690395288
ZCTA5 68777,308,0,308,0,-3.265049690395288
ZCTA5 72537,308,0,308,0,-3.265049690395288
ZCTA5 05146,308,0,308,0,-3.265049690395288
ZCTA5 23076,308,0,308,0,-3.265049690395288
ZCTA5 94592,308,0,308,0,-3.265049690395288
ZCTA5 54966,750,9,741,0.012,-3.267436099027265
ZCTA5 35044,2994,68,2926,0.022712090848363394,-3.2687416852582163
ZCTA5 55355,3943,95,3848,0.02409332995181334,-3.2688503718797013
ZCTA5 55959,880,12,868,0.013636363636363636,-3.2693529098884433
ZCTA5 21756,1328,23,1305,0.017319277108433735,-3.2698694024788284
ZCTA5 38481,420,2,418,0.004761904761904762,-3.2700457629416095
ZCTA5 42533,309,0,309,0,-3.270345800429851
ZCTA5 67059,309,0,309,0,-3.270345800429851
ZCTA5 22810,309,0,309,0,-3.270345800429851
ZCTA5 38860,2346,50,2296,0.021312872975277068,-3.270356318642728
ZCTA5 02030,2015,41,1974,0.020347394540942927,-3.2718935164006084
ZCTA5 79227,569,5,564,0.008787346221441126,-3.2721553090852162
ZCTA5 24148,3244,75,3169,0.02311960542540074,-3.273400074168793
ZCTA5 51052,367,1,366,0.0027247956403269754,-3.273791517730712
ZCTA5 45311,2274,48,2226,0.021108179419525065,-3.274063589245047
ZCTA5 30663,1089,17,1072,0.015610651974288337,-3.2746093869081783
ZCTA5 35183,310,0,310,0,-3.275633347618131
ZCTA5 61917,310,0,310,0,-3.275633347618131
ZCTA5 62477,310,0,310,0,-3.275633347618131
ZCTA5 61442,310,0,310,0,-3.275633347618131
ZCTA5 71827,310,0,310,0,-3.275633347618131
ZCTA5 72776,310,0,310,0,-3.275633347618131
ZCTA5 20184,310,0,310,0,-3.275633347618131
ZCTA5 24313,310,0,310,0,-3.275633347618131
ZCTA5 93604,310,0,310,0,-3.275633347618131
ZCTA5 54874,1486,27,1459,0.01816958277254374,-3.2766384364883105
ZCTA5 52565,752,9,743,0.011968085106382979,-3.2766568261704117
ZCTA5 24534,570,5,565,0.008771929824561403,-3.27707624095094
ZCTA5 35055,7837,210,7627,0.026795967844838585,-3.277934139789984
ZCTA5 43110,14465,413,14052,0.02855167646042171,-3.27903781935352
ZCTA5 43504,473,3,470,0.006342494714587738,-3.2790749472404466
ZCTA5 59859,1291,22,1269,0.017041053446940357,-3.279589003864887
ZCTA5 61814,422,2,420,0.004739336492890996,-3.2804005454000884
ZCTA5 32544,311,0,311,0,-3.2809123733600027
ZCTA5 40949,311,0,311,0,-3.2809123733600027
ZCTA5 58005,311,0,311,0,-3.2809123733600027
ZCTA5 62536,311,0,311,0,-3.2809123733600027
ZCTA5 71007,311,0,311,0,-3.2809123733600027
ZCTA5 72680,311,0,311,0,-3.2809123733600027
ZCTA5 80456,311,0,311,0,-3.2809123733600027
ZCTA5 79718,311,0,311,0,-3.2809123733600027
ZCTA5 13752,311,0,311,0,-3.2809123733600027
ZCTA5 26338,311,0,311,0,-3.2809123733600027
ZCTA5 27966,311,0,311,0,-3.2809123733600027
ZCTA5 50249,523,4,519,0.0076481835564053535,-3.2819789552425287
ZCTA5 64088,523,4,519,0.0076481835564053535,-3.2819789552425287
ZCTA5 98858,797,10,787,0.012547051442910916,-3.2823745624055802
ZCTA5 65704,1449,26,1423,0.017943409247757072,-3.2834670382027697
ZCTA5 57075,423,2,421,0.004728132387706856,-3.285566452155285
ZCTA5 81036,423,2,421,0.004728132387706856,-3.285566452155285
ZCTA5 75668,926,13,913,0.014038876889848811,-3.2855975577820242
ZCTA5 49774,754,9,745,0.011936339522546418,-3.2858588491741654
ZCTA5 11952,1982,40,1942,0.020181634712411706,-3.286029496614149
ZCTA5 37311,10411,288,10123,0.02766304869849198,-3.2860788720436256
ZCTA5 38044,312,0,312,0,-3.28618291872281
ZCTA5 41260,312,0,312,0,-3.28618291872281
ZCTA5 43930,312,0,312,0,-3.28618291872281
ZCTA5 71340,312,0,312,0,-3.28618291872281
ZCTA5 76871,312,0,312,0,-3.28618291872281
ZCTA5 20690,312,0,312,0,-3.28618291872281
ZCTA5 26845,312,0,312,0,-3.28618291872281
ZCTA5 43338,3741,89,3652,0.023790430366212242,-3.287046046189991
ZCTA5 70053,6641,174,6467,0.026200873362445413,-3.287154203438651
ZCTA5 04684,710,8,702,0.011267605633802818,-3.287637541381554
ZCTA5 49337,4950,124,4826,0.025050505050505052,-3.2880512374051514
ZCTA5 39335,1133,18,1115,0.01588702559576346,-3.2883742231565964
ZCTA5 44677,969,14,955,0.014447884416924664,-3.2902136483464997
ZCTA5 57718,2751,61,2690,0.022173754998182478,-3.2903081632089095
ZCTA5 13160,755,9,746,0.011920529801324504,-3.2904528778910764
ZCTA5 58575,424,2,422,0.0047169811320754715,-3.290724745958709
ZCTA5 52140,313,0,313,0,-3.291445024445094
ZCTA5 53069,313,0,313,0,-3.291445024445094
ZCTA5 57456,313,0,313,0,-3.291445024445094
ZCTA5 18335,313,0,313,0,-3.291445024445094
ZCTA5 22650,313,0,313,0,-3.291445024445094
ZCTA5 25113,313,0,313,0,-3.291445024445094
ZCTA5 51561,573,5,568,0.008726003490401396,-3.291802481815485
ZCTA5 89444,1255,21,1234,0.016733067729083666,-3.2942152573797543
ZCTA5 50228,1053,16,1037,0.015194681861348529,-3.295094082205373
ZCTA5 29682,1491,27,1464,0.018108651911468814,-3.2952302837421747
ZCTA5 56228,425,2,423,0.004705882352941176,-3.295875459054401
ZCTA5 72685,425,2,423,0.004705882352941176,-3.295875459054401
ZCTA5 73027,425,2,423,0.004705882352941176,-3.295875459054401
ZCTA5 41352,314,0,314,0,-3.2966987309402667
ZCTA5 42040,314,0,314,0,-3.2966987309402667
ZCTA5 42367,314,0,314,0,-3.2966987309402667
ZCTA5 61320,314,0,314,0,-3.2966987309402667
ZCTA5 68421,314,0,314,0,-3.2966987309402667
ZCTA5 71424,314,0,314,0,-3.2966987309402667
ZCTA5 81422,314,0,314,0,-3.2966987309402667
ZCTA5 04760,314,0,314,0,-3.2966987309402667
ZCTA5 49405,574,5,569,0.008710801393728223,-3.296699112590068
ZCTA5 13144,621,6,615,0.00966183574879227,-3.2972163772115484
ZCTA5 40370,1176,19,1157,0.016156462585034014,-3.2988103411043648
ZCTA5 50854,1054,16,1038,0.015180265654648957,-3.2992610949604337
ZCTA5 90067,1375,24,1351,0.017454545454545455,-3.2993352094051867
ZCTA5 04681,477,3,474,0.006289308176100629,-3.299370642200247
ZCTA5 17064,372,1,371,0.002688172043010753,-3.29994532405566
ZCTA5 12029,426,2,424,0.004694835680751174,-3.3010186234655965
ZCTA5 56535,527,4,523,0.007590132827324478,-3.3019166264111504
ZCTA5 45876,315,0,315,0,-3.3019440783002314
ZCTA5 47427,315,0,315,0,-3.3019440783002314
ZCTA5 66951,315,0,315,0,-3.3019440783002314
ZCTA5 04063,315,0,315,0,-3.3019440783002314
ZCTA5 24265,315,0,315,0,-3.3019440783002314
ZCTA5 24925,315,0,315,0,-3.3019440783002314
ZCTA5 23055,315,0,315,0,-3.3019440783002314
ZCTA5 95552,315,0,315,0,-3.3019440783002314
ZCTA5 90405,14029,399,13630,0.028441086321191817,-3.3020856447423226
ZCTA5 88119,668,7,661,0.010479041916167664,-3.30225662166863
ZCTA5 12068,1177,19,1158,0.016142735768903994,-3.3028315122314407
ZCTA5 14516,930,13,917,0.013978494623655914,-3.302926565725207
ZCTA5 28306,15159,434,14725,0.028629856850715747,-3.3032470625323027
ZCTA5 78133,7385,196,7189,0.026540284360189573,-3.3041942665348683
ZCTA5 42085,373,1,372,0.002680965147453083,-3.3051518019054
ZCTA5 62934,427,2,425,0.00468384074941452,-3.306154270996794
ZCTA5 82633,3888,93,3795,0.023919753086419752,-3.306161226815742
ZCTA5 65257,576,5,571,0.008680555555555556,-3.3064743224297297
ZCTA5 18818,576,5,571,0.008680555555555556,-3.3064743224297297
ZCTA5 38486,316,0,316,0,-3.3071811062989522
ZCTA5 42339,316,0,316,0,-3.3071811062989522
ZCTA5 50214,316,0,316,0,-3.3071811062989522
ZCTA5 64423,316,0,316,0,-3.3071811062989522
ZCTA5 70455,316,0,316,0,-3.3071811062989522
ZCTA5 72460,316,0,316,0,-3.3071811062989522
ZCTA5 87711,316,0,316,0,-3.3071811062989522
ZCTA5 12087,316,0,316,0,-3.3071811062989522
ZCTA5 15362,316,0,316,0,-3.3071811062989522
ZCTA5 26372,316,0,316,0,-3.3071811062989522
ZCTA5 56222,803,10,793,0.012453300124533,-3.309480640110323
ZCTA5 57334,374,1,373,0.00267379679144385,-3.3103502711044426
ZCTA5 54456,2541,55,2486,0.021645021645021644,-3.3104495714140247
ZCTA5 17229,529,4,525,0.007561436672967864,-3.311846600490914
ZCTA5 79553,1573,29,1544,0.018436109345200253,-3.3124067220448556
ZCTA5 46301,317,0,317,0,-3.3124098543959746
ZCTA5 49654,317,0,317,0,-3.3124098543959746
ZCTA5 55703,317,0,317,0,-3.3124098543959746
ZCTA5 58346,317,0,317,0,-3.3124098543959746
ZCTA5 63073,317,0,317,0,-3.3124098543959746
ZCTA5 66937,317,0,317,0,-3.3124098543959746
ZCTA5 67149,317,0,317,0,-3.3124098543959746
ZCTA5 56576,317,0,317,0,-3.3124098543959746
ZCTA5 71479,317,0,317,0,-3.3124098543959746
ZCTA5 03218,317,0,317,0,-3.3124098543959746
ZCTA5 15358,317,0,317,0,-3.3124098543959746
ZCTA5 22716,317,0,317,0,-3.3124098543959746
ZCTA5 28468,2396,51,2345,0.021285475792988316,-3.312480755182009
ZCTA5 40759,847,11,836,0.012987012987012988,-3.312562319698188
ZCTA5 02535,480,3,477,0.00625,-3.314518999826695
ZCTA5 12972,2287,48,2239,0.020988194140795804,-3.3153186413586377
ZCTA5 71032,975,14,961,0.014358974358974359,-3.3158232482837446
ZCTA5 03216,933,13,920,0.013933547695605574,-3.315884488431105
ZCTA5 55741,1574,29,1545,0.018424396442185513,-3.3160436728811433
ZCTA5 30823,578,5,573,0.00865051903114187,-3.3162255980554476
ZCTA5 62701,578,5,573,0.00865051903114187,-3.3162255980554476
ZCTA5 38541,671,7,664,0.010432190760059613,-3.3164126439429227
ZCTA5 98281,671,7,664,0.010432190760059613,-3.3164126439429227
ZCTA5 40353,8488,229,8259,0.026979264844486334,-3.3174513775899217
ZCTA5 37305,318,0,318,0,-3.3176303617398917
ZCTA5 62985,318,0,318,0,-3.3176303617398917
ZCTA5 84639,318,0,318,0,-3.3176303617398917
ZCTA5 30303,1261,21,1240,0.016653449643140365,-3.3178033777735343
ZCTA5 23308,761,9,752,0.011826544021024968,-3.317920070179865
ZCTA5 62016,1380,24,1356,0.017391304347826087,-3.3183933386755795
ZCTA5 98392,1301,22,1279,0.016910069177555727,-3.3185399228416026
ZCTA5 76023,2325,49,2276,0.021075268817204302,-3.31939935994483
ZCTA5 12932,481,3,478,0.006237006237006237,-3.319554613415605
ZCTA5 29487,1100,17,1083,0.015454545454545455,-3.319898840684008
ZCTA5 68866,376,1,375,0.0026595744680851063,-3.3207233282119666
ZCTA5 16255,626,6,620,0.009584664536741214,-3.321201144326176
ZCTA5 32420,849,11,838,0.012956419316843345,-3.321428287640653
ZCTA5 61729,430,2,428,0.004651162790697674,-3.321516427117129
ZCTA5 84307,430,2,428,0.004651162790697674,-3.321516427117129
ZCTA5 51544,319,0,319,0,-3.3228426671717646
ZCTA5 87538,319,0,319,0,-3.3228426671717646
ZCTA5 61844,319,0,319,0,-3.3228426671717646
ZCTA5 67047,319,0,319,0,-3.3228426671717646
ZCTA5 65732,319,0,319,0,-3.3228426671717646
ZCTA5 79097,319,0,319,0,-3.3228426671717646
ZCTA5 01079,319,0,319,0,-3.3228426671717646
ZCTA5 08041,319,0,319,0,-3.3228426671717646
ZCTA5 11960,319,0,319,0,-3.3228426671717646
ZCTA5 24646,319,0,319,0,-3.3228426671717646
ZCTA5 98585,319,0,319,0,-3.3228426671717646
ZCTA5 98329,3895,93,3802,0.023876765083440308,-3.3240559532060807
ZCTA5 53516,935,13,922,0.013903743315508022,-3.32450473369579
ZCTA5 79083,718,8,710,0.011142061281337047,-3.32481535330598
ZCTA5 30032,17841,517,17324,0.02897819628944566,-3.324818712721691
ZCTA5 42038,2031,41,1990,0.02018709995076317,-3.325031229991895
ZCTA5 07088,1223,20,1203,0.016353229762878167,-3.325817240239686
ZCTA5 37051,1382,24,1358,0.017366136034732273,-3.3260003099881588
ZCTA5 30228,13431,380,13051,0.028292755565482837,-3.3265398518584304
ZCTA5 41826,320,0,320,0,-3.3280468092284945
ZCTA5 42054,320,0,320,0,-3.3280468092284945
ZCTA5 47981,320,0,320,0,-3.3280468092284945
ZCTA5 54563,320,0,320,0,-3.3280468092284945
ZCTA5 54734,320,0,320,0,-3.3280468092284945
ZCTA5 62634,320,0,320,0,-3.3280468092284945
ZCTA5 05652,320,0,320,0,-3.3280468092284945
ZCTA5 12035,320,0,320,0,-3.3280468092284945
ZCTA5 22627,320,0,320,0,-3.3280468092284945
ZCTA5 99113,320,0,320,0,-3.3280468092284945
ZCTA5 97459,5377,136,5241,0.025292914264459735,-3.328084733418762
ZCTA5 84041,16207,466,15741,0.028753007959523662,-3.328334866685559
ZCTA5 24067,936,13,923,0.013888888888888888,-3.3288093695893335
ZCTA5 80542,1539,28,1511,0.018193632228719947,-3.3293124403725174
ZCTA5 75844,2438,52,2386,0.02132895816242822,-3.3294475287624383
ZCTA5 37774,7765,207,7558,0.026658081133290407,-3.3304122649387438
ZCTA5 71740,581,5,576,0.008605851979345954,-3.3308079847766403
ZCTA5 76691,2366,50,2316,0.021132713440405747,-3.333000390585682
ZCTA5 33921,321,0,321,0,-3.3332428261461486
ZCTA5 40915,321,0,321,0,-3.3332428261461486
ZCTA5 21723,321,0,321,0,-3.3332428261461486
ZCTA5 95942,321,0,321,0,-3.3332428261461486
ZCTA5 38963,484,3,481,0.006198347107438017,-3.334620310416151
ZCTA5 54470,852,11,841,0.012910798122065728,-3.33469677905095
ZCTA5 23833,852,11,841,0.012910798122065728,-3.33469677905095
ZCTA5 84333,895,12,883,0.013407821229050279,-3.3351215461324095
ZCTA5 54977,629,6,623,0.009538950715421303,-3.3355256015343984
ZCTA5 94115,17208,497,16711,0.02888191538819154,-3.3355410492070217
ZCTA5 12729,765,9,756,0.011764705882352941,-3.336140064413437
ZCTA5 36425,433,2,431,0.004618937644341801,-3.3368120557055185
ZCTA5 67001,433,2,431,0.004618937644341801,-3.3368120557055185
ZCTA5 49326,1695,32,1663,0.01887905604719764,-3.337046988029354
ZCTA5 60621,10900,302,10598,0.027706422018348623,-3.337183668265476
ZCTA5 43013,322,0,322,0,-3.338430755863234
ZCTA5 49934,322,0,322,0,-3.338430755863234
ZCTA5 50278,322,0,322,0,-3.338430755863234
ZCTA5 57762,322,0,322,0,-3.338430755863234
ZCTA5 66949,322,0,322,0,-3.338430755863234
ZCTA5 69149,322,0,322,0,-3.338430755863234
ZCTA5 56167,322,0,322,0,-3.338430755863234
ZCTA5 83120,322,0,322,0,-3.338430755863234
ZCTA5 05340,322,0,322,0,-3.338430755863234
ZCTA5 21856,322,0,322,0,-3.338430755863234
ZCTA5 26767,322,0,322,0,-3.338430755863234
ZCTA5 60556,721,8,713,0.011095700416088766,-3.3386769143453563
ZCTA5 63869,1503,27,1476,0.017964071856287425,-3.3396352142726515
ZCTA5 68624,380,1,379,0.002631578947368421,-3.3413749149927776
ZCTA5 14418,535,4,531,0.007476635514018692,-3.341483299827055
ZCTA5 30258,1023,15,1008,0.01466275659824047,-3.3424294174554334
ZCTA5 12134,1465,26,1439,0.017747440273037544,-3.343258245661588
ZCTA5 92003,1773,34,1739,0.019176536943034405,-3.3433061325099143
ZCTA5 45841,323,0,323,0,-3.343610636023932
ZCTA5 50569,323,0,323,0,-3.343610636023932
ZCTA5 14720,323,0,323,0,-3.343610636023932
ZCTA5 13681,323,0,323,0,-3.343610636023932
ZCTA5 25118,323,0,323,0,-3.343610636023932
ZCTA5 54202,677,7,670,0.0103397341211226,-3.3445852585076494
ZCTA5 62090,486,3,483,0.006172839506172839,-3.3446300847522554
ZCTA5 13146,811,10,801,0.012330456226880395,-3.345380183197488
ZCTA5 32311,8139,218,7921,0.02678461727484949,-3.346189627776151
ZCTA5 05483,536,4,532,0.007462686567164179,-3.3464006433833053
ZCTA5 47352,381,1,380,0.0026246719160104987,-3.3465183232845486
ZCTA5 57063,381,1,380,0.0026246719160104987,-3.3465183232845486
ZCTA5 51050,1024,15,1009,0.0146484375,-3.346610831711988
ZCTA5 47003,435,2,433,0.004597701149425287,-3.3469725895209117
ZCTA5 34744,15738,451,15287,0.028656754352522556,-3.3469748459489623
ZCTA5 32131,1736,33,1703,0.019009216589861752,-3.3470063697680925
ZCTA5 68005,9331,254,9077,0.027221090987032473,-3.3483851181520063
ZCTA5 29592,324,0,324,0,-3.3487825039812846
ZCTA5 40157,324,0,324,0,-3.3487825039812846
ZCTA5 41544,324,0,324,0,-3.3487825039812846
ZCTA5 65075,324,0,324,0,-3.3487825039812846
ZCTA5 56230,324,0,324,0,-3.3487825039812846
ZCTA5 75468,324,0,324,0,-3.3487825039812846
ZCTA5 04848,324,0,324,0,-3.3487825039812846
ZCTA5 04978,324,0,324,0,-3.3487825039812846
ZCTA5 25647,324,0,324,0,-3.3487825039812846
ZCTA5 89440,324,0,324,0,-3.3487825039812846
ZCTA5 44854,678,7,671,0.01032448377581121,-3.349262796568833
ZCTA5 50602,632,6,626,0.00949367088607595,-3.349800824854471
ZCTA5 15868,585,5,580,0.008547008547008548,-3.350168878248552
ZCTA5 71762,941,13,928,0.01381509032943677,-3.3502780016412386
ZCTA5 54230,1851,36,1815,0.019448946515397084,-3.350879886361983
ZCTA5 58558,382,1,381,0.002617801047120419,-3.351654005410238
ZCTA5 64491,856,11,845,0.012850467289719626,-3.352331647981395
ZCTA5 54889,1108,17,1091,0.015342960288808664,-3.352605009505895
ZCTA5 07670,4600,113,4487,0.024565217391304347,-3.352714176574178
ZCTA5 65605,5115,128,4987,0.025024437927663734,-3.3527704937095315
ZCTA5 68620,1149,18,1131,0.015665796344647518,-3.3532145538067724
ZCTA5 30545,325,0,325,0,-3.353946396800337
ZCTA5 47950,325,0,325,0,-3.353946396800337
ZCTA5 66010,325,0,325,0,-3.353946396800337
ZCTA5 71404,325,0,325,0,-3.353946396800337
ZCTA5 04616,325,0,325,0,-3.353946396800337
ZCTA5 14026,325,0,325,0,-3.353946396800337
ZCTA5 17235,325,0,325,0,-3.353946396800337
ZCTA5 15620,325,0,325,0,-3.353946396800337
ZCTA5 24817,325,0,325,0,-3.353946396800337
ZCTA5 62312,813,10,803,0.012300123001230012,-3.354312449536156
ZCTA5 16347,942,13,929,0.013800424628450107,-3.3545608741385733
ZCTA5 29031,488,3,485,0.006147540983606557,-3.354612882440679
ZCTA5 62010,4532,111,4421,0.024492497793468668,-3.35506545908412
ZCTA5 89406,9796,268,9528,0.02735810534912209,-3.35538804475899
ZCTA5 22712,2953,66,2887,0.022350152387402643,-3.3556612763809945
ZCTA5 40507,1271,21,1250,0.016522423288749016,-3.356910179007332
ZCTA5 63648,437,2,435,0.004576659038901602,-3.3571041625247213
ZCTA5 95456,437,2,435,0.004576659038901602,-3.3571041625247213
ZCTA5 37138,9402,256,9146,0.02722824930865773,-3.3572400088320618
ZCTA5 34251,1815,35,1780,0.01928374655647383,-3.357273496839833
ZCTA5 44084,1231,20,1211,0.016246953696181964,-3.3574132076502288
ZCTA5 39647,326,0,326,0,-3.3591023512612357
ZCTA5 41727,326,0,326,0,-3.3591023512612357
ZCTA5 50055,326,0,326,0,-3.3591023512612357
ZCTA5 61436,326,0,326,0,-3.3591023512612357
ZCTA5 68663,326,0,326,0,-3.3591023512612357
ZCTA5 72047,326,0,326,0,-3.3591023512612357
ZCTA5 82842,326,0,326,0,-3.3591023512612357
ZCTA5 87510,326,0,326,0,-3.3591023512612357
ZCTA5 12480,326,0,326,0,-3.3591023512612357
ZCTA5 66835,489,3,486,0.006134969325153374,-3.359594229147029
ZCTA5 58788,539,4,535,0.0074211502782931356,-3.361115224413917
ZCTA5 27252,901,12,889,0.013318534961154272,-3.361186303945788
ZCTA5 45760,1548,28,1520,0.01808785529715762,-3.362177143642652
ZCTA5 39755,327,0,327,0,-3.3642504038622874
ZCTA5 45330,327,0,327,0,-3.3642504038622874
ZCTA5 59057,327,0,327,0,-3.3642504038622874
ZCTA5 70397,327,0,327,0,-3.3642504038622874
ZCTA5 04424,327,0,327,0,-3.3642504038622874
ZCTA5 02894,327,0,327,0,-3.3642504038622874
ZCTA5 11959,327,0,327,0,-3.3642504038622874
ZCTA5 18030,327,0,327,0,-3.3642504038622874
ZCTA5 20896,327,0,327,0,-3.3642504038622874
ZCTA5 85935,1968,39,1929,0.019817073170731708,-3.364342064233847
ZCTA5 56253,490,3,487,0.006122448979591836,-3.3645689083052552
ZCTA5 30802,2006,40,1966,0.019940179461615155,-3.3660051199466867
ZCTA5 84738,3243,74,3169,0.022818378045020044,-3.3682917018909833
ZCTA5 62249,6142,158,5984,0.025724519700423314,-3.368855304109373
ZCTA5 47975,328,0,328,0,-3.3693905908229698
ZCTA5 52569,328,0,328,0,-3.3693905908229698
ZCTA5 52165,328,0,328,0,-3.3693905908229698
ZCTA5 57046,328,0,328,0,-3.3693905908229698
ZCTA5 68727,328,0,328,0,-3.3693905908229698
ZCTA5 84620,328,0,328,0,-3.3693905908229698
ZCTA5 84783,328,0,328,0,-3.3693905908229698
ZCTA5 13319,328,0,328,0,-3.3693905908229698
ZCTA5 24437,328,0,328,0,-3.3693905908229698
ZCTA5 70819,1550,28,1522,0.01806451612903226,-3.369458314773022
ZCTA5 33897,6345,164,6181,0.025847123719464144,-3.369764488024407
ZCTA5 37012,988,14,974,0.01417004048582996,-3.3708811943937014
ZCTA5 54213,541,4,537,0.0073937153419593345,-3.3708939567758143
ZCTA5 51521,817,10,807,0.012239902080783354,-3.372126431905775
ZCTA5 17752,1705,32,1673,0.0187683284457478,-3.3723024949395817
ZCTA5 43119,10299,283,10016,0.02747839596077289,-3.3725671885078508
ZCTA5 59522,683,7,676,0.010248901903367497,-3.3725746749263146
ZCTA5 10974,1113,17,1096,0.015274034141958671,-3.372948804157962
ZCTA5 52141,590,5,585,0.00847457627118644,-3.374239486548829
ZCTA5 33960,329,0,329,0,-3.374522948086909
ZCTA5 39668,329,0,329,0,-3.374522948086909
ZCTA5 41512,329,0,329,0,-3.374522948086909
ZCTA5 10505,329,0,329,0,-3.374522948086909
ZCTA5 26369,329,0,329,0,-3.374522948086909
ZCTA5 98008,9214,250,8964,0.027132624267419143,-3.374550928318988
ZCTA5 73852,818,10,808,0.012224938875305624,-3.3765694570634257
ZCTA5 33442,13692,387,13305,0.028264680105170904,-3.3769754529436975
ZCTA5 24801,1435,25,1410,0.017421602787456445,-3.3774919032364656
ZCTA5 47581,1591,29,1562,0.018227529855436832,-3.3775717568485857
ZCTA5 16841,2270,47,2223,0.020704845814977973,-3.3780489871456547
ZCTA5 67050,638,6,632,0.009404388714733543,-3.3782053916887147
ZCTA5 74834,2781,61,2720,0.02193455591513844,-3.3783493979116965
ZCTA5 04667,591,5,586,0.008460236886632826,-3.3790363972894766
ZCTA5 04219,591,5,586,0.008460236886632826,-3.3790363972894766
ZCTA5 56288,2010,40,1970,0.01990049751243781,-3.379252981978916
ZCTA5 16111,493,3,490,0.006085192697768763,-3.379453191878194
ZCTA5 35808,330,0,330,0,-3.3796475113248072
ZCTA5 49725,330,0,330,0,-3.3796475113248072
ZCTA5 59027,330,0,330,0,-3.3796475113248072
ZCTA5 57235,330,0,330,0,-3.3796475113248072
ZCTA5 63388,330,0,330,0,-3.3796475113248072
ZCTA5 68757,330,0,330,0,-3.3796475113248072
ZCTA5 71407,330,0,330,0,-3.3796475113248072
ZCTA5 77585,330,0,330,0,-3.3796475113248072
ZCTA5 25529,330,0,330,0,-3.3796475113248072
ZCTA5 94938,330,0,330,0,-3.3796475113248072
ZCTA5 96091,330,0,330,0,-3.3796475113248072
ZCTA5 96142,330,0,330,0,-3.3796475113248072
ZCTA5 28056,12786,359,12427,0.028077584858438916,-3.3809864825167226
ZCTA5 52639,819,10,809,0.01221001221001221,-3.381008314759547
ZCTA5 27521,2234,46,2188,0.020590868397493287,-3.3811143839114615
ZCTA5 01081,775,9,766,0.011612903225806452,-3.3813754860643614
ZCTA5 62910,1074,16,1058,0.0148975791433892,-3.381935631805666
ZCTA5 62682,388,1,387,0.002577319587628866,-3.3823077442580978
ZCTA5 66845,442,2,440,0.004524886877828055,-3.3823079392298596
ZCTA5 67839,639,6,633,0.009389671361502348,-3.382920769525414
ZCTA5 20036,4058,97,3961,0.02390340068999507,-3.383460666777159
ZCTA5 56354,592,5,587,0.008445945945945946,-3.383827614809561
ZCTA5 39160,1033,15,1018,0.01452081316553727,-3.3840965740499502
ZCTA5 28273,14474,411,14063,0.028395744092856157,-3.384384031256982
ZCTA5 26257,494,3,491,0.006072874493927126,-3.384401451472094
ZCTA5 29037,331,0,331,0,-3.384764315937339
ZCTA5 52135,331,0,331,0,-3.384764315937339
ZCTA5 59853,331,0,331,0,-3.384764315937339
ZCTA5 12092,331,0,331,0,-3.384764315937339
ZCTA5 17850,331,0,331,0,-3.384764315937339
ZCTA5 18056,331,0,331,0,-3.384764315937339
ZCTA5 26750,331,0,331,0,-3.384764315937339
ZCTA5 02817,2161,44,2117,0.02036094400740398,-3.3848531105562647
ZCTA5 17878,544,4,540,0.007352941176470588,-3.385516006732423
ZCTA5 61260,443,2,441,0.004514672686230248,-3.3873274712578465
ZCTA5 10983,1975,39,1936,0.019746835443037975,-3.3876787831630404
ZCTA5 60061,9980,273,9707,0.027354709418837674,-3.388640497924576
ZCTA5 13367,3108,70,3038,0.02252252252252252,-3.3891627384990914
ZCTA5 37366,332,0,332,0,-3.3898733970580026
ZCTA5 62028,332,0,332,0,-3.3898733970580026
ZCTA5 71660,332,0,332,0,-3.3898733970580026
ZCTA5 08511,332,0,332,0,-3.3898733970580026
ZCTA5 28787,8462,227,8235,0.026825809501299928,-3.3908687304116945
ZCTA5 31407,4823,119,4704,0.02467343976777939,-3.391222910622281
ZCTA5 17040,908,12,896,0.013215859030837005,-3.3914236085058027
ZCTA5 82935,4651,114,4537,0.0245108578800258,-3.3918649975215818
ZCTA5 67029,444,2,442,0.0045045045045045045,-3.3923399955072426
ZCTA5 47872,2930,65,2865,0.02218430034129693,-3.3924925966779296
ZCTA5 32038,3887,92,3795,0.023668639053254437,-3.392800582692923
ZCTA5 37752,2422,51,2371,0.021056977704376548,-3.392941206600371
ZCTA5 13459,951,13,938,0.013669821240799159,-3.392945680205484
ZCTA5 33042,3002,67,2935,0.022318454363757494,-3.3930457706944996
ZCTA5 48747,594,5,589,0.008417508417508417,-3.3933930443222216
ZCTA5 61880,1400,24,1376,0.017142857142857144,-3.394049685095303
ZCTA5 16442,1077,16,1061,0.014856081708449397,-3.394229135398827
ZCTA5 62324,496,3,493,0.006048387096774193,-3.3942783661579314
ZCTA5 35234,1977,39,1938,0.019726858877086494,-3.3943331787290134
ZCTA5 64842,333,0,333,0,-3.3949747895559343
ZCTA5 65262,333,0,333,0,-3.3949747895559343
ZCTA5 68735,333,0,333,0,-3.3949747895559343
ZCTA5 83523,333,0,333,0,-3.3949747895559343
ZCTA5 75020,8829,238,8591,0.026956620228791483,-3.3952661554733643
ZCTA5 28555,1902,37,1865,0.019453207150368034,-3.395695727578507
ZCTA5 25136,688,7,681,0.010174418604651164,-3.3957615373077688
ZCTA5 37367,3924,93,3831,0.023700305810397553,-3.3978788018855726
ZCTA5 16678,1078,16,1062,0.014842300556586271,-3.3983208240039513
ZCTA5 59353,497,3,494,0.006036217303822937,-3.399207070030403
ZCTA5 56144,497,3,494,0.006036217303822937,-3.399207070030403
ZCTA5 14623,8533,229,8304,0.026836985819758585,-3.39932314145081
ZCTA5 28101,334,0,334,0,-3.4000685280386866
ZCTA5 38588,334,0,334,0,-3.4000685280386866
ZCTA5 40737,334,0,334,0,-3.4000685280386866
ZCTA5 43359,334,0,334,0,-3.4000685280386866
ZCTA5 50153,334,0,334,0,-3.4000685280386866
ZCTA5 55953,334,0,334,0,-3.4000685280386866
ZCTA5 66024,334,0,334,0,-3.4000685280386866
ZCTA5 72934,334,0,334,0,-3.4000685280386866
ZCTA5 82832,334,0,334,0,-3.4000685280386866
ZCTA5 84033,334,0,334,0,-3.4000685280386866
ZCTA5 01270,334,0,334,0,-3.4000685280386866
ZCTA5 15675,334,0,334,0,-3.4000685280386866
ZCTA5 18354,334,0,334,0,-3.4000685280386866
ZCTA5 25039,334,0,334,0,-3.4000685280386866
ZCTA5 48872,2680,58,2622,0.02164179104477612,-3.4007196662786754
ZCTA5 18202,4793,118,4675,0.02461923638639683,-3.4015280210335166
ZCTA5 52249,392,1,391,0.002551020408163265,-3.402593281342461
ZCTA5 43406,735,8,727,0.010884353741496598,-3.402799554055111
ZCTA5 00719,8701,234,8467,0.026893460521779107,-3.4033278768431003
ZCTA5 38658,780,9,771,0.011538461538461539,-3.4038274445130616
ZCTA5 13810,498,3,495,0.006024096385542169,-3.404129303866456
ZCTA5 59922,868,11,857,0.012672811059907835,-3.404854922847784
ZCTA5 58282,690,7,683,0.010144927536231883,-3.405001680275547
ZCTA5 33849,335,0,335,0,-3.4051546468549647
ZCTA5 36444,335,0,335,0,-3.4051546468549647
ZCTA5 68966,335,0,335,0,-3.4051546468549647
ZCTA5 05751,335,0,335,0,-3.4051546468549647
ZCTA5 16679,335,0,335,0,-3.4051546468549647
ZCTA5 20674,335,0,335,0,-3.4051546468549647
ZCTA5 95701,335,0,335,0,-3.4051546468549647
ZCTA5 21561,1121,17,1104,0.015165031222123104,-3.405344810137985
ZCTA5 67416,393,1,392,0.002544529262086514,-3.407646176690973
ZCTA5 66223,9596,261,9335,0.027198832847019593,-3.40772467180328
ZCTA5 49644,912,12,900,0.013157894736842105,-3.408620163035513
ZCTA5 37885,2464,52,2412,0.021103896103896104,-3.409281631445468
ZCTA5 55395,1163,18,1145,0.015477214101461736,-3.4093459724632726
ZCTA5 68017,691,7,684,0.010130246020260492,-3.4096143937059717
ZCTA5 69339,691,7,684,0.010130246020260492,-3.4096143937059717
ZCTA5 52345,549,4,545,0.007285974499089253,-3.409764714121625
ZCTA5 61725,549,4,545,0.007285974499089253,-3.409764714121625
ZCTA5 52650,336,0,336,0,-3.410233180097332
ZCTA5 62462,336,0,336,0,-3.410233180097332
ZCTA5 62217,336,0,336,0,-3.410233180097332
ZCTA5 68872,336,0,336,0,-3.410233180097332
ZCTA5 79541,336,0,336,0,-3.410233180097332
ZCTA5 17046,11567,321,11246,0.027751361632229618,-3.4108948881131598
ZCTA5 40380,2611,56,2555,0.021447721179624665,-3.4118036338222657
ZCTA5 61262,448,2,446,0.004464285714285714,-3.412320575868319
ZCTA5 57014,598,5,593,0.008361204013377926,-3.4124563948596265
ZCTA5 50598,394,1,393,0.0025380710659898475,-3.4126917399339507
ZCTA5 55917,1405,24,1381,0.01708185053380783,-3.4128218966936013
ZCTA5 61230,500,3,497,0.006,-3.413954457395604
ZCTA5 38864,692,7,685,0.010115606936416185,-3.414222220462532
ZCTA5 80480,550,4,546,0.007272727272727273,-3.414596438061478
ZCTA5 12154,1082,16,1066,0.014787430683918669,-3.414657005838041
ZCTA5 41843,337,0,337,0,-3.415304161604873
ZCTA5 49874,337,0,337,0,-3.415304161604873
ZCTA5 72717,337,0,337,0,-3.415304161604873
ZCTA5 01222,337,0,337,0,-3.415304161604873
ZCTA5 23357,337,0,337,0,-3.415304161604873
ZCTA5 21722,2021,40,1981,0.01979218208807521,-3.415566326262292
ZCTA5 16248,1246,20,1226,0.016051364365971106,-3.41620102315162
ZCTA5 62849,827,10,817,0.012091898428053204,-3.4163703738739652
ZCTA5 46149,738,8,730,0.01084010840108401,-3.416421316335921
ZCTA5 37118,338,0,338,0,-3.4203676249658255
ZCTA5 41566,338,0,338,0,-3.4203676249658255
ZCTA5 61345,338,0,338,0,-3.4203676249658255
ZCTA5 18451,338,0,338,0,-3.4203676249658255
ZCTA5 89018,338,0,338,0,-3.4203676249658255
ZCTA5 15725,647,6,641,0.00927357032457496,-3.420454202564466
ZCTA5 73848,739,8,731,0.010825439783491205,-3.420952737142279
ZCTA5 24290,784,9,775,0.011479591836734694,-3.4217107462597007
ZCTA5 04289,694,7,687,0.010086455331412104,-3.423423269662976
ZCTA5 52346,502,3,499,0.00597609561752988,-3.423754017254397
ZCTA5 27864,1986,39,1947,0.019637462235649546,-3.4242056186534877
ZCTA5 27844,1167,18,1149,0.015424164524421594,-3.425282102197472
ZCTA5 38674,339,0,339,0,-3.4254236035201777
ZCTA5 36374,339,0,339,0,-3.4254236035201777
ZCTA5 50105,339,0,339,0,-3.4254236035201777
ZCTA5 66415,339,0,339,0,-3.4254236035201777
ZCTA5 75928,339,0,339,0,-3.4254236035201777
ZCTA5 15083,339,0,339,0,-3.4254236035201777
ZCTA5 60476,1043,15,1028,0.014381591562799617,-3.4254412082851275
ZCTA5 52211,1126,17,1109,0.015097690941385435,-3.425497091364121
ZCTA5 49250,2433,51,2382,0.02096177558569667,-3.426751786370458
ZCTA5 49304,1566,28,1538,0.017879948914431672,-3.4274219551088243
ZCTA5 38390,397,1,396,0.0025188916876574307,-3.4277847493391898
ZCTA5 29055,1605,29,1576,0.01806853582554517,-3.427822360763377
ZCTA5 00957,14440,409,14031,0.02832409972299169,-3.4282838754288627
ZCTA5 85637,503,3,500,0.005964214711729622,-3.428644258474708
ZCTA5 41043,649,6,643,0.009244992295839754,-3.429785480663113
ZCTA5 15437,917,12,905,0.013086150490730643,-3.4300330869363496
ZCTA5 36720,340,0,340,0,-3.4304721303622276
ZCTA5 40510,340,0,340,0,-3.4304721303622276
ZCTA5 41835,340,0,340,0,-3.4304721303622276
ZCTA5 50157,340,0,340,0,-3.4304721303622276
ZCTA5 63868,340,0,340,0,-3.4304721303622276
ZCTA5 71063,340,0,340,0,-3.4304721303622276
ZCTA5 15351,340,0,340,0,-3.4304721303622276
ZCTA5 26852,340,0,340,0,-3.4304721303622276
ZCTA5 63441,452,2,450,0.004424778761061947,-3.432191254675377
ZCTA5 71031,398,1,397,0.002512562814070352,-3.4328012953782343
ZCTA5 96002,12658,354,12304,0.027966503397061148,-3.4335208675732347
ZCTA5 56364,2139,43,2096,0.020102851799906497,-3.433960278284742
ZCTA5 75473,1371,23,1348,0.016776075857038657,-3.4342377829091255
ZCTA5 71060,918,12,906,0.013071895424836602,-3.4343047177158845
ZCTA5 66743,1568,28,1540,0.017857142857142856,-3.434632016159169
ZCTA5 80241,11484,318,11166,0.027690700104493208,-3.43478650210092
ZCTA5 36268,2362,49,2313,0.020745131244707875,-3.434934891991657
ZCTA5 00656,6478,167,6311,0.025779561593084286,-3.4351391535867153
ZCTA5 72057,341,0,341,0,-3.43551323834311
ZCTA5 12494,341,0,341,0,-3.43551323834311
ZCTA5 53911,505,3,502,0.005940594059405941,-3.4384057801160655
ZCTA5 71039,555,4,551,0.007207207207207207,-3.4386661020475877
ZCTA5 58621,651,6,645,0.009216589861751152,-3.439096177446209
ZCTA5 40855,342,0,342,0,-3.4405469600732905
ZCTA5 04617,342,0,342,0,-3.4405469600732905
ZCTA5 05441,342,0,342,0,-3.4405469600732905
ZCTA5 17016,342,0,342,0,-3.4405469600732905
ZCTA5 18241,342,0,342,0,-3.4405469600732905
ZCTA5 25313,5154,128,5026,0.02483507954986418,-3.441127711322754
ZCTA5 14715,1130,17,1113,0.01504424778761062,-3.441566727875812
ZCTA5 76137,19982,581,19401,0.029076168551696528,-3.4416475793726744
ZCTA5 50703,7724,204,7520,0.02641118591403418,-3.442277514386713
ZCTA5 48767,833,10,823,0.012004801920768308,-3.4427204286365325
ZCTA5 97062,11359,314,11045,0.027643278457610707,-3.4441487275892317
ZCTA5 63664,3520,81,3439,0.023011363636363635,-3.4455218170950865
ZCTA5 31050,343,0,343,0,-3.445573327925029
ZCTA5 61564,343,0,343,0,-3.445573327925029
ZCTA5 65790,343,0,343,0,-3.445573327925029
ZCTA5 68404,343,0,343,0,-3.445573327925029
ZCTA5 83615,343,0,343,0,-3.445573327925029
ZCTA5 85626,343,0,343,0,-3.445573327925029
ZCTA5 03241,343,0,343,0,-3.445573327925029
ZCTA5 97876,343,0,343,0,-3.445573327925029
ZCTA5 53956,1294,21,1273,0.01622874806800618,-3.445895910992633
ZCTA5 47619,699,7,692,0.010014306151645207,-3.4463413442768003
ZCTA5 62340,699,7,692,0.010014306151645207,-3.4463413442768003
ZCTA5 53525,1493,26,1467,0.017414601473543203,-3.44657617084227
ZCTA5 43787,1254,20,1234,0.01594896331738437,-3.447316253587186
ZCTA5 63014,401,1,400,0.0024937655860349127,-3.447807988851567
ZCTA5 13338,557,4,553,0.00718132854578097,-3.4482528323732735
ZCTA5 76849,1650,30,1620,0.01818181818181818,-3.449953932200097
ZCTA5 31568,344,0,344,0,-3.450592374034806
ZCTA5 50532,344,0,344,0,-3.450592374034806
ZCTA5 92075,5330,133,5197,0.024953095684803,-3.4514740965618063
ZCTA5 49076,1455,25,1430,0.01718213058419244,-3.4517453572222045
ZCTA5 54810,965,13,952,0.013471502590673576,-3.4520890370086796
ZCTA5 43348,879,11,868,0.012514220705346985,-3.452509293456295
ZCTA5 41183,654,6,648,0.009174311926605505,-3.4530239020561666
ZCTA5 43106,654,6,648,0.009174311926605505,-3.4530239020561666
ZCTA5 39363,558,4,554,0.007168458781362007,-3.453037462720195
ZCTA5 29669,4608,112,4496,0.024305555555555556,-3.453651204416959
ZCTA5 36029,345,0,345,0,-3.4556041303057214
ZCTA5 37057,345,0,345,0,-3.4556041303057214
ZCTA5 58849,345,0,345,0,-3.4556041303057214
ZCTA5 17037,345,0,345,0,-3.4556041303057214
ZCTA5 48628,880,11,869,0.0125,-3.456818607020673
ZCTA5 27508,457,2,455,0.00437636761487965,-3.4568776855881094
ZCTA5 29593,747,8,739,0.0107095046854083,-3.4570408704799074
ZCTA5 16340,747,8,739,0.0107095046854083,-3.4570408704799074
ZCTA5 56579,509,3,506,0.005893909626719057,-3.457853624668461
ZCTA5 08030,4679,114,4565,0.024364180380423168,-3.457855561335043
ZCTA5 75946,1338,22,1316,0.016442451420029897,-3.4605204452849336
ZCTA5 47551,346,0,346,0,-3.460608628409858
ZCTA5 57353,346,0,346,0,-3.460608628409858
ZCTA5 16131,346,0,346,0,-3.460608628409858
ZCTA5 26160,346,0,346,0,-3.460608628409858
ZCTA5 62275,1497,26,1471,0.01736806947227789,-3.461202177197417
ZCTA5 46989,1298,21,1277,0.016178736517719568,-3.4612378324056277
ZCTA5 03570,3914,92,3822,0.02350536535513541,-3.461369200518496
ZCTA5 06796,458,2,456,0.004366812227074236,-3.4617949799848797
ZCTA5 50036,6896,179,6717,0.02595707656612529,-3.4622569340118217
ZCTA5 15864,656,6,650,0.009146341463414634,-3.46228368245441
ZCTA5 36768,347,0,347,0,-3.465605899790621
ZCTA5 43153,347,0,347,0,-3.465605899790621
ZCTA5 48807,347,0,347,0,-3.465605899790621
ZCTA5 50480,347,0,347,0,-3.465605899790621
ZCTA5 52649,347,0,347,0,-3.465605899790621
ZCTA5 58348,347,0,347,0,-3.465605899790621
ZCTA5 04535,347,0,347,0,-3.465605899790621
ZCTA5 67487,561,4,557,0.0071301247771836,-3.4673566505978517
ZCTA5 99031,561,4,557,0.0071301247771836,-3.4673566505978517
ZCTA5 02892,1771,33,1738,0.018633540372670808,-3.4684976722989638
ZCTA5 14737,1771,33,1738,0.018633540372670808,-3.4684976722989638
ZCTA5 21798,750,8,742,0.010666666666666666,-3.4704999021011442
ZCTA5 04076,1054,15,1039,0.014231499051233396,-3.4705553674523637
ZCTA5 38966,348,0,348,0,-3.4705959756650384
ZCTA5 40022,348,0,348,0,-3.4705959756650384
ZCTA5 39461,348,0,348,0,-3.4705959756650384
ZCTA5 44454,348,0,348,0,-3.4705959756650384
ZCTA5 56385,348,0,348,0,-3.4705959756650384
ZCTA5 05905,348,0,348,0,-3.4705959756650384
ZCTA5 12732,348,0,348,0,-3.4705959756650384
ZCTA5 44629,1012,14,998,0.01383399209486166,-3.471027871760064
ZCTA5 47838,658,6,652,0.00911854103343465,-3.4715233080416112
ZCTA5 78676,5476,137,5339,0.02501826150474799,-3.4716090545822156
ZCTA5 16319,562,4,558,0.0071174377224199285,-3.4721182104691537
ZCTA5 13612,970,13,957,0.013402061855670102,-3.473047884774364
ZCTA5 46538,1461,25,1436,0.017111567419575632,-3.473854174077955
ZCTA5 06420,1618,29,1589,0.01792336217552534,-3.4741508405864057
ZCTA5 35176,349,0,349,0,-3.475578887026039
ZCTA5 47578,349,0,349,0,-3.475578887026039
ZCTA5 84726,349,0,349,0,-3.475578887026039
ZCTA5 12873,349,0,349,0,-3.475578887026039
ZCTA5 08340,349,0,349,0,-3.475578887026039
ZCTA5 22850,349,0,349,0,-3.475578887026039
ZCTA5 80233,17057,489,16568,0.02866858181391804,-3.475817749941518
ZCTA5 44234,1302,21,1281,0.016129032258064516,-3.4765407527305583
ZCTA5 55032,1302,21,1281,0.016129032258064516,-3.4765407527305583
ZCTA5 62001,706,7,699,0.009915014164305949,-3.47822639040002
ZCTA5 62838,706,7,699,0.009915014164305949,-3.47822639040002
ZCTA5 44608,885,11,874,0.012429378531073447,-3.478308665764659
ZCTA5 49519,11315,312,11003,0.0275740167918692,-3.4784433027238784
ZCTA5 16050,612,5,607,0.008169934640522876,-3.478484285066266
ZCTA5 43003,1014,14,1000,0.013806706114398421,-3.4792879900046785
ZCTA5 29828,350,0,350,0,-3.4805546646446968
ZCTA5 50522,350,0,350,0,-3.4805546646446968
ZCTA5 52729,350,0,350,0,-3.4805546646446968
ZCTA5 57314,350,0,350,0,-3.4805546646446968
ZCTA5 61067,350,0,350,0,-3.4805546646446968
ZCTA5 68331,350,0,350,0,-3.4805546646446968
ZCTA5 11948,350,0,350,0,-3.4805546646446968
ZCTA5 15686,350,0,350,0,-3.4805546646446968
ZCTA5 20645,350,0,350,0,-3.4805546646446968
ZCTA5 22935,350,0,350,0,-3.4805546646446968
ZCTA5 58474,1140,17,1123,0.014912280701754385,-3.4815402098632924
ZCTA5 68939,514,3,511,0.005836575875486381,-3.4820242985808396
ZCTA5 91107,12462,347,12115,0.027844647729096453,-3.4824832862167034
ZCTA5 35548,707,7,700,0.009900990099009901,-3.4827625559364934
ZCTA5 18446,1344,22,1322,0.01636904761904762,-3.4832359395751626
ZCTA5 43758,1223,19,1204,0.01553556827473426,-3.4848365700456503
ZCTA5 71327,1464,25,1439,0.01707650273224044,-3.4848800441214878
ZCTA5 35571,351,0,351,0,-3.48552333907245
ZCTA5 45321,351,0,351,0,-3.48552333907245
ZCTA5 62036,351,0,351,0,-3.48552333907245
ZCTA5 69028,351,0,351,0,-3.48552333907245
ZCTA5 01253,351,0,351,0,-3.48552333907245
ZCTA5 10597,351,0,351,0,-3.48552333907245
ZCTA5 14802,351,0,351,0,-3.48552333907245
ZCTA5 55113,17869,514,17355,0.028764900106329396,-3.485987698803866
ZCTA5 42206,2118,42,2076,0.019830028328611898,-3.4868864563140787
ZCTA5 91320,15032,426,14606,0.028339542309739223,-3.4873239645168894
ZCTA5 41086,1016,14,1002,0.013779527559055118,-3.487535212686514
ZCTA5 62237,1016,14,1002,0.013779527559055118,-3.487535212686514
ZCTA5 58249,1100,16,1084,0.014545454545454545,-3.48757325757883
ZCTA5 19021,3713,86,3627,0.023161863722057634,-3.487720480824141
ZCTA5 14517,1265,20,1245,0.015810276679841896,-3.489834136592683
ZCTA5 36775,352,0,352,0,-3.4904849406432854
ZCTA5 42451,352,0,352,0,-3.4904849406432854
ZCTA5 49638,352,0,352,0,-3.4904849406432854
ZCTA5 61484,352,0,352,0,-3.4904849406432854
ZCTA5 61367,352,0,352,0,-3.4904849406432854
ZCTA5 56647,352,0,352,0,-3.4904849406432854
ZCTA5 24941,352,0,352,0,-3.4904849406432854
ZCTA5 24280,352,0,352,0,-3.4904849406432854
ZCTA5 61770,464,2,462,0.004310344827586207,-3.491160964956631
ZCTA5 24431,1017,14,1003,0.01376597836774828,-3.4916540044728994
ZCTA5 28504,8785,235,8550,0.026750142287990893,-3.494418947090408
ZCTA5 05651,663,6,657,0.00904977375565611,-3.494534974893893
ZCTA5 41262,353,0,353,0,-3.4954394994759044
ZCTA5 66771,353,0,353,0,-3.4954394994759044
ZCTA5 78623,353,0,353,0,-3.4954394994759044
ZCTA5 80820,353,0,353,0,-3.4954394994759044
ZCTA5 04739,353,0,353,0,-3.4954394994759044
ZCTA5 13469,353,0,353,0,-3.4954394994759044
ZCTA5 23011,353,0,353,0,-3.4954394994759044
ZCTA5 71220,8220,218,8002,0.026520681265206812,-3.495874559077736
ZCTA5 80105,465,2,463,0.004301075268817204,-3.4960325674640824
ZCTA5 70538,5144,127,5017,0.02468895800933126,-3.496068900009162
ZCTA5 33763,9416,254,9162,0.02697536108751062,-3.4962047803821914
ZCTA5 46939,801,9,792,0.011235955056179775,-3.496955616843029
ZCTA5 61529,1061,15,1046,0.01413760603204524,-3.4990689456350745
ZCTA5 67030,846,10,836,0.01182033096926714,-3.499318846080996
ZCTA5 52206,890,11,879,0.012359550561797753,-3.4997053312922737
ZCTA5 31829,354,0,354,0,-3.500387045475851
ZCTA5 58718,354,0,354,0,-3.500387045475851
ZCTA5 63545,354,0,354,0,-3.500387045475851
ZCTA5 71468,354,0,354,0,-3.500387045475851
ZCTA5 88325,354,0,354,0,-3.500387045475851
ZCTA5 16851,354,0,354,0,-3.500387045475851
ZCTA5 24323,354,0,354,0,-3.500387045475851
ZCTA5 50632,466,2,464,0.004291845493562232,-3.5008977424378465
ZCTA5 77640,6341,162,6179,0.02554802081690585,-3.501155400938784
ZCTA5 30456,757,8,749,0.010568031704095112,-3.5017497860701012
ZCTA5 28023,5661,142,5519,0.025083907436848612,-3.5022966061594722
ZCTA5 78071,1062,15,1047,0.014124293785310734,-3.503130058340445
ZCTA5 55320,1896,36,1860,0.0189873417721519,-3.5031442503625487
ZCTA5 46792,1548,27,1521,0.01744186046511628,-3.5035212385258356
ZCTA5 34681,355,0,355,0,-3.505327608337623
ZCTA5 36255,355,0,355,0,-3.505327608337623
ZCTA5 40358,355,0,355,0,-3.505327608337623
ZCTA5 58218,355,0,355,0,-3.505327608337623
ZCTA5 62625,355,0,355,0,-3.505327608337623
ZCTA5 02650,355,0,355,0,-3.505327608337623
ZCTA5 12151,355,0,355,0,-3.505327608337623
ZCTA5 11958,355,0,355,0,-3.505327608337623
ZCTA5 24603,355,0,355,0,-3.505327608337623
ZCTA5 35447,1146,17,1129,0.014834205933682374,-3.505388402111479
ZCTA5 70783,1146,17,1129,0.014834205933682374,-3.505388402111479
ZCTA5 70420,3114,69,3045,0.022157996146435453,-3.5055556828326515
ZCTA5 56511,803,9,794,0.0112079701120797,-3.5057287011984455
ZCTA5 63469,467,2,465,0.004282655246252677,-3.505756514383181
ZCTA5 80467,978,13,965,0.013292433537832311,-3.506406136105282
ZCTA5 49348,4596,111,4485,0.024151436031331592,-3.50725597152208
ZCTA5 62691,848,10,838,0.01179245283018868,-3.507967373001002
ZCTA5 76570,848,10,838,0.01179245283018868,-3.507967373001002
ZCTA5 49253,1270,20,1250,0.015748031496062992,-3.509060138072894
ZCTA5 75494,3473,79,3394,0.02274690469334869,-3.509112739701474
ZCTA5 41777,356,0,356,0,-3.5102612175467454
ZCTA5 41527,356,0,356,0,-3.5102612175467454
ZCTA5 51436,356,0,356,0,-3.5102612175467454
ZCTA5 52054,356,0,356,0,-3.5102612175467454
ZCTA5 56138,356,0,356,0,-3.5102612175467454
ZCTA5 56757,356,0,356,0,-3.5102612175467454
ZCTA5 78963,356,0,356,0,-3.5102612175467454
ZCTA5 04912,356,0,356,0,-3.5102612175467454
ZCTA5 23050,356,0,356,0,-3.5102612175467454
ZCTA5 48757,1550,27,1523,0.017419354838709676,-3.510711190482534
ZCTA5 47610,2013,39,1974,0.019374068554396422,-3.5131222780289484
ZCTA5 98257,1823,34,1789,0.018650575973669776,-3.515005234042971
ZCTA5 38042,357,0,357,0,-3.515187902381828
ZCTA5 61490,469,2,467,0.0042643923240938165,-3.515454946453148
ZCTA5 48224,14210,400,13810,0.028149190710767064,-3.5168218990521707
ZCTA5 67431,806,9,797,0.011166253101736972,-3.518857615331392
ZCTA5 84003,13041,364,12677,0.027911969940955447,-3.51971104831647
ZCTA5 27810,1901,36,1865,0.01893740136770121,-3.519869277592674
ZCTA5 36555,358,0,358,0,-3.5201076919165923
ZCTA5 72436,358,0,358,0,-3.5201076919165923
ZCTA5 83857,358,0,358,0,-3.5201076919165923
ZCTA5 02652,358,0,358,0,-3.5201076919165923
ZCTA5 32501,4323,103,4220,0.023826046726810084,-3.520472745128102
ZCTA5 62467,1474,25,1449,0.016960651289009497,-3.521496782688334
ZCTA5 85501,5259,130,5129,0.024719528427457692,-3.522603533813948
ZCTA5 04029,716,7,709,0.009776536312849162,-3.523379403567867
ZCTA5 13348,573,4,569,0.006980802792321117,-3.524122073812565
ZCTA5 35740,1435,24,1411,0.016724738675958188,-3.524295669219168
ZCTA5 45735,622,5,617,0.008038585209003215,-3.5250055285510293
ZCTA5 51533,359,0,359,0,-3.5250206150218695
ZCTA5 70729,359,0,359,0,-3.5250206150218695
ZCTA5 80420,359,0,359,0,-3.5250206150218695
ZCTA5 15775,359,0,359,0,-3.5250206150218695
ZCTA5 27922,359,0,359,0,-3.5250206150218695
ZCTA5 29104,471,2,469,0.004246284501061571,-3.5251280567081613
ZCTA5 47989,471,2,469,0.004246284501061571,-3.5251280567081613
ZCTA5 61361,471,2,469,0.004246284501061571,-3.5251280567081613
ZCTA5 48461,2941,64,2877,0.0217613056783407,-3.5264239074683537
ZCTA5 85552,2168,43,2125,0.019833948339483393,-3.5267891165369627
ZCTA5 27572,2796,60,2736,0.02145922746781116,-3.5272218443922236
ZCTA5 83422,1110,16,1094,0.014414414414414415,-3.527668894639516
ZCTA5 64150,1396,23,1373,0.0164756446991404,-3.527831650953478
ZCTA5 54471,717,7,710,0.009762900976290097,-3.527869438189515
ZCTA5 92277,9136,245,8891,0.026816987740805605,-3.5280126090474715
ZCTA5 37332,897,11,886,0.012263099219620958,-3.5295057774323344
ZCTA5 41528,360,0,360,0,-3.529926700367581
ZCTA5 45620,360,0,360,0,-3.529926700367581
ZCTA5 47147,360,0,360,0,-3.529926700367581
ZCTA5 51646,360,0,360,0,-3.529926700367581
ZCTA5 21734,360,0,360,0,-3.529926700367581
ZCTA5 94970,360,0,360,0,-3.529926700367581
ZCTA5 31029,5674,142,5532,0.025026436376454,-3.530390147705718
ZCTA5 33850,3087,68,3019,0.02202785876255264,-3.530535051043221
ZCTA5 32324,1673,30,1643,0.017931858936043037,-3.530772377398895
ZCTA5 72142,984,13,971,0.013211382113821139,-3.5312846231839004
ZCTA5 72469,418,1,417,0.0023923444976076554,-3.531663958094163
ZCTA5 61542,1477,25,1452,0.016926201760324982,-3.5324412666507823
ZCTA5 05038,575,4,571,0.006956521739130435,-3.5335049253423345
ZCTA5 32404,14384,405,13979,0.028156284760845383,-3.5335564667797166
ZCTA5 29166,361,0,361,0,-3.534825976424689
ZCTA5 77442,361,0,361,0,-3.534825976424689
ZCTA5 76470,1195,18,1177,0.01506276150627615,-3.5356068316747207
ZCTA5 85901,7068,183,6885,0.025891341256366725,-3.5359021695276565
ZCTA5 98402,3590,82,3508,0.022841225626740947,-3.5363033027431667
ZCTA5 55949,719,7,712,0.009735744089012517,-3.5368358893922207
ZCTA5 45669,3944,92,3852,0.02332657200811359,-3.5370521019811942
ZCTA5 24529,765,8,757,0.01045751633986928,-3.5372031900945378
ZCTA5 32046,3341,75,3266,0.022448368751870697,-3.5377421994244
ZCTA5 58045,899,11,888,0.012235817575083427,-3.5379873505049
ZCTA5 42635,1237,19,1218,0.015359741309620048,-3.5391158325441614
ZCTA5 68446,1196,18,1178,0.015050167224080268,-3.539508011982734
ZCTA5 59254,986,13,973,0.013184584178498986,-3.539551042972121
ZCTA5 97341,1278,20,1258,0.01564945226917058,-3.539693046193772
ZCTA5 55724,362,0,362,0,-3.5397184714671246
ZCTA5 67466,362,0,362,0,-3.5397184714671246
ZCTA5 70752,362,0,362,0,-3.5397184714671246
ZCTA5 12409,362,0,362,0,-3.5397184714671246
ZCTA5 22480,362,0,362,0,-3.5397184714671246
ZCTA5 26818,362,0,362,0,-3.5397184714671246
ZCTA5 27916,362,0,362,0,-3.5397184714671246
ZCTA5 55983,673,6,667,0.008915304606240713,-3.540189927609865
ZCTA5 66440,720,7,713,0.009722222222222222,-3.5413123307927137
ZCTA5 72065,1831,34,1797,0.018569087930092845,-3.5421004091814083
ZCTA5 41572,1480,25,1455,0.016891891891891893,-3.5433671829414095
ZCTA5 62216,987,13,974,0.013171225937183385,-3.5436793319055218
ZCTA5 52533,475,2,473,0.004210526315789474,-3.5443990721305596
ZCTA5 41666,363,0,363,0,-3.5446042135736904
ZCTA5 46766,363,0,363,0,-3.5446042135736904
ZCTA5 63622,363,0,363,0,-3.5446042135736904
ZCTA5 83246,363,0,363,0,-3.5446042135736904
ZCTA5 20670,363,0,363,0,-3.5446042135736904
ZCTA5 25133,363,0,363,0,-3.5446042135736904
ZCTA5 42602,3806,88,3718,0.023121387283236993,-3.5450157689795767
ZCTA5 08876,8047,212,7835,0.02634522182179694,-3.54642144112712
ZCTA5 12737,627,5,622,0.007974481658692184,-3.548071652952128
ZCTA5 29418,10009,271,9738,0.027075631931261866,-3.548828780181127
ZCTA5 04680,528,3,525,0.005681818181818182,-3.548902006744147
ZCTA5 65555,476,2,474,0.004201680672268907,-3.5492012949693392
ZCTA5 68423,476,2,474,0.004201680672268907,-3.5492012949693392
ZCTA5 36020,364,0,364,0,-3.549483230629941
ZCTA5 60072,364,0,364,0,-3.549483230629941
ZCTA5 67140,364,0,364,0,-3.549483230629941
ZCTA5 68961,364,0,364,0,-3.549483230629941
ZCTA5 81092,364,0,364,0,-3.549483230629941
ZCTA5 14784,364,0,364,0,-3.549483230629941
ZCTA5 21733,364,0,364,0,-3.549483230629941
ZCTA5 24150,364,0,364,0,-3.549483230629941
ZCTA5 47341,902,11,891,0.012195121951219513,-3.5506825894022733
ZCTA5 48467,1116,16,1100,0.014336917562724014,-3.5515875274773334
ZCTA5 50675,989,13,976,0.01314459049544995,-3.5519261017403343
ZCTA5 39840,1834,34,1800,0.018538713195201745,-3.5522349436487315
ZCTA5 55971,1158,17,1141,0.01468048359240069,-3.552784143307416
ZCTA5 49853,529,3,526,0.005671077504725898,-3.553634916917763
ZCTA5 63344,529,3,526,0.005671077504725898,-3.553634916917763
ZCTA5 03280,529,3,526,0.005671077504725898,-3.553634916917763
ZCTA5 62875,477,2,475,0.0041928721174004195,-3.553997351704816
ZCTA5 36574,365,0,365,0,-3.5543555503300395
ZCTA5 50541,365,0,365,0,-3.5543555503300395
ZCTA5 61928,365,0,365,0,-3.5543555503300395
ZCTA5 64494,365,0,365,0,-3.5543555503300395
ZCTA5 65534,365,0,365,0,-3.5543555503300395
ZCTA5 79848,365,0,365,0,-3.5543555503300395
ZCTA5 79734,990,13,977,0.013131313131313131,-3.55604459613251
ZCTA5 00971,8854,236,8618,0.026654619381070704,-3.55810029352672
ZCTA5 51027,530,3,527,0.005660377358490566,-3.558362060329928
ZCTA5 16930,478,2,476,0.0041841004184100415,-3.5587872652437054
ZCTA5 17024,724,7,717,0.009668508287292817,-3.5591731554715444
ZCTA5 41548,366,0,366,0,-3.5592212001785946
ZCTA5 59479,366,0,366,0,-3.5592212001785946
ZCTA5 65470,366,0,366,0,-3.5592212001785946
ZCTA5 81430,366,0,366,0,-3.5592212001785946
ZCTA5 05832,366,0,366,0,-3.5592212001785946
ZCTA5 12746,366,0,366,0,-3.5592212001785946
ZCTA5 19437,366,0,366,0,-3.5592212001785946
ZCTA5 43747,424,1,423,0.0023584905660377358,-3.560797155401556
ZCTA5 17846,1564,27,1537,0.017263427109974423,-3.5608233270100733
ZCTA5 92881,9851,266,9585,0.02700233478834636,-3.561163509477585
ZCTA5 45118,1405,23,1382,0.016370106761565837,-3.561184684445145
ZCTA5 37188,5517,137,5380,0.024832336414718145,-3.561379646372943
ZCTA5 61330,581,4,577,0.0068846815834767644,-3.5615225862822313
ZCTA5 34604,3989,93,3896,0.02331411381298571,-3.5615490140727313
ZCTA5 92373,12841,357,12484,0.027801573086208238,-3.5621867502677556
ZCTA5 83522,678,6,672,0.008849557522123894,-3.5628367566263077
ZCTA5 62912,531,3,528,0.005649717514124294,-3.5630834569516456
ZCTA5 10928,1760,32,1728,0.01818181818181818,-3.563097099891671
ZCTA5 30565,1604,28,1576,0.017456359102244388,-3.563100255386943
ZCTA5 56279,479,2,477,0.0041753653444676405,-3.563571058354587
ZCTA5 21034,1325,21,1304,0.015849056603773583,-3.5637880780990168
ZCTA5 40387,861,10,851,0.011614401858304297,-3.5638082133229405
ZCTA5 43767,367,0,367,0,-3.564080207492469
ZCTA5 50142,367,0,367,0,-3.564080207492469
ZCTA5 62339,367,0,367,0,-3.564080207492469
ZCTA5 68865,367,0,367,0,-3.564080207492469
ZCTA5 04066,367,0,367,0,-3.564080207492469
ZCTA5 15856,367,0,367,0,-3.564080207492469
ZCTA5 19474,367,0,367,0,-3.564080207492469
ZCTA5 43115,582,4,578,0.006872852233676976,-3.5661732935712718
ZCTA5 12783,582,4,578,0.006872852233676976,-3.5661732935712718
ZCTA5 14470,3208,71,3137,0.02213216957605985,-3.566206914225401
ZCTA5 17301,1605,28,1577,0.017445482866043614,-3.5666339188327876
ZCTA5 55084,679,6,673,0.008836524300441826,-3.5673518920009535
ZCTA5 05472,679,6,673,0.008836524300441826,-3.5673518920009535
ZCTA5 68718,772,8,764,0.010362694300518135,-3.5680010867437897
ZCTA5 57001,726,7,719,0.009641873278236915,-3.568076773853564
ZCTA5 45863,480,2,478,0.004166666666666667,-3.5683487536690435
ZCTA5 31551,368,0,368,0,-3.568932599402566
ZCTA5 50482,368,0,368,0,-3.568932599402566
ZCTA5 84722,368,0,368,0,-3.568932599402566
ZCTA5 26238,368,0,368,0,-3.568932599402566
ZCTA5 68864,426,1,425,0.002347417840375587,-3.5704563142649484
ZCTA5 42261,4204,99,4105,0.023549000951474785,-3.5715758032634266
ZCTA5 51237,680,6,674,0.008823529411764706,-3.5718623155601636
ZCTA5 83452,680,6,674,0.008823529411764706,-3.5718623155601636
ZCTA5 15349,680,6,674,0.008823529411764706,-3.5718623155601636
ZCTA5 05906,533,3,530,0.005628517823639775,-3.572509089152779
ZCTA5 96103,727,7,720,0.009628610729023384,-3.5725219268412176
ZCTA5 47930,481,2,479,0.004158004158004158,-3.5731203736827912
ZCTA5 29145,369,0,369,0,-3.5737784028556043
ZCTA5 38311,369,0,369,0,-3.5737784028556043
ZCTA5 41602,369,0,369,0,-3.5737784028556043
ZCTA5 44699,369,0,369,0,-3.5737784028556043
ZCTA5 52658,369,0,369,0,-3.5737784028556043
ZCTA5 23306,369,0,369,0,-3.5737784028556043
ZCTA5 97377,369,0,369,0,-3.5737784028556043
ZCTA5 60203,1489,25,1464,0.0167897918065816,-3.576034313692658
ZCTA5 06754,681,6,675,0.00881057268722467,-3.5763680407504106
ZCTA5 23840,864,10,854,0.011574074074074073,-3.576603648530849
ZCTA5 61854,534,3,531,0.0056179775280898875,-3.5772133641217563
ZCTA5 62545,482,2,480,0.004149377593360996,-3.577885940756802
ZCTA5 54005,1206,18,1188,0.014925373134328358,-3.578375248649114
ZCTA5 31735,370,0,370,0,-3.5786176446158593
ZCTA5 50452,370,0,370,0,-3.5786176446158593
ZCTA5 61039,370,0,370,0,-3.5786176446158593
ZCTA5 02543,370,0,370,0,-3.5786176446158593
ZCTA5 06755,370,0,370,0,-3.5786176446158593
ZCTA5 24818,370,0,370,0,-3.5786176446158593
ZCTA5 54730,1957,37,1920,0.01890648952478283,-3.5789421841615208
ZCTA5 41554,428,1,427,0.002336448598130841,-3.5800898595677686
ZCTA5 49238,634,5,629,0.007886435331230283,-3.5801512519190375
ZCTA5 34135,18232,523,17709,0.028685827117156646,-3.580593407423447
ZCTA5 02702,1530,26,1504,0.01699346405228758,-3.58062972814438
ZCTA5 04679,775,8,767,0.01032258064516129,-3.5811372186169534
ZCTA5 39168,2595,54,2541,0.020809248554913295,-3.582207092440997
ZCTA5 14753,483,2,481,0.004140786749482402,-3.582645477118409
ZCTA5 23707,5938,149,5789,0.025092623779050187,-3.583224015415479
ZCTA5 12202,4349,103,4246,0.023683605426534835,-3.583282409016868
ZCTA5 28452,371,0,371,0,-3.583450351266885
ZCTA5 30072,371,0,371,0,-3.583450351266885
ZCTA5 33930,371,0,371,0,-3.583450351266885
ZCTA5 71358,371,0,371,0,-3.583450351266885
ZCTA5 81149,371,0,371,0,-3.583450351266885
ZCTA5 04655,371,0,371,0,-3.583450351266885
ZCTA5 18070,371,0,371,0,-3.583450351266885
ZCTA5 25638,371,0,371,0,-3.583450351266885
ZCTA5 25843,371,0,371,0,-3.583450351266885
ZCTA5 24844,635,5,630,0.007874015748031496,-3.584714034460903
ZCTA5 26033,997,13,984,0.013039117352056168,-3.5847833911424036
ZCTA5 36274,4350,103,4247,0.02367816091954023,-3.5856912976517017
ZCTA5 72732,1844,34,1810,0.01843817787418655,-3.5859145180533476
ZCTA5 41564,372,0,372,0,-3.588276549213223
ZCTA5 51243,372,0,372,0,-3.588276549213223
ZCTA5 62465,372,0,372,0,-3.588276549213223
ZCTA5 79525,998,13,985,0.013026052104208416,-3.5888760605762573
ZCTA5 56449,684,6,678,0.008771929824561403,-3.58985715966613
ZCTA5 37014,955,12,943,0.012565445026178011,-3.5898674624367826
ZCTA5 29817,1729,31,1698,0.017929438982070563,-3.589937998941024
ZCTA5 47022,1168,17,1151,0.014554794520547944,-3.5919794674211194
ZCTA5 48506,11518,316,11202,0.027435318631706892,-3.5922870181001736
ZCTA5 88023,999,13,986,0.013013013013013013,-3.5929655315594182
ZCTA5 29743,373,0,373,0,-3.593096264682086
ZCTA5 36921,373,0,373,0,-3.593096264682086
ZCTA5 52362,373,0,373,0,-3.593096264682086
ZCTA5 61414,373,0,373,0,-3.593096264682086
ZCTA5 56248,373,0,373,0,-3.593096264682086
ZCTA5 19436,373,0,373,0,-3.593096264682086
ZCTA5 97410,373,0,373,0,-3.593096264682086
ZCTA5 92029,6996,180,6816,0.025728987993138937,-3.593364135721174
ZCTA5 63462,637,5,632,0.007849293563579277,-3.59382473729203
ZCTA5 03809,1333,21,1312,0.015753938484621154,-3.593843125538179
ZCTA5 39769,732,7,725,0.009562841530054645,-3.5946816068816903
ZCTA5 37640,1534,26,1508,0.01694915254237288,-3.594958680478495
ZCTA5 65734,1127,16,1111,0.01419698314108252,-3.5951725520662814
ZCTA5 40827,374,0,374,0,-3.5979095237250136
ZCTA5 52079,374,0,374,0,-3.5979095237250136
ZCTA5 52254,374,0,374,0,-3.5979095237250136
ZCTA5 66945,374,0,374,0,-3.5979095237250136
ZCTA5 75566,374,0,374,0,-3.5979095237250136
ZCTA5 04859,374,0,374,0,-3.5979095237250136
ZCTA5 13486,374,0,374,0,-3.5979095237250136
ZCTA5 07423,1415,23,1392,0.01625441696113074,-3.598036643447508
ZCTA5 25419,4250,100,4150,0.023529411764705882,-3.5981645533128126
ZCTA5 03449,779,8,771,0.010269576379974325,-3.5985939916986225
ZCTA5 46217,12474,345,12129,0.02765752765752766,-3.600381049342779
ZCTA5 50628,487,2,485,0.004106776180698152,-3.6016237553711608
ZCTA5 36617,5053,123,4930,0.024341975064318226,-3.6021731131559696
ZCTA5 61314,375,0,375,0,-3.6027163522195247
ZCTA5 24857,375,0,375,0,-3.6027163522195247
ZCTA5 26208,375,0,375,0,-3.6027163522195247
ZCTA5 98651,375,0,375,0,-3.6027163522195247
ZCTA5 98342,590,4,586,0.006779661016949152,-3.6031876380662733
ZCTA5 51535,734,7,727,0.009536784741144414,-3.6035148595952897
ZCTA5 16156,1171,17,1154,0.014517506404782237,-3.603685470728597
ZCTA5 76693,540,3,537,0.005555555555555556,-3.6053206618280815
ZCTA5 30349,26120,769,25351,0.02944104134762634,-3.606960640611129
ZCTA5 05251,640,5,635,0.0078125,-3.607453858504318
ZCTA5 28731,3546,80,3466,0.022560631697687534,-3.6074858905319442
ZCTA5 28740,376,0,376,0,-3.6075167758707316
ZCTA5 36916,376,0,376,0,-3.6075167758707316
ZCTA5 62889,376,0,376,0,-3.6075167758707316
ZCTA5 70393,376,0,376,0,-3.6075167758707316
ZCTA5 12777,376,0,376,0,-3.6075167758707316
ZCTA5 20144,376,0,376,0,-3.6075167758707316
ZCTA5 87710,735,7,728,0.009523809523809525,-3.607924971436639
ZCTA5 26250,1812,33,1779,0.018211920529801324,-3.608224660239387
ZCTA5 27839,1131,16,1115,0.014146772767462422,-3.6109374588840417
ZCTA5 31009,489,2,487,0.00408997955010225,-3.6110772784935614
ZCTA5 47360,489,2,487,0.00408997955010225,-3.6110772784935614
ZCTA5 22801,13233,368,12865,0.02780926471699539,-3.6112293184367448
ZCTA5 98387,16255,461,15794,0.0283605044601661,-3.611551604065398
ZCTA5 35974,641,5,636,0.0078003120124804995,-3.611987108965201
ZCTA5 59412,689,6,683,0.008708272859216255,-3.612246294755257
ZCTA5 43341,377,0,377,0,-3.6123108202129504
ZCTA5 41862,377,0,377,0,-3.6123108202129504
ZCTA5 54964,377,0,377,0,-3.6123108202129504
ZCTA5 62058,377,0,377,0,-3.6123108202129504
ZCTA5 25512,377,0,377,0,-3.6123108202129504
ZCTA5 63548,435,1,434,0.0022988505747126436,-3.6136084257665138
ZCTA5 55069,1775,32,1743,0.018028169014084508,-3.6142477120836167
ZCTA5 79382,2532,52,2480,0.020537124802527645,-3.6146050006928183
ZCTA5 23175,873,10,863,0.011454753722794959,-3.614789342896848
ZCTA5 36558,1298,20,1278,0.015408320493066256,-3.615594644669902
ZCTA5 16406,1257,19,1238,0.015115354017501989,-3.615796316380973
ZCTA5 24954,1619,28,1591,0.017294626312538603,-3.615911539754642
ZCTA5 22610,737,7,730,0.009497964721845319,-3.616732223929963
ZCTA5 58228,378,0,378,0,-3.617098510611282
ZCTA5 61489,378,0,378,0,-3.617098510611282
ZCTA5 66095,378,0,378,0,-3.617098510611282
ZCTA5 56054,378,0,378,0,-3.617098510611282
ZCTA5 32221,10050,271,9779,0.026965174129353234,-3.617670318924095
ZCTA5 04957,1659,29,1630,0.017480409885473176,-3.618225714766038
ZCTA5 48890,829,9,820,0.010856453558504222,-3.618315997766094
ZCTA5 99587,829,9,820,0.010856453558504222,-3.618315997766094
ZCTA5 31836,436,1,435,0.0022935779816513763,-3.6183718669094422
ZCTA5 50707,3443,77,3366,0.022364217252396165,-3.618799001484245
ZCTA5 38611,5818,145,5673,0.024922653832932278,-3.6189306702119275
ZCTA5 20001,19292,555,18737,0.028768401409910844,-3.619428195857825
ZCTA5 60424,1006,13,993,0.012922465208747515,-3.621502817222495
ZCTA5 65236,594,4,590,0.006734006734006734,-3.6215690244950083
ZCTA5 12058,594,4,590,0.006734006734006734,-3.6215690244950083
ZCTA5 85024,9953,268,9685,0.0269265548075957,-3.6215957614814633
ZCTA5 41655,379,0,379,0,-3.621879872263181
ZCTA5 41568,379,0,379,0,-3.621879872263181
ZCTA5 80449,379,0,379,0,-3.621879872263181
ZCTA5 24059,379,0,379,0,-3.621879872263181
ZCTA5 27709,379,0,379,0,-3.621879872263181
ZCTA5 94513,20386,589,19797,0.028892377121554007,-3.6221987343808704
ZCTA5 61933,437,1,436,0.002288329519450801,-3.623129148400325
ZCTA5 29056,875,10,865,0.011428571428571429,-3.6232346262798623
ZCTA5 38116,14577,409,14168,0.028057899430609864,-3.6232418789996195
ZCTA5 21536,1542,26,1516,0.016861219195849545,-3.6235231192723063
ZCTA5 38603,1218,18,1200,0.014778325123152709,-3.6246735166366055
ZCTA5 98380,1817,33,1784,0.018161805173362685,-3.6250793287224656
ZCTA5 38241,380,0,380,0,-3.626654930199999
ZCTA5 49963,380,0,380,0,-3.626654930199999
ZCTA5 71970,380,0,380,0,-3.626654930199999
ZCTA5 22437,380,0,380,0,-3.626654930199999
ZCTA5 25081,380,0,380,0,-3.626654930199999
ZCTA5 33471,2086,40,2046,0.019175455417066157,-3.626701612652221
ZCTA5 54872,1301,20,1281,0.015372790161414296,-3.6268974077116627
ZCTA5 18322,876,10,866,0.01141552511415525,-3.6274518058673597
ZCTA5 26386,876,10,866,0.01141552511415525,-3.6274518058673597
ZCTA5 37873,1818,33,1785,0.018151815181518153,-3.6284455194164402
ZCTA5 98844,2087,40,2047,0.019166267369429803,-3.629905055487091
ZCTA5 44688,1178,17,1161,0.014431239388794566,-3.630906185557304
ZCTA5 17980,1261,19,1242,0.01506740681998414,-3.6310133634509674
ZCTA5 52224,832,9,823,0.010817307692307692,-3.631136391170743
ZCTA5 31025,381,0,381,0,-3.631423709288515
ZCTA5 64448,381,0,381,0,-3.631423709288515
ZCTA5 05352,381,0,381,0,-3.631423709288515
ZCTA5 06090,381,0,381,0,-3.631423709288515
ZCTA5 25035,381,0,381,0,-3.631423709288515
ZCTA5 25234,381,0,381,0,-3.631423709288515
ZCTA5 73503,1584,27,1557,0.017045454545454544,-3.6317623333416846
ZCTA5 37016,439,1,438,0.002277904328018223,-3.6326253263869
ZCTA5 39859,439,1,438,0.002277904328018223,-3.6326253263869
ZCTA5 68629,546,3,543,0.005494505494505495,-3.6332280386326796
ZCTA5 76252,1052,14,1038,0.013307984790874524,-3.633837898443588
ZCTA5 31824,694,6,688,0.008645533141210375,-3.634520926185995
ZCTA5 61759,597,4,593,0.006700167504187605,-3.6353009019200755
ZCTA5 28631,382,0,382,0,-3.6361862342324485
ZCTA5 52064,382,0,382,0,-3.6361862342324485
ZCTA5 83836,382,0,382,0,-3.6361862342324485
ZCTA5 85362,382,0,382,0,-3.6361862342324485
ZCTA5 85601,382,0,382,0,-3.6361862342324485
ZCTA5 05455,382,0,382,0,-3.6361862342324485
ZCTA5 05903,382,0,382,0,-3.6361862342324485
ZCTA5 26801,382,0,382,0,-3.6361862342324485
ZCTA5 72086,3842,88,3754,0.022904737116085372,-3.6364214236948063
ZCTA5 65712,3414,76,3338,0.022261277094317515,-3.6369751440593365
ZCTA5 19543,2203,43,2160,0.019518837948252384,-3.637392696138786
ZCTA5 59421,788,8,780,0.01015228426395939,-3.6376323483932502
ZCTA5 73550,1010,13,997,0.01287128712871287,-3.6377404657676427
ZCTA5 16946,1010,13,997,0.01287128712871287,-3.6377404657676427
ZCTA5 16635,5242,128,5114,0.024418161007249143,-3.6382465305779053
ZCTA5 45314,1426,23,1403,0.016129032258064516,-3.6383258769470714
ZCTA5 60112,1426,23,1403,0.016129032258064516,-3.6383258769470714
ZCTA5 44882,1180,17,1163,0.01440677966101695,-3.6386597112254107
ZCTA5 30268,3451,77,3374,0.02231237322515213,-3.639937718366004
ZCTA5 97146,2429,49,2380,0.020172910662824207,-3.6401456119840567
ZCTA5 38024,11088,302,10786,0.027236652236652236,-3.640930033311904
ZCTA5 45678,383,0,383,0,-3.640942529573951
ZCTA5 47135,383,0,383,0,-3.640942529573951
ZCTA5 62021,383,0,383,0,-3.640942529573951
ZCTA5 68854,383,0,383,0,-3.640942529573951
ZCTA5 72036,383,0,383,0,-3.640942529573951
ZCTA5 80741,383,0,383,0,-3.640942529573951
ZCTA5 88426,383,0,383,0,-3.640942529573951
ZCTA5 04979,383,0,383,0,-3.640942529573951
ZCTA5 26808,383,0,383,0,-3.640942529573951
ZCTA5 25262,383,0,383,0,-3.640942529573951
ZCTA5 60938,789,8,781,0.010139416983523447,-3.641949723562463
ZCTA5 32927,9401,251,9150,0.026699287309860653,-3.6422779657483764
ZCTA5 74840,696,6,690,0.008620689655172414,-3.6433990757633086
ZCTA5 84087,4724,113,4611,0.023920406435224386,-3.6440647382102274
ZCTA5 46150,384,0,384,0,-3.645692619695077
ZCTA5 66756,384,0,384,0,-3.645692619695077
ZCTA5 71961,384,0,384,0,-3.645692619695077
ZCTA5 18435,384,0,384,0,-3.645692619695077
ZCTA5 23967,384,0,384,0,-3.645692619695077
ZCTA5 15478,2431,49,2382,0.020156314273961334,-3.6461945285848154
ZCTA5 19012,2319,46,2273,0.019836136265631736,-3.64695544770422
ZCTA5 35987,969,12,957,0.01238390092879257,-3.6475121989143044
ZCTA5 99116,697,6,691,0.00860832137733142,-3.647831407468019
ZCTA5 71851,836,9,827,0.01076555023923445,-3.6481768381674695
ZCTA5 47926,497,2,495,0.004024144869215292,-3.6486578998087444
ZCTA5 57385,497,2,495,0.004024144869215292,-3.6486578998087444
ZCTA5 21918,1348,21,1327,0.015578635014836795,-3.6498000235171624
ZCTA5 54614,1141,16,1125,0.014022787028921999,-3.6501562407544728
ZCTA5 37710,385,0,385,0,-3.650436528819253
ZCTA5 68340,385,0,385,0,-3.650436528819253
ZCTA5 54408,443,1,442,0.002257336343115124,-3.6515447918979413
ZCTA5 03104,13489,375,13114,0.02780042997998369,-3.6516988448277488
ZCTA5 36271,2283,45,2238,0.01971090670170828,-3.651812555956085
ZCTA5 49117,1708,30,1678,0.01756440281030445,-3.6519664863952546
ZCTA5 24555,882,10,872,0.011337868480725623,-3.652678936703992
ZCTA5 53183,1057,14,1043,0.013245033112582781,-3.6538449297036277
ZCTA5 58201,18322,524,17798,0.028599497871411417,-3.6544042683753597
ZCTA5 71416,386,0,386,0,-3.6551742810127066
ZCTA5 68351,386,0,386,0,-3.6551742810127066
ZCTA5 56083,386,0,386,0,-3.6551742810127066
ZCTA5 03812,386,0,386,0,-3.6551742810127066
ZCTA5 13690,386,0,386,0,-3.6551742810127066
ZCTA5 22847,386,0,386,0,-3.6551742810127066
ZCTA5 49245,1826,33,1793,0.018072289156626505,-3.655318437609704
ZCTA5 53934,1942,36,1906,0.018537590113285273,-3.6556055560375063
ZCTA5 79366,444,1,443,0.0022522522522522522,-3.656259606395733
ZCTA5 21636,444,1,443,0.0022522522522522522,-3.656259606395733
ZCTA5 35581,2019,38,1981,0.018821198613174838,-3.656505114443478
ZCTA5 37902,1431,23,1408,0.01607267645003494,-3.6565543954373374
ZCTA5 61427,883,10,873,0.011325028312570781,-3.6568708774885788
ZCTA5 99159,651,5,646,0.007680491551459293,-3.6570540965837752
ZCTA5 95485,1058,14,1044,0.013232514177693762,-3.6578374299708587
ZCTA5 32096,1015,13,1002,0.012807881773399015,-3.6579673389700256
ZCTA5 16923,602,4,598,0.006644518272425249,-3.6580854887248195
ZCTA5 95648,19420,558,18862,0.028733264675592174,-3.658645665973727
ZCTA5 92256,1552,26,1526,0.01675257731958763,-3.6590551643110434
ZCTA5 43525,387,0,387,0,-3.659905900185899
ZCTA5 50478,387,0,387,0,-3.659905900185899
ZCTA5 65444,387,0,387,0,-3.659905900185899
ZCTA5 16440,387,0,387,0,-3.659905900185899
ZCTA5 24445,1310,20,1290,0.015267175572519083,-3.66067879644995
ZCTA5 36256,652,5,647,0.007668711656441718,-3.6615345557766283
ZCTA5 12533,8512,224,8288,0.02631578947368421,-3.662549286349465
ZCTA5 73858,603,4,599,0.006633499170812604,-3.6626272676222804
ZCTA5 31309,388,0,388,0,-3.66463141009493
ZCTA5 49812,388,0,388,0,-3.66463141009493
ZCTA5 50581,388,0,388,0,-3.66463141009493
ZCTA5 72769,388,0,388,0,-3.66463141009493
ZCTA5 79506,388,0,388,0,-3.66463141009493
ZCTA5 12934,388,0,388,0,-3.66463141009493
ZCTA5 18254,388,0,388,0,-3.66463141009493
ZCTA5 05363,840,9,831,0.010714285714285714,-3.6651567760818478
ZCTA5 71456,553,3,550,0.0054249547920434,-3.6655393032022743
ZCTA5 67428,653,5,648,0.007656967840735069,-3.6660103000304085
ZCTA5 18629,653,5,648,0.007656967840735069,-3.6660103000304085
ZCTA5 29717,501,2,499,0.003992015968063872,-3.6673104471753617
ZCTA5 68641,501,2,499,0.003992015968063872,-3.6673104471753617
ZCTA5 28518,3173,69,3104,0.021745981720768987,-3.6676748262495433
ZCTA5 31076,1312,20,1292,0.01524390243902439,-3.668160113086189
ZCTA5 34690,5394,132,5262,0.024471635150166853,-3.668777430366664
ZCTA5 17771,1271,19,1252,0.014948859166011016,-3.668885591548571
ZCTA5 35035,389,0,389,0,-3.6693508343429295
ZCTA5 46180,389,0,389,0,-3.6693508343429295
ZCTA5 53167,389,0,389,0,-3.6693508343429295
ZCTA5 63036,389,0,389,0,-3.6693508343429295
ZCTA5 66724,389,0,389,0,-3.6693508343429295
ZCTA5 68967,389,0,389,0,-3.6693508343429295
ZCTA5 71021,389,0,389,0,-3.6693508343429295
ZCTA5 21711,389,0,389,0,-3.6693508343429295
ZCTA5 95311,841,9,832,0.01070154577883472,-3.669392373260196
ZCTA5 77417,1018,13,1005,0.012770137524557957,-3.670066329470946
ZCTA5 62964,554,3,551,0.005415162454873646,-3.6701337902291273
ZCTA5 39451,1230,18,1212,0.014634146341463415,-3.670605399911737
ZCTA5 74735,605,4,601,0.006611570247933884,-3.671695812216435
ZCTA5 07607,3499,78,3421,0.022292083452414974,-3.6718386717495024
ZCTA5 43116,502,2,500,0.00398406374501992,-3.6719594531830704
ZCTA5 56678,502,2,500,0.00398406374501992,-3.6719594531830704
ZCTA5 30525,3066,66,3000,0.021526418786692758,-3.6729133594020453
ZCTA5 19562,1147,16,1131,0.013949433304272014,-3.673556425944514
ZCTA5 93513,750,7,743,0.009333333333333334,-3.673563705175023
ZCTA5 48636,390,0,390,0,-3.6740641963814342
ZCTA5 65733,390,0,390,0,-3.6740641963814342
ZCTA5 72623,390,0,390,0,-3.6740641963814342
ZCTA5 83118,390,0,390,0,-3.6740641963814342
ZCTA5 87931,390,0,390,0,-3.6740641963814342
ZCTA5 03854,390,0,390,0,-3.6740641963814342
ZCTA5 75778,1231,18,1213,0.01462225832656377,-3.674416750896886
ZCTA5 02831,1231,18,1213,0.01462225832656377,-3.674416750896886
ZCTA5 55088,655,5,650,0.007633587786259542,-3.6749476987045306
ZCTA5 13433,655,5,650,0.007633587786259542,-3.6749476987045306
ZCTA5 82636,1948,36,1912,0.018480492813141684,-3.675262734986878
ZCTA5 42024,503,2,501,0.003976143141153081,-3.676602846569136
ZCTA5 76682,1020,13,1007,0.012745098039215686,-3.67811695388265
ZCTA5 57532,1232,18,1214,0.01461038961038961,-3.6782256129454423
ZCTA5 27829,704,6,698,0.008522727272727272,-3.678733015605619
ZCTA5 08344,1833,33,1800,0.01800327332242226,-3.678750198320439
ZCTA5 16040,391,0,391,0,-3.6787715195117454
ZCTA5 21622,391,0,391,0,-3.6787715195117454
ZCTA5 52653,1315,20,1295,0.015209125475285171,-3.6793647226914468
ZCTA5 46510,1518,25,1493,0.016469038208168644,-3.680187814703873
ZCTA5 29101,1107,15,1092,0.013550135501355014,-3.682814164934586
ZCTA5 57053,705,6,699,0.00851063829787234,-3.683129861787708
ZCTA5 05464,1357,21,1336,0.015475313190862197,-3.6831301139387467
ZCTA5 37083,5814,144,5670,0.02476780185758514,-3.683348909554284
ZCTA5 37175,392,0,392,0,-3.6834728268862733
ZCTA5 68029,392,0,392,0,-3.6834728268862733
ZCTA5 82727,392,0,392,0,-3.6834728268862733
ZCTA5 12156,392,0,392,0,-3.6834728268862733
ZCTA5 26346,392,0,392,0,-3.6834728268862733
ZCTA5 95635,392,0,392,0,-3.6834728268862733
ZCTA5 04068,557,3,554,0.005385996409335727,-3.683885526978294
ZCTA5 51449,934,11,923,0.011777301927194861,-3.6841279907386384
ZCTA5 77304,12431,342,12089,0.027511865497546455,-3.684485761404742
ZCTA5 67548,608,4,604,0.006578947368421052,-3.6852613277820963
ZCTA5 36343,505,2,503,0.0039603960396039604,-3.6858728739946525
ZCTA5 34772,8659,228,8431,0.026330985102205797,-3.686176046114127
ZCTA5 05354,845,9,836,0.010650887573964497,-3.6862974785193465
ZCTA5 33993,8056,210,7846,0.026067527308838132,-3.68701269683285
ZCTA5 72933,2105,40,2065,0.019002375296912115,-3.687341535686517
ZCTA5 68462,1480,24,1456,0.016216216216216217,-3.6879219071930223
ZCTA5 75683,1480,24,1456,0.016216216216216217,-3.6879219071930223
ZCTA5 29446,393,0,393,0,-3.688168141509868
ZCTA5 38504,393,0,393,0,-3.688168141509868
ZCTA5 08241,393,0,393,0,-3.688168141509868
ZCTA5 25564,393,0,393,0,-3.688168141509868
ZCTA5 04630,558,3,555,0.005376344086021506,-3.688458922236047
ZCTA5 14555,558,3,555,0.005376344086021506,-3.688458922236047
ZCTA5 56136,506,2,504,0.003952569169960474,-3.690499547014264
ZCTA5 39531,7655,198,7457,0.025865447419986937,-3.6924018733951955
ZCTA5 39422,1876,34,1842,0.01812366737739872,-3.692650510889478
ZCTA5 12785,394,0,394,0,-3.6928574862411296
ZCTA5 25971,394,0,394,0,-3.6928574862411296
ZCTA5 25817,394,0,394,0,-3.6928574862411296
ZCTA5 95345,394,0,394,0,-3.6928574862411296
ZCTA5 48742,801,8,793,0.009987515605493134,-3.69344852900715
ZCTA5 44645,892,10,882,0.011210762331838564,-3.6944385328827423
ZCTA5 92676,847,9,838,0.010625737898465172,-3.6947277838355386
ZCTA5 31563,507,2,505,0.0039447731755424065,-3.6951206853742957
ZCTA5 55972,1838,33,1805,0.017954298150163223,-3.6954406494102425
ZCTA5 65466,708,6,702,0.00847457627118644,-3.6962941624148864
ZCTA5 51640,660,5,655,0.007575757575757576,-3.6972096395248806
ZCTA5 12046,395,0,395,0,-3.6975408837937076
ZCTA5 16160,395,0,395,0,-3.6975408837937076
ZCTA5 23004,395,0,395,0,-3.6975408837937076
ZCTA5 67449,1279,19,1260,0.014855355746677092,-3.699010205864053
ZCTA5 56580,508,2,506,0.003937007874015748,-3.6997363082897343
ZCTA5 19966,11784,322,11462,0.027325186693822133,-3.700015772412017
ZCTA5 29827,1238,18,1220,0.014539579967689823,-3.70102675058785
ZCTA5 34756,1238,18,1220,0.014539579967689823,-3.70102675058785
ZCTA5 82930,5409,132,5277,0.024403771491957847,-3.701631210530717
ZCTA5 52801,661,5,656,0.007564296520423601,-3.701648154386211
ZCTA5 68758,561,3,558,0.0053475935828877,-3.70214779717668
ZCTA5 84654,1026,13,1013,0.012670565302144249,-3.702195591843194
ZCTA5 31789,396,0,396,0,-3.7022183567375864
ZCTA5 55967,396,0,396,0,-3.7022183567375864
ZCTA5 22125,396,0,396,0,-3.7022183567375864
ZCTA5 23436,396,0,396,0,-3.7022183567375864
ZCTA5 37362,1403,22,1381,0.015680684248039915,-3.7022567373921307
ZCTA5 63830,2894,61,2833,0.021078092605390463,-3.702526808995994
ZCTA5 63068,1879,34,1845,0.018094731240021287,-3.702577244684286
ZCTA5 80648,454,1,453,0.0022026431718061676,-3.7030827463538456
ZCTA5 70734,2562,52,2510,0.02029664324746292,-3.7036470352789044
ZCTA5 56171,757,7,750,0.009247027741083224,-3.703872540305124
ZCTA5 13730,1197,17,1180,0.014202172096908938,-3.7041436292479064
ZCTA5 24174,1155,16,1139,0.013852813852813853,-3.704605926852168
ZCTA5 45315,1565,26,1539,0.016613418530351438,-3.704962625311911
ZCTA5 70648,2600,53,2547,0.020384615384615383,-3.706066825686115
ZCTA5 27818,562,3,559,0.005338078291814947,-3.7067003751226575
ZCTA5 46365,397,0,397,0,-3.7068899275003506
ZCTA5 48856,397,0,397,0,-3.7068899275003506
ZCTA5 61279,397,0,397,0,-3.7068899275003506
ZCTA5 62219,397,0,397,0,-3.7068899275003506
ZCTA5 68343,397,0,397,0,-3.7068899275003506
ZCTA5 78850,397,0,397,0,-3.7068899275003506
ZCTA5 12942,397,0,397,0,-3.7068899275003506
ZCTA5 21912,397,0,397,0,-3.7068899275003506
ZCTA5 15840,850,9,841,0.010588235294117647,-3.7073456281499277
ZCTA5 45628,1958,36,1922,0.018386108273748723,-3.7079098676625284
ZCTA5 14755,1198,17,1181,0.014190317195325543,-3.707972430260627
ZCTA5 77611,3188,69,3119,0.02164366373902133,-3.70846116736642
ZCTA5 58413,510,2,508,0.00392156862745098,-3.708951084105136
ZCTA5 32177,10138,272,9866,0.026829749457486684,-3.709303661294332
ZCTA5 13679,711,6,705,0.008438818565400843,-3.7094193562216744
ZCTA5 98310,9007,238,8769,0.026423892528033753,-3.7104842862005323
ZCTA5 50635,663,5,658,0.007541478129713424,-3.710511417275537
ZCTA5 23237,8237,215,8022,0.026101736068957146,-3.710936286982585
ZCTA5 36035,563,3,560,0.0053285968028419185,-3.711247790950953
ZCTA5 13164,851,9,842,0.010575793184488837,-3.711544247046178
ZCTA5 44628,398,0,398,0,-3.711555618368443
ZCTA5 61413,398,0,398,0,-3.711555618368443
ZCTA5 24569,398,0,398,0,-3.711555618368443
ZCTA5 62952,1199,17,1182,0.014178482068390326,-3.711798682239098
ZCTA5 17068,1567,26,1541,0.016592214422463305,-3.711997115859036
ZCTA5 80117,1157,16,1141,0.013828867761452032,-3.7123416386454102
ZCTA5 36619,5725,141,5584,0.02462882096069869,-3.7135278750700804
ZCTA5 14066,511,2,509,0.003913894324853229,-3.713550274895942
ZCTA5 35404,8105,211,7894,0.026033312769895126,-3.7153384067918984
ZCTA5 62295,564,3,561,0.005319148936170213,-3.7157900613692294
ZCTA5 12449,1242,18,1224,0.014492753623188406,-3.7161782550014726
ZCTA5 44251,399,0,399,0,-3.7162154514884027
ZCTA5 61015,399,0,399,0,-3.7162154514884027
ZCTA5 78004,399,0,399,0,-3.7162154514884027
ZCTA5 04772,399,0,399,0,-3.7162154514884027
ZCTA5 18085,399,0,399,0,-3.7162154514884027
ZCTA5 12581,986,12,974,0.012170385395537525,-3.716653542170273
ZCTA5 64077,615,4,611,0.0065040650406504065,-3.7167422525380767
ZCTA5 51576,760,7,753,0.009210526315789473,-3.716800555305895
ZCTA5 22840,1727,30,1697,0.017371163867979156,-3.7168812519606584
ZCTA5 31620,3874,88,3786,0.022715539494062985,-3.7170214223437243
ZCTA5 21017,2678,55,2623,0.020537714712471993,-3.717187316229988
ZCTA5 31569,2115,40,2075,0.018912529550827423,-3.7190678811560987
ZCTA5 18837,1201,17,1184,0.014154870940882597,-3.719443556590707
ZCTA5 71016,853,9,844,0.010550996483001172,-3.719930542299627
ZCTA5 37686,3301,72,3229,0.02181157225083308,-3.719964216624313
ZCTA5 28622,987,12,975,0.0121580547112462,-3.720692090789223
ZCTA5 69034,400,0,400,0,-3.7208694488680942
ZCTA5 79778,400,0,400,0,-3.7208694488680942
ZCTA5 78953,400,0,400,0,-3.7208694488680942
ZCTA5 25573,400,0,400,0,-3.7208694488680942
ZCTA5 37826,1962,36,1926,0.01834862385321101,-3.720928819807203
ZCTA5 18955,616,4,612,0.006493506493506494,-3.721220096054058
ZCTA5 68633,513,2,511,0.003898635477582846,-3.722732356174633
ZCTA5 01071,513,2,511,0.003898635477582846,-3.722732356174633
ZCTA5 05846,513,2,511,0.003898635477582846,-3.722732356174633
ZCTA5 22846,899,10,889,0.011123470522803115,-3.7234614629108367
ZCTA5 68836,666,5,661,0.0075075075075075074,-3.723772091653605
ZCTA5 33616,6519,164,6355,0.025157232704402517,-3.725423066697107
ZCTA5 58761,401,0,401,0,-3.7255176323779162
ZCTA5 71331,401,0,401,0,-3.7255176323779162
ZCTA5 26739,401,0,401,0,-3.7255176323779162
ZCTA5 77025,12819,353,12466,0.027537249395428662,-3.7255619302374425
ZCTA5 48412,2002,37,1965,0.01848151848151848,-3.725599805128925
ZCTA5 44837,1531,25,1506,0.016329196603527107,-3.7263415623203184
ZCTA5 01571,3878,88,3790,0.022692109334708613,-3.7270540213172425
ZCTA5 76433,567,3,564,0.005291005291005291,-3.7293861659375134
ZCTA5 72103,4656,110,4546,0.023625429553264604,-3.7296751407720623
ZCTA5 43716,763,7,756,0.009174311926605505,-3.7296920891050864
ZCTA5 55941,402,0,402,0,-3.7301600237520045
ZCTA5 81020,402,0,402,0,-3.7301600237520045
ZCTA5 02812,402,0,402,0,-3.7301600237520045
ZCTA5 22834,402,0,402,0,-3.7301600237520045
ZCTA5 25651,402,0,402,0,-3.7301600237520045
ZCTA5 97436,402,0,402,0,-3.7301600237520045
ZCTA5 97523,2571,52,2519,0.020225593154414623,-3.7301810822520243
ZCTA5 54725,1162,16,1146,0.013769363166953529,-3.7316346702715912
ZCTA5 73057,901,10,891,0.011098779134295227,-3.7317225927896014
ZCTA5 45846,1452,23,1429,0.01584022038567493,-3.7325459396166427
ZCTA5 32331,1613,27,1586,0.016738995660260384,-3.7333035506033725
ZCTA5 52154,403,0,403,0,-3.734796644589415
ZCTA5 17758,403,0,403,0,-3.734796644589415
ZCTA5 93441,403,0,403,0,-3.734796644589415
ZCTA5 01038,1330,20,1310,0.015037593984962405,-3.735078458148388
ZCTA5 60421,1453,23,1430,0.015829318651066758,-3.7361419857331297
ZCTA5 02667,1534,25,1509,0.016297262059973925,-3.7369462965192755
ZCTA5 51346,947,11,936,0.011615628299894404,-3.7373463691262003
ZCTA5 51575,569,3,566,0.005272407732864675,-3.7384248110148066
ZCTA5 54531,569,3,566,0.005272407732864675,-3.7384248110148066
ZCTA5 77354,12171,333,11838,0.027360118314025142,-3.738850214030954
ZCTA5 76903,11842,323,11519,0.027275798007093396,-3.7389986348219675
ZCTA5 52720,404,0,404,0,-3.7394275163552977
ZCTA5 68933,404,0,404,0,-3.7394275163552977
ZCTA5 18453,404,0,404,0,-3.7394275163552977
ZCTA5 86018,404,0,404,0,-3.7394275163552977
ZCTA5 97531,404,0,404,0,-3.7394275163552977
ZCTA5 99170,404,0,404,0,-3.7394275163552977
ZCTA5 33709,10886,294,10592,0.027007165166268603,-3.740766958698176
ZCTA5 68402,517,2,515,0.0038684719535783366,-3.7410318369473194
ZCTA5 07418,766,7,759,0.009138381201044387,-3.742547421152055
ZCTA5 25635,570,3,567,0.005263157894736842,-3.742936554998352
ZCTA5 97381,5808,143,5665,0.02462121212121212,-3.7435747734926856
ZCTA5 38703,4662,110,4552,0.023595023595023596,-3.743622881480376
ZCTA5 49406,405,0,405,0,-3.7440526603820565
ZCTA5 77519,405,0,405,0,-3.7440526603820565
ZCTA5 04108,405,0,405,0,-3.7440526603820565
ZCTA5 63134,5290,128,5162,0.024196597353497166,-3.744482753205155
ZCTA5 48893,2085,39,2046,0.01870503597122302,-3.745286417929734
ZCTA5 75831,1931,35,1896,0.018125323666494046,-3.745984731965488
ZCTA5 95461,1037,13,1024,0.01253616200578592,-3.746058002944161
ZCTA5 46797,1333,20,1313,0.015003750937734433,-3.7461600186453508
ZCTA5 50554,767,7,760,0.009126466753585397,-3.7468245348151603
ZCTA5 17579,2124,40,2084,0.018832391713747645,-3.7475113311278094
ZCTA5 29741,905,10,895,0.011049723756906077,-3.7482037363577536
ZCTA5 41168,905,10,895,0.011049723756906077,-3.7482037363577536
ZCTA5 41531,406,0,406,0,-3.7486720978704917
ZCTA5 03817,406,0,406,0,-3.7486720978704917
ZCTA5 12960,406,0,406,0,-3.7486720978704917
ZCTA5 21778,406,0,406,0,-3.7486720978704917
ZCTA5 10464,1893,34,1859,0.017960908610670893,-3.748724517252135
ZCTA5 65349,1081,14,1067,0.012950971322849213,-3.748860630031801
ZCTA5 49664,860,9,851,0.010465116279069767,-3.749168565743133
ZCTA5 96114,1375,21,1354,0.015272727272727273,-3.7492528825225397
ZCTA5 44849,950,11,939,0.011578947368421053,-3.749548771694443
ZCTA5 52773,1038,13,1025,0.012524084778420038,-3.7500276268706823
ZCTA5 90077,3276,71,3205,0.021672771672771672,-3.7500310061817794
ZCTA5 44452,1251,18,1233,0.014388489208633094,-3.7501265822252714
ZCTA5 51016,519,2,517,0.0038535645472061657,-3.750149529556517
ZCTA5 16874,519,2,517,0.0038535645472061657,-3.750149529556517
ZCTA5 29920,4207,97,4110,0.023056810078440695,-3.7503845060693677
ZCTA5 50563,1167,16,1151,0.013710368466152529,-3.750862099272998
ZCTA5 31733,572,3,569,0.005244755244755245,-3.751944966409153
ZCTA5 54965,572,3,569,0.005244755244755245,-3.751944966409153
ZCTA5 24258,721,6,715,0.008321775312066574,-3.7528916173549125
ZCTA5 04927,1417,22,1395,0.015525758645024701,-3.753114402854841
ZCTA5 55969,407,0,407,0,-3.7532858498909394
ZCTA5 59754,407,0,407,0,-3.7532858498909394
ZCTA5 75447,407,0,407,0,-3.7532858498909394
ZCTA5 96109,407,0,407,0,-3.7532858498909394
ZCTA5 97149,407,0,407,0,-3.7532858498909394
ZCTA5 34291,2126,40,2086,0.01881467544684854,-3.7538180117148903
ZCTA5 45843,1458,23,1435,0.01577503429355281,-3.754091797588851
ZCTA5 10528,4632,109,4523,0.02353195164075993,-3.7554300425280416
ZCTA5 89060,3925,89,3836,0.02267515923566879,-3.7554767754654206
ZCTA5 71028,573,3,570,0.005235602094240838,-3.756441665809646
ZCTA5 50130,624,4,620,0.00641025641025641,-3.7568707675119555
ZCTA5 30746,408,0,408,0,-3.75789393738439
ZCTA5 38473,408,0,408,0,-3.75789393738439
ZCTA5 41231,408,0,408,0,-3.75789393738439
ZCTA5 42324,408,0,408,0,-3.75789393738439
ZCTA5 66872,408,0,408,0,-3.75789393738439
ZCTA5 77971,408,0,408,0,-3.75789393738439
ZCTA5 04745,408,0,408,0,-3.75789393738439
ZCTA5 14729,408,0,408,0,-3.75789393738439
ZCTA5 97820,408,0,408,0,-3.75789393738439
ZCTA5 98943,408,0,408,0,-3.75789393738439
ZCTA5 00953,21687,626,21061,0.028865218794669616,-3.758234167217615
ZCTA5 62930,2581,52,2529,0.020147229755908564,-3.7595680135921326
ZCTA5 53001,770,7,763,0.00909090909090909,-3.7596320267552796
ZCTA5 14033,770,7,763,0.00909090909090909,-3.7596320267552796
ZCTA5 07712,16236,457,15779,0.02814732692781473,-3.76049839606719
ZCTA5 49344,1337,20,1317,0.014958863126402393,-3.7609040679354164
ZCTA5 65692,574,3,571,0.005226480836236934,-3.7609333821857542
ZCTA5 67560,723,6,717,0.008298755186721992,-3.7615353635848976
ZCTA5 45682,863,9,854,0.010428736964078795,-3.761645357516181
ZCTA5 78669,4459,104,4355,0.023323615160349854,-3.761997625350027
ZCTA5 35647,409,0,409,0,-3.762496381163596
ZCTA5 38361,409,0,409,0,-3.762496381163596
ZCTA5 46104,409,0,409,0,-3.762496381163596
ZCTA5 50666,409,0,409,0,-3.762496381163596
ZCTA5 80819,409,0,409,0,-3.762496381163596
ZCTA5 05065,409,0,409,0,-3.762496381163596
ZCTA5 04554,409,0,409,0,-3.762496381163596
ZCTA5 05150,409,0,409,0,-3.762496381163596
ZCTA5 24237,409,0,409,0,-3.762496381163596
ZCTA5 64867,467,1,466,0.0021413276231263384,-3.7630949799182436
ZCTA5 66866,675,5,670,0.007407407407407408,-3.7633109869121615
ZCTA5 01096,1085,14,1071,0.012903225806451613,-3.764536160956533
ZCTA5 15022,4425,103,4322,0.02327683615819209,-3.764932476649492
ZCTA5 56542,1213,17,1196,0.014014839241549877,-3.76510099168262
ZCTA5 47138,1898,34,1864,0.01791359325605901,-3.7651354218394943
ZCTA5 89183,13992,388,13604,0.02773013150371641,-3.7654042800066465
ZCTA5 85617,626,4,622,0.006389776357827476,-3.7657361606760156
ZCTA5 12526,1502,24,1478,0.015978695073235686,-3.766422823911351
ZCTA5 04643,410,0,410,0,-3.76709320191417
ZCTA5 13322,410,0,410,0,-3.76709320191417
ZCTA5 49277,1421,22,1399,0.015482054890921885,-3.7675696981968594
ZCTA5 03049,2954,62,2892,0.02098849018280298,-3.76779378217548
ZCTA5 42461,523,2,521,0.0038240917782026767,-3.7683215399173897
ZCTA5 45113,1462,23,1439,0.01573187414500684,-3.768415318429548
ZCTA5 70744,2321,45,2276,0.01938819474364498,-3.7685390221744886
ZCTA5 08341,999,12,987,0.012012012012012012,-3.7689119388184116
ZCTA5 32226,5544,135,5409,0.024350649350649352,-3.7695362602806526
ZCTA5 16914,819,8,811,0.009768009768009768,-3.7696516209966195
ZCTA5 52142,576,3,573,0.005208333333333333,-3.7699019289145235
ZCTA5 01354,576,3,573,0.005208333333333333,-3.7699019289145235
ZCTA5 18824,627,4,623,0.006379585326953748,-3.7701618435813327
ZCTA5 37334,9376,248,9128,0.026450511945392493,-3.771393091244117
ZCTA5 41180,411,0,411,0,-3.7716844201956707
ZCTA5 46960,411,0,411,0,-3.7716844201956707
ZCTA5 71933,411,0,411,0,-3.7716844201956707
ZCTA5 72768,411,0,411,0,-3.7716844201956707
ZCTA5 80624,411,0,411,0,-3.7716844201956707
ZCTA5 14803,411,0,411,0,-3.7716844201956707
ZCTA5 23359,411,0,411,0,-3.7716844201956707
ZCTA5 23405,411,0,411,0,-3.7716844201956707
ZCTA5 97037,411,0,411,0,-3.7716844201956707
ZCTA5 89301,2734,56,2678,0.020482809070958303,-3.7718169074471195
ZCTA5 24225,677,5,672,0.007385524372230428,-3.772048533350025
ZCTA5 63823,524,2,522,0.003816793893129771,-3.772851442929274
ZCTA5 45732,1783,31,1752,0.017386427369601793,-3.7730784080713256
ZCTA5 43319,412,0,412,0,-3.7762700564426734
ZCTA5 52746,412,0,412,0,-3.7762700564426734
ZCTA5 73074,412,0,412,0,-3.7762700564426734
ZCTA5 10518,412,0,412,0,-3.7762700564426734
ZCTA5 15926,1131,15,1116,0.013262599469496022,-3.776297984787516
ZCTA5 56750,1001,12,989,0.011988011988011988,-3.7769054529846446
ZCTA5 73048,912,10,902,0.010964912280701754,-3.776915079003302
ZCTA5 36861,1300,19,1281,0.014615384615384615,-3.7773702131130187
ZCTA5 92624,2810,58,2752,0.020640569395017794,-3.777375679319394
ZCTA5 53023,525,2,523,0.0038095238095238095,-3.7773761412133737
ZCTA5 16928,525,2,523,0.0038095238095238095,-3.7773761412133737
ZCTA5 26582,1745,30,1715,0.017191977077363897,-3.777827215823225
ZCTA5 04353,957,11,946,0.011494252873563218,-3.777908039729055
ZCTA5 03444,578,3,575,0.005190311418685121,-3.778850731892316
ZCTA5 67831,413,0,413,0,-3.7808501309658324
ZCTA5 03226,413,0,413,0,-3.7808501309658324
ZCTA5 17855,413,0,413,0,-3.7808501309658324
ZCTA5 97388,413,0,413,0,-3.7808501309658324
ZCTA5 62448,2173,41,2132,0.018867924528301886,-3.781280465529298
ZCTA5 42749,2058,38,2020,0.0184645286686103,-3.781632944994507
ZCTA5 60941,822,8,814,0.009732360097323601,-3.782233440604582
ZCTA5 40160,9082,239,8843,0.02631578947368421,-3.7831923162041052
ZCTA5 54721,579,3,576,0.0051813471502590676,-3.7833177682816785
ZCTA5 54539,579,3,576,0.0051813471502590676,-3.7833177682816785
ZCTA5 71646,2250,43,2207,0.01911111111111111,-3.7835422721219065
ZCTA5 27822,3325,72,3253,0.021654135338345863,-3.7839481395450894
ZCTA5 00795,15083,421,14662,0.02791221905456474,-3.7850873682266366
ZCTA5 41055,776,7,769,0.00902061855670103,-3.7851405910360083
ZCTA5 37882,1176,16,1160,0.013605442176870748,-3.785307984793105
ZCTA5 39456,414,0,414,0,-3.7854246639529303
ZCTA5 44682,414,0,414,0,-3.7854246639529303
ZCTA5 49675,414,0,414,0,-3.7854246639529303
ZCTA5 68354,414,0,414,0,-3.7854246639529303
ZCTA5 05872,414,0,414,0,-3.7854246639529303
ZCTA5 20779,414,0,414,0,-3.7854246639529303
ZCTA5 27051,3107,66,3041,0.021242355970389443,-3.7854435817243144
ZCTA5 54557,472,1,471,0.00211864406779661,-3.7859269908887594
ZCTA5 71229,472,1,471,0.00211864406779661,-3.7859269908887594
ZCTA5 84315,2590,52,2538,0.020077220077220077,-3.7859311070747856
ZCTA5 40068,729,6,723,0.00823045267489712,-3.787366805345812
ZCTA5 31626,1427,22,1405,0.015416958654519973,-3.7891904883114393
ZCTA5 63384,681,5,676,0.007342143906020558,-3.789471054347109
ZCTA5 35972,415,0,415,0,-3.7899936754699146
ZCTA5 41332,415,0,415,0,-3.7899936754699146
ZCTA5 02833,415,0,415,0,-3.7899936754699146
ZCTA5 85611,415,0,415,0,-3.7899936754699146
ZCTA5 27843,415,0,415,0,-3.7899936754699146
ZCTA5 38556,5067,121,4946,0.023880007894217486,-3.790032860187205
ZCTA5 71447,528,2,526,0.003787878787878788,-3.7909191810702447
ZCTA5 68937,730,6,724,0.00821917808219178,-3.7916576073400754
ZCTA5 98328,3797,85,3712,0.022386094284961813,-3.792788983767683
ZCTA5 48159,916,10,906,0.010917030567685589,-3.7932477144633947
ZCTA5 70775,3618,80,3538,0.02211166390270868,-3.794106245998485
ZCTA5 34216,416,0,416,0,-3.7945571854619287
ZCTA5 38838,416,0,416,0,-3.7945571854619287
ZCTA5 01245,416,0,416,0,-3.7945571854619287
ZCTA5 03590,416,0,416,0,-3.7945571854619287
ZCTA5 15534,416,0,416,0,-3.7945571854619287
ZCTA5 17228,416,0,416,0,-3.7945571854619287
ZCTA5 51525,474,1,473,0.002109704641350211,-3.795021879422634
ZCTA5 59079,1221,17,1204,0.013923013923013924,-3.795340058199857
ZCTA5 67671,633,4,629,0.00631911532385466,-3.7966186197146783
ZCTA5 67067,633,4,629,0.00631911532385466,-3.7966186197146783
ZCTA5 59759,1551,25,1526,0.016118633139909737,-3.796717900593518
ZCTA5 93437,917,10,907,0.010905125408942203,-3.7973225549021565
ZCTA5 42784,962,11,951,0.011434511434511435,-3.798068812522278
ZCTA5 03741,1511,24,1487,0.01588352084712111,-3.7982640038293134
ZCTA5 35775,417,0,417,0,-3.7991152137543223
ZCTA5 37369,417,0,417,0,-3.7991152137543223
ZCTA5 41124,417,0,417,0,-3.7991152137543223
ZCTA5 42782,417,0,417,0,-3.7991152137543223
ZCTA5 52053,417,0,417,0,-3.7991152137543223
ZCTA5 61467,417,0,417,0,-3.7991152137543223
ZCTA5 63440,417,0,417,0,-3.7991152137543223
ZCTA5 81233,417,0,417,0,-3.7991152137543223
ZCTA5 23856,417,0,417,0,-3.7991152137543223
ZCTA5 89003,417,0,417,0,-3.7991152137543223
ZCTA5 94937,417,0,417,0,-3.7991152137543223
ZCTA5 97204,417,0,417,0,-3.7991152137543223
ZCTA5 50054,1137,15,1122,0.013192612137203167,-3.799425337871052
ZCTA5 54733,475,1,474,0.002105263157894737,-3.799561274780768
ZCTA5 65274,684,5,679,0.007309941520467836,-3.8024923285413035
ZCTA5 81401,9728,258,9470,0.02652138157894737,-3.8026630559680994
ZCTA5 24554,1593,26,1567,0.016321406151914627,-3.8027736452165652
ZCTA5 98405,9595,254,9341,0.026472120896300157,-3.8034128670707155
ZCTA5 68601,11256,304,10952,0.02700781805259417,-3.803422296901768
ZCTA5 52065,418,0,418,0,-3.803667780053662
ZCTA5 54210,418,0,418,0,-3.803667780053662
ZCTA5 63766,418,0,418,0,-3.803667780053662
ZCTA5 57564,418,0,418,0,-3.803667780053662
ZCTA5 14037,418,0,418,0,-3.803667780053662
ZCTA5 14034,733,6,727,0.008185538881309686,-3.804505479048129
ZCTA5 72173,3114,66,3048,0.02119460500963391,-3.8045239525020835
ZCTA5 56208,1008,12,996,0.011904761904761904,-3.8047870808303355
ZCTA5 16403,2371,46,2325,0.01940109658371995,-3.8054208350068515
ZCTA5 15424,919,10,909,0.01088139281828074,-3.805462304278041
ZCTA5 97049,685,5,680,0.0072992700729927005,-3.8068241286758666
ZCTA5 54414,1308,19,1289,0.01452599388379205,-3.806953815180636
ZCTA5 47346,1554,25,1529,0.016087516087516088,-3.807209614359513
ZCTA5 13308,1182,16,1166,0.01353637901861252,-3.808156486510126
ZCTA5 71841,419,0,419,0,-3.8082149039487185
ZCTA5 23878,419,0,419,0,-3.8082149039487185
ZCTA5 75574,734,6,728,0.008174386920980926,-3.8087799606275863
ZCTA5 84310,1514,24,1490,0.015852047556142668,-3.8088430782839304
ZCTA5 63764,2028,37,1991,0.01824457593688363,-3.8090529643194757
ZCTA5 38654,18218,517,17701,0.02837852673180371,-3.80988070009975
ZCTA5 58746,585,3,582,0.005128205128205128,-3.8100178396217803
ZCTA5 61912,585,3,582,0.005128205128205128,-3.8100178396217803
ZCTA5 25123,1392,21,1371,0.015086206896551725,-3.811058712146066
ZCTA5 17017,686,5,681,0.007288629737609329,-3.811151636397192
ZCTA5 36548,420,0,420,0,-3.8127566049114585
ZCTA5 56585,420,0,420,0,-3.8127566049114585
ZCTA5 87942,420,0,420,0,-3.8127566049114585
ZCTA5 03464,420,0,420,0,-3.8127566049114585
ZCTA5 25854,420,0,420,0,-3.8127566049114585
ZCTA5 23437,1676,28,1648,0.016706443914081145,-3.81292323164718
ZCTA5 27592,5703,139,5564,0.0243731369454673,-3.813764610928032
ZCTA5 48414,966,11,955,0.011387163561076604,-3.8141405612826143
ZCTA5 15936,637,4,633,0.006279434850863423,-3.8141647809377184
ZCTA5 08067,586,3,583,0.005119453924914676,-3.8144509680925105
ZCTA5 55760,1516,24,1492,0.0158311345646438,-3.815886230900495
ZCTA5 34470,7924,204,7720,0.02574457344775366,-3.8165547988633968
ZCTA5 37869,2069,38,2031,0.01836636056065732,-3.8165580020108285
ZCTA5 55384,1011,12,999,0.011869436201780416,-3.816691156266086
ZCTA5 08319,421,0,421,0,-3.8172929022980084
ZCTA5 15938,967,11,956,0.011375387797311272,-3.818150654627275
ZCTA5 13743,1394,21,1373,0.015064562410329985,-3.818289649488639
ZCTA5 70552,638,4,634,0.006269592476489028,-3.818539982974576
ZCTA5 65714,12421,339,12082,0.02729248852749376,-3.818970158696822
ZCTA5 49765,1678,28,1650,0.0166865315852205,-3.819733652185891
ZCTA5 38659,1012,12,1000,0.011857707509881422,-3.820653199671918
ZCTA5 50525,1558,25,1533,0.016046213093709884,-3.821172613946846
ZCTA5 61369,737,6,731,0.008141112618724558,-3.8215791273780413
ZCTA5 37657,422,0,422,0,-3.821823815349623
ZCTA5 50846,422,0,422,0,-3.821823815349623
ZCTA5 52070,422,0,422,0,-3.821823815349623
ZCTA5 62523,422,0,422,0,-3.821823815349623
ZCTA5 99123,422,0,422,0,-3.821823815349623
ZCTA5 54540,480,1,479,0.0020833333333333333,-3.822178507511392
ZCTA5 19952,3952,89,3863,0.022520242914979758,-3.8225303337761765
ZCTA5 31077,588,3,585,0.00510204081632653,-3.8233028878720723
ZCTA5 53034,689,5,684,0.00725689404934688,-3.8241085233448104
ZCTA5 98027,11666,316,11350,0.02708726212926453,-3.824354227453236
ZCTA5 54558,1057,13,1044,0.01229895931882687,-3.824895943934372
ZCTA5 54666,1144,15,1129,0.013111888111888112,-3.8262868196400426
ZCTA5 35480,423,0,423,0,-3.826349363193637
ZCTA5 51101,423,0,423,0,-3.826349363193637
ZCTA5 52728,423,0,423,0,-3.826349363193637
ZCTA5 23039,423,0,423,0,-3.826349363193637
ZCTA5 27942,423,0,423,0,-3.826349363193637
ZCTA5 58652,481,1,480,0.002079002079002079,-3.826686133949977
ZCTA5 61942,481,1,480,0.002079002079002079,-3.826686133949977
ZCTA5 15345,536,2,534,0.0037313432835820895,-3.8268092155252535
ZCTA5 54759,640,4,636,0.00625,-3.827276873568143
ZCTA5 62612,786,7,779,0.008905852417302799,-3.8273445208691257
ZCTA5 46319,7150,181,6969,0.025314685314685316,-3.8275186228834004
ZCTA5 60520,1058,13,1045,0.012287334593572778,-3.8288075881279626
ZCTA5 44445,1479,23,1456,0.01555104800540906,-3.8289344391671913
ZCTA5 62670,1102,14,1088,0.012704174228675136,-3.830660098082767
ZCTA5 79536,1879,33,1846,0.017562533262373604,-3.8308692983430994
ZCTA5 38554,424,0,424,0,-3.8308695648444036
ZCTA5 46049,424,0,424,0,-3.8308695648444036
ZCTA5 61018,424,0,424,0,-3.8308695648444036
ZCTA5 56343,424,0,424,0,-3.8308695648444036
ZCTA5 87540,424,0,424,0,-3.8308695648444036
ZCTA5 26717,424,0,424,0,-3.8308695648444036
ZCTA5 95703,424,0,424,0,-3.8308695648444036
ZCTA5 43524,537,2,535,0.0037243947858473,-3.831272786512247
ZCTA5 99161,641,4,637,0.0062402496099844,-3.8316385882907964
ZCTA5 67357,4841,114,4727,0.023548853542656477,-3.832679667457185
ZCTA5 21539,1059,13,1046,0.012275731822474031,-3.8327163915874736
ZCTA5 13145,691,5,686,0.00723589001447178,-3.8327252018198856
ZCTA5 32423,425,0,425,0,-3.8353844392042302
ZCTA5 65464,425,0,425,0,-3.8353844392042302
ZCTA5 75489,425,0,425,0,-3.8353844392042302
ZCTA5 24622,425,0,425,0,-3.8353844392042302
ZCTA5 67422,538,2,536,0.0037174721189591076,-3.835731371591148
ZCTA5 37309,881,9,872,0.01021566401816118,-3.8358426882010783
ZCTA5 37388,10680,286,10394,0.026779026217228465,-3.8363176612086587
ZCTA5 64724,835,8,827,0.009580838323353293,-3.836373305345293
ZCTA5 16627,835,8,827,0.009580838323353293,-3.836373305345293
ZCTA5 57068,591,3,588,0.005076142131979695,-3.8365451451952297
ZCTA5 23974,1643,27,1616,0.016433353621424222,-3.8367574072374424
ZCTA5 55027,1147,15,1132,0.013077593722755012,-3.8377595586145627
ZCTA5 95454,1147,15,1132,0.013077593722755012,-3.8377595586145627
ZCTA5 66088,927,10,917,0.010787486515641856,-3.8378899287477406
ZCTA5 28394,2153,40,2113,0.018578727357176035,-3.8384631585269857
ZCTA5 02813,3200,68,3132,0.02125,-3.839274892875181
ZCTA5 47520,1275,18,1257,0.01411764705882353,-3.839709820983274
ZCTA5 30572,426,0,426,0,-3.8398940050643
ZCTA5 44804,426,0,426,0,-3.8398940050643
ZCTA5 72773,426,0,426,0,-3.8398940050643
ZCTA5 48093,10217,272,9945,0.026622296173044926,-3.8403404375242753
ZCTA5 83553,592,3,589,0.005067567567567568,-3.840949789982235
ZCTA5 36028,693,5,688,0.007215007215007215,-3.841324991946586
ZCTA5 15765,693,5,688,0.007215007215007215,-3.841324991946586
ZCTA5 54873,1359,20,1339,0.014716703458425313,-3.8413650898319918
ZCTA5 08092,1359,20,1339,0.014716703458425313,-3.8413650898319918
ZCTA5 85929,3055,64,2991,0.020949263502454993,-3.843721908963641
ZCTA5 40104,427,0,427,0,-3.8443982811055815
ZCTA5 51553,427,0,427,0,-3.8443982811055815
ZCTA5 73832,427,0,427,0,-3.8443982811055815
ZCTA5 80137,427,0,427,0,-3.8443982811055815
ZCTA5 02671,427,0,427,0,-3.8443982811055815
ZCTA5 03262,427,0,427,0,-3.8443982811055815
ZCTA5 24597,427,0,427,0,-3.8443982811055815
ZCTA5 62468,1062,13,1049,0.01224105461393597,-3.844425811751064
ZCTA5 54424,694,5,689,0.007204610951008645,-3.845618582709014
ZCTA5 64640,1192,16,1176,0.013422818791946308,-3.8460350773214134
ZCTA5 11778,4105,93,4012,0.022655298416565165,-3.847700820765695
ZCTA5 15046,1019,12,1007,0.011776251226692836,-3.8483043676998867
ZCTA5 45207,2233,42,2191,0.018808777429467086,-3.8486718147205803
ZCTA5 47832,428,0,428,0,-3.8488972858997355
ZCTA5 68740,428,0,428,0,-3.8488972858997355
ZCTA5 83552,428,0,428,0,-3.8488972858997355
ZCTA5 91008,428,0,428,0,-3.8488972858997355
ZCTA5 50568,645,4,641,0.006201550387596899,-3.8490408791276862
ZCTA5 12496,541,2,539,0.0036968576709796672,-3.8490773730366064
ZCTA5 45697,1806,31,1775,0.01716500553709856,-3.849665048388621
ZCTA5 60436,6031,148,5883,0.024539877300613498,-3.8498921849118286
ZCTA5 28523,975,11,964,0.011282051282051283,-3.8501194590345316
ZCTA5 53714,7162,181,6981,0.025272270315554315,-3.850690983228489
ZCTA5 17538,2462,48,2414,0.01949634443541836,-3.851477872390012
ZCTA5 53011,885,9,876,0.010169491525423728,-3.8521794316120923
ZCTA5 37052,1020,12,1008,0.011764705882352941,-3.8522427284867864
ZCTA5 48851,839,8,831,0.009535160905840286,-3.852909005911721
ZCTA5 98376,839,8,831,0.009535160905840286,-3.852909005911721
ZCTA5 42259,429,0,429,0,-3.853391037910005
ZCTA5 51338,429,0,429,0,-3.853391037910005
ZCTA5 70036,429,0,429,0,-3.853391037910005
ZCTA5 26269,429,0,429,0,-3.853391037910005
ZCTA5 45212,10125,269,9856,0.0265679012345679,-3.8534491860833247
ZCTA5 30185,1445,22,1423,0.01522491349480969,-3.8536113929281353
ZCTA5 59828,2158,40,2118,0.018535681186283594,-3.8540381602307026
ZCTA5 66211,2158,40,2118,0.018535681186283594,-3.8540381602307026
ZCTA5 68715,595,3,592,0.005042016806722689,-3.854135603181395
ZCTA5 31719,3425,74,3351,0.021605839416058394,-3.8561463391894812
ZCTA5 65051,1808,31,1777,0.017146017699115043,-3.8562859685541375
ZCTA5 29662,6172,152,6020,0.02462734931950745,-3.8564198892359656
ZCTA5 35089,793,7,786,0.008827238335435058,-3.8566608178026933
ZCTA5 28448,430,0,430,0,-3.8578795554921035
ZCTA5 66202,7845,201,7644,0.025621414913957936,-3.858145200570658
ZCTA5 45772,697,5,692,0.007173601147776184,-3.8584742749747294
ZCTA5 27292,15560,434,15126,0.027892030848329048,-3.8584776507513276
ZCTA5 41858,3244,69,3175,0.02127003699136868,-3.8592332671218528
ZCTA5 31768,7778,199,7579,0.025584983286191822,-3.859502672916465
ZCTA5 63537,746,6,740,0.00804289544235925,-3.8597605750184423
ZCTA5 21838,746,6,740,0.00804289544235925,-3.8597605750184423
ZCTA5 48229,3499,76,3423,0.021720491569019718,-3.8598660851495334
ZCTA5 07856,2160,40,2120,0.018518518518518517,-3.860259506424542
ZCTA5 23872,1110,14,1096,0.012612612612612612,-3.861503730476718
ZCTA5 97333,9295,244,9051,0.026250672404518557,-3.86221142213621
ZCTA5 61257,431,0,431,0,-3.8623628568950834
ZCTA5 68341,431,0,431,0,-3.8623628568950834
ZCTA5 84006,431,0,431,0,-3.8623628568950834
ZCTA5 02659,431,0,431,0,-3.8623628568950834
ZCTA5 03583,431,0,431,0,-3.8623628568950834
ZCTA5 12457,431,0,431,0,-3.8623628568950834
ZCTA5 10501,431,0,431,0,-3.8623628568950834
ZCTA5 95254,431,0,431,0,-3.8623628568950834
ZCTA5 25442,698,5,693,0.0071633237822349575,-3.8627511835402144
ZCTA5 59068,1691,28,1663,0.01655824955647546,-3.863837442220518
ZCTA5 45661,2729,55,2674,0.02015390252839868,-3.8639178198471664
ZCTA5 36451,1811,31,1780,0.017117614577581448,-3.8662058390239062
ZCTA5 48468,545,2,543,0.003669724770642202,-3.8668032124998244
ZCTA5 63629,545,2,543,0.003669724770642202,-3.8668032124998244
ZCTA5 03580,545,2,543,0.003669724770642202,-3.8668032124998244
ZCTA5 62241,432,0,432,0,-3.8668409602622074
ZCTA5 21767,432,0,432,0,-3.8668409602622074
ZCTA5 26678,432,0,432,0,-3.8668409602622074
ZCTA5 72417,2085,38,2047,0.018225419664268584,-3.867075993683031
ZCTA5 95542,1024,12,1012,0.01171875,-3.8679668890073806
ZCTA5 49751,889,9,880,0.010123734533183352,-3.868462131989582
ZCTA5 74937,1930,34,1896,0.017616580310880828,-3.869305895489098
ZCTA5 73932,843,8,835,0.009489916963226572,-3.869387900365016
ZCTA5 54624,650,4,646,0.006153846153846154,-3.8706944232660963
ZCTA5 76264,650,4,646,0.006153846153846154,-3.8706944232660963
ZCTA5 60601,8864,231,8633,0.02606046931407942,-3.8711905351775937
ZCTA5 40374,700,5,695,0.007142857142857143,-3.8712925849437556
ZCTA5 39366,433,0,433,0,-3.8713138836318026
ZCTA5 42462,433,0,433,0,-3.8713138836318026
ZCTA5 49818,433,0,433,0,-3.8713138836318026
ZCTA5 61038,433,0,433,0,-3.8713138836318026
ZCTA5 56021,433,0,433,0,-3.8713138836318026
ZCTA5 71751,433,0,433,0,-3.8713138836318026
ZCTA5 77419,433,0,433,0,-3.8713138836318026
ZCTA5 78725,2620,52,2568,0.01984732824427481,-3.873233323844382
ZCTA5 63957,2545,50,2495,0.019646365422396856,-3.8737730040194127
ZCTA5 14437,4116,93,4023,0.02259475218658892,-3.874454335077971
ZCTA5 95379,1492,23,1469,0.015415549597855228,-3.8748312074322846
ZCTA5 19945,2583,51,2532,0.019744483159117306,-3.87485449327454
ZCTA5 55951,651,4,647,0.006144393241167435,-3.875012015721341
ZCTA5 97119,1614,26,1588,0.0161090458488228,-3.875201700587979
ZCTA5 93066,1070,13,1057,0.012149532710280374,-3.875527281881688
ZCTA5 83115,434,0,434,0,-3.8757816449381086
ZCTA5 12520,1026,12,1014,0.011695906432748537,-3.875811480214763
ZCTA5 26542,1026,12,1014,0.011695906432748537,-3.875811480214763
ZCTA5 30220,1893,33,1860,0.017432646592709985,-3.876541287787003
ZCTA5 49753,891,9,882,0.010101010101010102,-3.876583366158162
ZCTA5 73401,13676,376,13300,0.02749341912840012,-3.876586202842493
ZCTA5 16662,2204,41,2163,0.018602540834845735,-3.877442439438315
ZCTA5 58051,652,4,648,0.006134969325153374,-3.879325265131901
ZCTA5 62544,652,4,648,0.006134969325153374,-3.879325265131901
ZCTA5 88435,1071,13,1058,0.012138188608776844,-3.8794024152776387
ZCTA5 57567,702,5,697,0.007122507122507123,-3.879817506461553
ZCTA5 31097,548,2,546,0.0036496350364963502,-3.880046521319417
ZCTA5 41606,435,0,435,0,-3.880244262012116
ZCTA5 51570,435,0,435,0,-3.880244262012116
ZCTA5 51573,435,0,435,0,-3.880244262012116
ZCTA5 63855,435,0,435,0,-3.880244262012116
ZCTA5 23418,435,0,435,0,-3.880244262012116
ZCTA5 28761,3252,69,3183,0.021217712177121772,-3.880582757549625
ZCTA5 37026,892,9,883,0.010089686098654708,-3.880638980256406
ZCTA5 83226,892,9,883,0.010089686098654708,-3.880638980256406
ZCTA5 24918,799,7,792,0.008760951188986232,-3.881643420942042
ZCTA5 38222,1202,16,1186,0.013311148086522463,-3.8836646066623883
ZCTA5 60957,2129,39,2090,0.018318459370596524,-3.8837929672113396
ZCTA5 31089,1856,32,1824,0.017241379310344827,-3.884293470069348
ZCTA5 83823,549,2,547,0.0036429872495446266,-3.884451312594287
ZCTA5 38362,436,0,436,0,-3.8847017525823975
ZCTA5 20609,436,0,436,0,-3.8847017525823975
ZCTA5 23106,436,0,436,0,-3.8847017525823975
ZCTA5 21821,436,0,436,0,-3.8847017525823975
ZCTA5 95547,436,0,436,0,-3.8847017525823975
ZCTA5 51055,602,3,599,0.0049833887043189366,-3.8847402787376235
ZCTA5 48637,1245,17,1228,0.013654618473895583,-3.8851242886473902
ZCTA5 74014,14207,392,13815,0.027592032096853663,-3.885762447873612
ZCTA5 38601,847,8,839,0.009445100354191263,-3.8858105159042142
ZCTA5 03451,1698,28,1670,0.016489988221436984,-3.887469002825723
ZCTA5 19930,1288,18,1270,0.013975155279503106,-3.8876739431673366
ZCTA5 94129,1288,18,1270,0.013975155279503106,-3.8876739431673366
ZCTA5 12076,654,4,650,0.0061162079510703364,-3.8879387841578477
ZCTA5 28006,437,0,437,0,-3.8891541342759286
ZCTA5 36026,437,0,437,0,-3.8891541342759286
ZCTA5 76525,437,0,437,0,-3.8891541342759286
ZCTA5 06282,437,0,437,0,-3.8891541342759286
ZCTA5 89124,437,0,437,0,-3.8891541342759286
ZCTA5 27927,437,0,437,0,-3.8891541342759286
ZCTA5 29645,3656,80,3576,0.02188183807439825,-3.8912586638999307
ZCTA5 13809,655,4,651,0.0061068702290076335,-3.8922390783023233
ZCTA5 47944,1497,23,1474,0.015364061456245824,-3.892396964298988
ZCTA5 61534,705,5,700,0.0070921985815602835,-3.892574182624218
ZCTA5 54520,1898,33,1865,0.01738672286617492,-3.8927837241707466
ZCTA5 48003,2324,44,2280,0.0189328743545611,-3.8930407514861924
ZCTA5 37301,438,0,438,0,-3.8936014246189026
ZCTA5 66770,438,0,438,0,-3.8936014246189026
ZCTA5 14102,438,0,438,0,-3.8936014246189026
ZCTA5 17255,438,0,438,0,-3.8936014246189026
ZCTA5 56331,802,7,795,0.008728179551122194,-3.8940849576002896
ZCTA5 60948,656,4,652,0.006097560975609756,-3.896535078460987
ZCTA5 97403,3982,89,3893,0.022350577599196383,-3.89655122343363
ZCTA5 92264,10917,292,10625,0.026747274892369697,-3.897099147134445
ZCTA5 10594,1580,25,1555,0.015822784810126583,-3.897445750317476
ZCTA5 24226,552,2,550,0.0036231884057971015,-3.897636965595655
ZCTA5 58225,439,0,439,0,-3.8980436410375336
ZCTA5 61931,439,0,439,0,-3.8980436410375336
ZCTA5 67448,497,1,496,0.002012072434607646,-3.8981087295870864
ZCTA5 43973,942,10,932,0.010615711252653927,-3.8981352183919142
ZCTA5 41701,6708,167,6541,0.024895646988670243,-3.8981856959124155
ZCTA5 33538,1939,34,1905,0.017534811758638472,-3.89834052486163
ZCTA5 73501,7119,179,6940,0.025143980896193286,-3.899309404868892
ZCTA5 54636,5081,120,4961,0.023617398149970478,-3.899364618782315
ZCTA5 49729,657,4,653,0.0060882800608828,-3.900826796759591
ZCTA5 37870,2057,37,2020,0.01798736023334954,-3.9010657058984703
ZCTA5 13618,756,6,750,0.007936507936507936,-3.90181143537527
ZCTA5 29410,8376,216,8160,0.025787965616045846,-3.9018122727758495
ZCTA5 12455,851,8,843,0.009400705052878966,-3.9021773720634294
ZCTA5 49892,804,7,797,0.008706467661691543,-3.902361047304081
ZCTA5 32925,440,0,440,0,-3.902480800858852
ZCTA5 38476,440,0,440,0,-3.902480800858852
ZCTA5 61569,440,0,440,0,-3.902480800858852
ZCTA5 84724,440,0,440,0,-3.902480800858852
ZCTA5 61817,1077,13,1064,0.012070566388115135,-3.902595198063841
ZCTA5 49878,1500,23,1477,0.015333333333333332,-3.902913484596451
ZCTA5 74331,3040,63,2977,0.020723684210526314,-3.903441028036308
ZCTA5 39367,5780,140,5640,0.02422145328719723,-3.903555058867961
ZCTA5 13409,898,9,889,0.01002227171492205,-3.904903086116777
ZCTA5 31905,3589,78,3511,0.021733073279465033,-3.9050002524175236
ZCTA5 68970,658,4,654,0.0060790273556231,-3.9051142452689898
ZCTA5 95524,757,6,751,0.007926023778071334,-3.9059952945401464
ZCTA5 62257,1165,15,1150,0.012875536480686695,-3.906108635503786
ZCTA5 67854,554,2,552,0.0036101083032490976,-3.906403618114131
ZCTA5 56074,805,7,798,0.008695652173913044,-3.9064936381645086
ZCTA5 30446,441,0,441,0,-3.906912921311499
ZCTA5 36471,441,0,441,0,-3.906912921311499
ZCTA5 47980,441,0,441,0,-3.906912921311499
ZCTA5 04265,441,0,441,0,-3.906912921311499
ZCTA5 23303,441,0,441,0,-3.906912921311499
ZCTA5 08068,2745,55,2690,0.020036429872495445,-3.9094554303805147
ZCTA5 50450,1294,18,1276,0.013910355486862442,-3.9096815149093276
ZCTA5 44085,1166,15,1151,0.012864493996569469,-3.9098816245564008
ZCTA5 71638,1378,20,1358,0.01451378809869376,-3.910013952571103
ZCTA5 36521,2021,36,1985,0.017812963879267688,-3.910378051024209
ZCTA5 31316,3988,89,3899,0.022316950852557672,-3.9112950807235314
ZCTA5 80515,442,0,442,0,-3.9113400195264982
ZCTA5 14143,442,0,442,0,-3.9113400195264982
ZCTA5 83333,3592,78,3514,0.021714922048997772,-3.9126817311844446
ZCTA5 54837,1625,26,1599,0.016,-3.9128302374248594
ZCTA5 51246,1337,19,1318,0.014210919970082274,-3.9129929416136844
ZCTA5 15110,2254,42,2212,0.018633540372670808,-3.912993105009916
ZCTA5 61547,1503,23,1480,0.015302727877578177,-3.913412891865644
ZCTA5 72821,759,6,753,0.007905138339920948,-3.914351561522442
ZCTA5 16947,1786,30,1756,0.0167973124300112,-3.9147047757398457
ZCTA5 05658,609,3,606,0.0049261083743842365,-3.915121691997433
ZCTA5 84060,3265,69,3196,0.02113323124042879,-3.915176416966469
ZCTA5 28363,443,0,443,0,-3.915762112538037
ZCTA5 47833,443,0,443,0,-3.915762112538037
ZCTA5 68418,443,0,443,0,-3.915762112538037
ZCTA5 68643,443,0,443,0,-3.915762112538037
ZCTA5 03875,443,0,443,0,-3.915762112538037
ZCTA5 56293,501,1,500,0.001996007984031936,-3.915763469635347
ZCTA5 71235,1866,32,1834,0.01714898177920686,-3.916939801560172
ZCTA5 95525,661,4,657,0.006051437216338881,-3.9179510919540688
ZCTA5 97107,711,5,706,0.007032348804500703,-3.917978073426134
ZCTA5 54947,1081,13,1068,0.012025901942645698,-3.918002177772663
ZCTA5 63967,760,6,754,0.007894736842105263,-3.918523988595923
ZCTA5 52233,3046,63,2983,0.02068286277084701,-3.919820209312155
ZCTA5 28766,444,0,444,0,-3.9201792172842236
ZCTA5 35459,444,0,444,0,-3.9201792172842236
ZCTA5 45867,444,0,444,0,-3.9201792172842236
ZCTA5 54512,444,0,444,0,-3.9201792172842236
ZCTA5 80545,444,0,444,0,-3.9201792172842236
ZCTA5 04939,444,0,444,0,-3.9201792172842236
ZCTA5 98358,444,0,444,0,-3.9201792172842236
ZCTA5 36610,4100,92,4008,0.0224390243902439,-3.9223689896643426
ZCTA5 10921,1382,20,1362,0.01447178002894356,-3.9243693532094963
ZCTA5 36726,1709,28,1681,0.016383850204798128,-3.924441455712295
ZCTA5 47106,1709,28,1681,0.016383850204798128,-3.924441455712295
ZCTA5 31071,503,1,502,0.0019880715705765406,-3.9245614346635636
ZCTA5 29934,445,0,445,0,-3.92459135060785
ZCTA5 56270,445,0,445,0,-3.92459135060785
ZCTA5 11930,445,0,445,0,-3.92459135060785
ZCTA5 22709,445,0,445,0,-3.92459135060785
ZCTA5 13865,2373,45,2328,0.018963337547408345,-3.925615227504739
ZCTA5 50638,1424,21,1403,0.014747191011235955,-3.9257590685085844
ZCTA5 29115,10469,278,10191,0.02655458974114051,-3.9259377837869516
ZCTA5 61533,949,10,939,0.01053740779768177,-3.926006511463684
ZCTA5 75847,762,6,756,0.007874015748031496,-3.9268574777591763
ZCTA5 16410,612,3,609,0.004901960784313725,-3.9280751018577904
ZCTA5 48629,3270,69,3201,0.02110091743119266,-3.928449133787073
ZCTA5 46730,446,0,446,0,-3.928998529257137
ZCTA5 50230,446,0,446,0,-3.928998529257137
ZCTA5 87056,446,0,446,0,-3.928998529257137
ZCTA5 04349,446,0,446,0,-3.928998529257137
ZCTA5 36804,6861,171,6690,0.024923480542195016,-3.9295699980024343
ZCTA5 49403,950,10,940,0.010526315789473684,-3.9299756954909015
ZCTA5 55413,6518,161,6357,0.024700828474992328,-3.930050543631603
ZCTA5 65284,858,8,850,0.009324009324009324,-3.9306867352305215
ZCTA5 04750,763,6,757,0.007863695937090432,-3.9310185588750595
ZCTA5 27865,811,7,804,0.008631319358816275,-3.9312133761505477
ZCTA5 71046,560,2,558,0.0035714285714285713,-3.9325907283451773
ZCTA5 56714,505,1,504,0.0019801980198019802,-3.9333399678732395
ZCTA5 57249,447,0,447,0,-3.9334007698864792
ZCTA5 63631,447,0,447,0,-3.9334007698864792
ZCTA5 13864,447,0,447,0,-3.9334007698864792
ZCTA5 17260,447,0,447,0,-3.9334007698864792
ZCTA5 18059,447,0,447,0,-3.9334007698864792
ZCTA5 20692,447,0,447,0,-3.9334007698864792
ZCTA5 95460,1129,14,1115,0.012400354295837024,-3.9340744288372296
ZCTA5 35540,1041,12,1029,0.011527377521613832,-3.9342793199330037
ZCTA5 05735,1550,24,1526,0.015483870967741935,-3.9344698176110677
ZCTA5 50028,665,4,661,0.006015037593984963,-3.93500783331486
ZCTA5 32044,764,6,758,0.007853403141361256,-3.9351758769680347
ZCTA5 98359,1832,31,1801,0.016921397379912665,-3.935262066227903
ZCTA5 61610,2146,39,2107,0.018173345759552657,-3.9366521539612744
ZCTA5 44656,1259,17,1242,0.013502779984114376,-3.9368684040045663
ZCTA5 50510,448,0,448,0,-3.937798089057176
ZCTA5 19501,448,0,448,0,-3.937798089057176
ZCTA5 73121,1344,19,1325,0.014136904761904762,-3.938312815114186
ZCTA5 55019,716,5,711,0.006983240223463687,-3.93903787081199
ZCTA5 49033,666,4,662,0.006006006006006006,-3.9392615515838334
ZCTA5 99217,6661,165,6496,0.024771055397087523,-3.9410538221103426
ZCTA5 69143,562,2,560,0.0035587188612099642,-3.9412825397761617
ZCTA5 39180,12832,349,12483,0.027197630922693266,-3.941395281202121
ZCTA5 29332,953,10,943,0.01049317943336831,-3.941864746356743
ZCTA5 62554,507,1,506,0.0019723865877712033,-3.94209919616251
ZCTA5 38487,449,0,449,0,-3.9421905032381614
ZCTA5 46913,449,0,449,0,-3.9421905032381614
ZCTA5 62022,449,0,449,0,-3.9421905032381614
ZCTA5 77613,449,0,449,0,-3.9421905032381614
ZCTA5 01026,449,0,449,0,-3.9421905032381614
ZCTA5 25607,449,0,449,0,-3.9421905032381614
ZCTA5 01108,9878,260,9618,0.026321117635148817,-3.9425562810920756
ZCTA5 36036,766,6,760,0.007832898172323759,-3.9434792617224024
ZCTA5 04352,667,4,663,0.005997001499250375,-3.94351110628578
ZCTA5 82410,814,7,807,0.0085995085995086,-3.94352489945491
ZCTA5 56467,1088,13,1075,0.011948529411764705,-3.9448598708680875
ZCTA5 56115,563,2,561,0.003552397868561279,-3.9456215307168785
ZCTA5 66616,2380,45,2335,0.018907563025210083,-3.9465326485503542
ZCTA5 39086,450,0,450,0,-3.9465780288067216
ZCTA5 58433,450,0,450,0,-3.9465780288067216
ZCTA5 99030,450,0,450,0,-3.9465780288067216
ZCTA5 39339,5870,142,5728,0.024190800681431004,-3.946888859662859
ZCTA5 36530,2721,54,2667,0.019845644983461964,-3.9476715022892552
ZCTA5 39653,1000,11,989,0.011,-3.948768634717645
ZCTA5 36312,2266,42,2224,0.018534863195057368,-3.9495176131298386
ZCTA5 64439,617,3,614,0.004862236628849271,-3.9495758411192172
ZCTA5 85194,2946,60,2886,0.020366598778004074,-3.95040124821886
ZCTA5 43549,509,1,508,0.0019646365422396855,-3.9508392450656804
ZCTA5 44855,451,0,451,0,-3.9509606820492085
ZCTA5 93432,451,0,451,0,-3.9509606820492085
ZCTA5 95636,451,0,451,0,-3.9509606820492085
ZCTA5 47145,719,5,714,0.006954102920723227,-3.951626290668496
ZCTA5 78121,4327,98,4229,0.02264848624913335,-3.952865497474838
ZCTA5 52045,910,9,901,0.00989010989010989,-3.953078401813585
ZCTA5 38463,1046,12,1034,0.011472275334608031,-3.953626870720291
ZCTA5 98045,5386,128,5258,0.02376531748978834,-3.9543237532145015
ZCTA5 39191,2761,55,2706,0.0199203187250996,-3.9547614909064834
ZCTA5 45120,1178,15,1163,0.012733446519524618,-3.9549625069795513
ZCTA5 32139,452,0,452,0,-3.955338479161745
ZCTA5 45654,452,0,452,0,-3.955338479161745
ZCTA5 48720,452,0,452,0,-3.955338479161745
ZCTA5 13615,452,0,452,0,-3.955338479161745
ZCTA5 17093,452,0,452,0,-3.955338479161745
ZCTA5 25608,452,0,452,0,-3.955338479161745
ZCTA5 54615,4042,90,3952,0.022266204849084613,-3.955628406810573
ZCTA5 16134,1597,25,1572,0.015654351909830933,-3.955788880758126
ZCTA5 39540,3754,82,3672,0.02184336707511987,-3.9561750815297647
ZCTA5 03287,670,4,666,0.005970149253731343,-3.9562349041336526
ZCTA5 44442,1638,26,1612,0.015873015873015872,-3.957030861320171
ZCTA5 19149,18950,536,18414,0.028284960422163587,-3.9572962314944564
ZCTA5 54009,1047,12,1035,0.011461318051575931,-3.9574879915785943
ZCTA5 13135,2687,53,2634,0.01972459992556755,-3.9578235521301006
ZCTA5 52540,566,2,564,0.0035335689045936395,-3.95861101507514
ZCTA5 36792,453,0,453,0,-3.9597114362509234
ZCTA5 58647,453,0,453,0,-3.9597114362509234
ZCTA5 67525,453,0,453,0,-3.9597114362509234
ZCTA5 69025,453,0,453,0,-3.9597114362509234
ZCTA5 73724,453,0,453,0,-3.9597114362509234
ZCTA5 15542,453,0,453,0,-3.9597114362509234
ZCTA5 96057,620,3,617,0.004838709677419355,-3.9624238856270515
ZCTA5 62931,567,2,565,0.003527336860670194,-3.9629317273547833
ZCTA5 52315,512,1,511,0.001953125,-3.963913628376334
ZCTA5 97358,1093,13,1080,0.011893870082342177,-3.9639632960990294
ZCTA5 42458,454,0,454,0,-3.9640795693344946
ZCTA5 63447,454,0,454,0,-3.9640795693344946
ZCTA5 74734,454,0,454,0,-3.9640795693344946
ZCTA5 88124,454,0,454,0,-3.9640795693344946
ZCTA5 83813,454,0,454,0,-3.9640795693344946
ZCTA5 05821,454,0,454,0,-3.9640795693344946
ZCTA5 15076,454,0,454,0,-3.9640795693344946
ZCTA5 96146,454,0,454,0,-3.9640795693344946
ZCTA5 06254,722,5,717,0.006925207756232687,-3.9641794581692036
ZCTA5 12523,672,4,668,0.005952380952380952,-3.9646968284021646
ZCTA5 47265,7767,197,7570,0.025363718295352132,-3.9652158103543313
ZCTA5 76244,24115,696,23419,0.028861704333402446,-3.966068424049833
ZCTA5 54177,1394,20,1374,0.014347202295552367,-3.967236649511213
ZCTA5 56738,568,2,566,0.0035211267605633804,-3.967247905028497
ZCTA5 14804,568,2,566,0.0035211267605633804,-3.967247905028497
ZCTA5 13862,1722,28,1694,0.016260162601626018,-3.967882786905455
ZCTA5 36041,455,0,455,0,-3.968442894342055
ZCTA5 43511,455,0,455,0,-3.968442894342055
ZCTA5 59349,455,0,455,0,-3.968442894342055
ZCTA5 12956,455,0,455,0,-3.968442894342055
ZCTA5 13839,455,0,455,0,-3.968442894342055
ZCTA5 16740,455,0,455,0,-3.968442894342055
ZCTA5 54499,1225,16,1209,0.013061224489795919,-3.9692900942311553
ZCTA5 16143,1182,15,1167,0.012690355329949238,-3.9699102555582884
ZCTA5 85140,13971,383,13588,0.027413928852623292,-3.9704239002302555
ZCTA5 56586,821,7,814,0.008526187576126675,-3.9721280283199856
ZCTA5 41166,456,0,456,0,-3.972801427115726
ZCTA5 46348,456,0,456,0,-3.972801427115726
ZCTA5 62560,456,0,456,0,-3.972801427115726
ZCTA5 67349,456,0,456,0,-3.972801427115726
ZCTA5 22832,456,0,456,0,-3.972801427115726
ZCTA5 96145,1051,12,1039,0.011417697431018078,-3.972904688954527
ZCTA5 78028,16657,465,16192,0.027916191391006782,-3.974834373420619
ZCTA5 47336,1312,18,1294,0.013719512195121951,-3.9752222199421645
ZCTA5 30170,1096,13,1083,0.011861313868613138,-3.9753933921108984
ZCTA5 44119,5675,136,5539,0.023964757709251102,-3.975475010359128
ZCTA5 62277,570,2,568,0.0035087719298245615,-3.9758667120220577
ZCTA5 03823,570,2,568,0.0035087719298245615,-3.9758667120220577
ZCTA5 48064,1521,23,1498,0.015121630506245891,-3.9760539024773234
ZCTA5 85395,9999,263,9736,0.026302630263026303,-3.976910399447318
ZCTA5 29469,457,0,457,0,-3.9771551834108188
ZCTA5 38332,457,0,457,0,-3.9771551834108188
ZCTA5 47516,457,0,457,0,-3.9771551834108188
ZCTA5 65024,457,0,457,0,-3.9771551834108188
ZCTA5 84757,457,0,457,0,-3.9771551834108188
ZCTA5 01342,457,0,457,0,-3.9771551834108188
ZCTA5 11569,457,0,457,0,-3.9771551834108188
ZCTA5 13420,457,0,457,0,-3.9771551834108188
ZCTA5 26294,457,0,457,0,-3.9771551834108188
ZCTA5 54448,1725,28,1697,0.016231884057971015,-3.9778691538813447
ZCTA5 18014,4374,99,4275,0.02263374485596708,-3.9796973550191104
ZCTA5 41189,823,7,816,0.00850546780072904,-3.9802688270970226
ZCTA5 63332,516,1,515,0.001937984496124031,-3.981280159674547
ZCTA5 43343,458,0,458,0,-3.9815041788965067
ZCTA5 80427,458,0,458,0,-3.9815041788965067
ZCTA5 16020,458,0,458,0,-3.9815041788965067
ZCTA5 84081,12892,350,12542,0.027148619298789946,-3.9815464166748002
ZCTA5 15033,1965,34,1931,0.017302798982188294,-3.9815846357505276
ZCTA5 17922,1926,33,1893,0.017133956386292833,-3.9830819250125895
ZCTA5 55077,5189,122,5067,0.023511273848525728,-3.983101303038242
ZCTA5 52203,824,7,817,0.00849514563106796,-3.9843340136818233
ZCTA5 21822,776,6,770,0.007731958762886598,-3.984773569638677
ZCTA5 98606,3033,62,2971,0.02044180679195516,-3.9852739266895334
ZCTA5 66411,459,0,459,0,-3.9858484291564764
ZCTA5 12464,459,0,459,0,-3.9858484291564764
ZCTA5 46511,1647,26,1621,0.015786278081360048,-3.987462678851925
ZCTA5 03038,13095,356,12739,0.027185948835433373,-3.98901535435806
ZCTA5 37688,460,0,460,0,-3.9901879496895813
ZCTA5 47575,460,0,460,0,-3.9901879496895813
ZCTA5 61884,460,0,460,0,-3.9901879496895813
ZCTA5 01531,460,0,460,0,-3.9901879496895813
ZCTA5 11972,460,0,460,0,-3.9901879496895813
ZCTA5 43146,3109,64,3045,0.020585397233837247,-3.9903713945634958
ZCTA5 04220,1144,14,1130,0.012237762237762238,-3.9907051126548474
ZCTA5 71675,778,6,772,0.007712082262210797,-3.9929884200949863
ZCTA5 53070,1850,31,1819,0.016756756756756756,-3.993928364138997
ZCTA5 35542,461,0,461,0,-3.994522755910491
ZCTA5 40075,461,0,461,0,-3.994522755910491
ZCTA5 54175,461,0,461,0,-3.994522755910491
ZCTA5 18355,461,0,461,0,-3.994522755910491
ZCTA5 27919,461,0,461,0,-3.994522755910491
ZCTA5 33037,4630,106,4524,0.022894168466522678,-3.9959577479687924
ZCTA5 18076,1189,15,1174,0.012615643397813289,-3.995974766126177
ZCTA5 33185,7954,202,7752,0.02539602715614785,-3.9966413646384185
ZCTA5 95138,6172,150,6022,0.024303305249513935,-3.9979928074758257
ZCTA5 12060,680,4,676,0.0058823529411764705,-3.998381614407171
ZCTA5 38923,462,0,462,0,-3.9988528631503244
ZCTA5 49625,462,0,462,0,-3.9988528631503244
ZCTA5 62567,462,0,462,0,-3.9988528631503244
ZCTA5 01236,462,0,462,0,-3.9988528631503244
ZCTA5 15688,462,0,462,0,-3.9988528631503244
ZCTA5 22654,462,0,462,0,-3.9988528631503244
ZCTA5 24473,462,0,462,0,-3.9988528631503244
ZCTA5 15140,1528,23,1505,0.015052356020942409,-4.000251837009474
ZCTA5 25015,1772,29,1743,0.01636568848758465,-4.000373075794691
ZCTA5 16259,780,6,774,0.007692307692307693,-4.001188768192718
ZCTA5 13608,576,2,574,0.003472222222222222,-4.001615732156919
ZCTA5 80603,4526,103,4423,0.02275740167918692,-4.001992159012715
ZCTA5 74332,681,4,677,0.005873715124816446,-4.002574067943807
ZCTA5 29518,463,0,463,0,-4.003178286657284
ZCTA5 39192,463,0,463,0,-4.003178286657284
ZCTA5 49876,463,0,463,0,-4.003178286657284
ZCTA5 81090,463,0,463,0,-4.003178286657284
ZCTA5 01349,463,0,463,0,-4.003178286657284
ZCTA5 16224,463,0,463,0,-4.003178286657284
ZCTA5 37777,4952,115,4837,0.023222940226171242,-4.003913364559453
ZCTA5 66027,1488,22,1466,0.01478494623655914,-4.004909621693257
ZCTA5 60180,630,3,627,0.004761904761904762,-4.0049717773785325
ZCTA5 56655,781,6,775,0.0076824583866837385,-4.005283526030884
ZCTA5 75968,682,4,678,0.005865102639296188,-4.0067625257641275
ZCTA5 52037,464,0,464,0,-4.007499041597284
ZCTA5 56339,464,0,464,0,-4.007499041597284
ZCTA5 72651,464,0,464,0,-4.007499041597284
ZCTA5 82223,464,0,464,0,-4.007499041597284
ZCTA5 05654,464,0,464,0,-4.007499041597284
ZCTA5 18438,464,0,464,0,-4.007499041597284
ZCTA5 24352,464,0,464,0,-4.007499041597284
ZCTA5 24439,464,0,464,0,-4.007499041597284
ZCTA5 60151,1489,22,1467,0.014775016789791807,-4.008385896399637
ZCTA5 63740,1934,33,1901,0.017063081695966906,-4.0086789413371315
ZCTA5 35570,4742,109,4633,0.022986081822016027,-4.008801815785385
ZCTA5 04268,1694,27,1667,0.015938606847697757,-4.009091080656195
ZCTA5 53063,631,3,628,0.004754358161648178,-4.009203281034642
ZCTA5 42713,782,6,776,0.0076726342710997444,-4.009374684819023
ZCTA5 44428,1279,17,1262,0.013291634089132134,-4.010008402496171
ZCTA5 59030,683,4,679,0.005856515373352855,-4.010946998670019
ZCTA5 49668,1322,18,1304,0.01361573373676248,-4.011326831507894
ZCTA5 36578,465,0,465,0,-4.0118151430545685
ZCTA5 49745,465,0,465,0,-4.0118151430545685
ZCTA5 52341,465,0,465,0,-4.0118151430545685
ZCTA5 61420,465,0,465,0,-4.0118151430545685
ZCTA5 67120,465,0,465,0,-4.0118151430545685
ZCTA5 81523,465,0,465,0,-4.0118151430545685
ZCTA5 15451,465,0,465,0,-4.0118151430545685
ZCTA5 25669,465,0,465,0,-4.0118151430545685
ZCTA5 07435,925,9,916,0.00972972972972973,-4.012651485304932
ZCTA5 43320,632,3,629,0.004746835443037975,-4.013430599303253
ZCTA5 04947,632,3,629,0.004746835443037975,-4.013430599303253
ZCTA5 73762,783,6,777,0.007662835249042145,-4.013462253332221
ZCTA5 71038,1776,29,1747,0.01632882882882883,-4.013524076685335
ZCTA5 01518,1449,21,1428,0.014492753623188406,-4.013931276621058
ZCTA5 18623,1062,12,1050,0.011299435028248588,-4.015073688456373
ZCTA5 91024,4603,105,4498,0.02281121008038236,-4.015589401952653
ZCTA5 29435,1696,27,1669,0.015919811320754717,-4.01576160221037
ZCTA5 05046,466,0,466,0,-4.016126606032328
ZCTA5 35442,1857,31,1826,0.01669359181475498,-4.016614498538023
ZCTA5 31804,2094,37,2057,0.01766953199617956,-4.016874800452262
ZCTA5 37082,2404,45,2359,0.018718801996672214,-4.017849862128273
ZCTA5 16838,735,5,730,0.006802721088435374,-4.018175806199695
ZCTA5 16844,1063,12,1051,0.011288805268109126,-4.018890897092056
ZCTA5 71357,685,4,681,0.00583941605839416,-4.01930403271188
ZCTA5 56472,3231,67,3164,0.02073661405137728,-4.020110521906749
ZCTA5 29404,467,0,467,0,-4.020433445453307
ZCTA5 41174,467,0,467,0,-4.020433445453307
ZCTA5 47386,467,0,467,0,-4.020433445453307
ZCTA5 88301,467,0,467,0,-4.020433445453307
ZCTA5 04438,467,0,467,0,-4.020433445453307
ZCTA5 23850,467,0,467,0,-4.020433445453307
ZCTA5 25235,467,0,467,0,-4.020433445453307
ZCTA5 26419,467,0,467,0,-4.020433445453307
ZCTA5 05346,2056,36,2020,0.017509727626459144,-4.020556773094086
ZCTA5 65052,1239,16,1223,0.0129136400322841,-4.02079677483973
ZCTA5 25557,634,3,631,0.00473186119873817,-4.021872727241454
ZCTA5 68031,736,5,731,0.006793478260869565,-4.022302792726076
ZCTA5 22534,974,10,964,0.01026694045174538,-4.024324321899766
ZCTA5 46542,1535,23,1512,0.01498371335504886,-4.024360110390768
ZCTA5 03814,1153,14,1139,0.012142237640936688,-4.02441025557786
ZCTA5 60088,1109,13,1096,0.011722272317403066,-4.024650365541352
ZCTA5 38575,468,0,468,0,-4.024735676160404
ZCTA5 40815,468,0,468,0,-4.024735676160404
ZCTA5 41121,468,0,468,0,-4.024735676160404
ZCTA5 65739,468,0,468,0,-4.024735676160404
ZCTA5 76486,468,0,468,0,-4.024735676160404
ZCTA5 08328,468,0,468,0,-4.024735676160404
ZCTA5 89043,468,0,468,0,-4.024735676160404
ZCTA5 27857,468,0,468,0,-4.024735676160404
ZCTA5 31549,834,7,827,0.008393285371702638,-4.0247966690482
ZCTA5 54613,834,7,827,0.008393285371702638,-4.0247966690482
ZCTA5 81657,2330,43,2287,0.018454935622317595,-4.026359016574723
ZCTA5 41073,2560,49,2511,0.019140625,-4.027473998583178
ZCTA5 38231,687,4,683,0.005822416302765648,-4.027645255551614
ZCTA5 55936,687,4,683,0.005822416302765648,-4.027645255551614
ZCTA5 35954,4359,98,4261,0.022482220692819455,-4.028501364605801
ZCTA5 71485,835,7,828,0.008383233532934131,-4.0288241890057765
ZCTA5 66427,469,0,469,0,-4.029033312917274
ZCTA5 69024,469,0,469,0,-4.029033312917274
ZCTA5 08247,469,0,469,0,-4.029033312917274
ZCTA5 62326,930,9,921,0.00967741935483871,-4.032353279360998
ZCTA5 68662,528,1,527,0.001893939393939394,-4.032936355396342
ZCTA5 36579,470,0,470,0,-4.033326370408914
ZCTA5 36047,470,0,470,0,-4.033326370408914
ZCTA5 65080,470,0,470,0,-4.033326370408914
ZCTA5 81424,470,0,470,0,-4.033326370408914
ZCTA5 03268,470,0,470,0,-4.033326370408914
ZCTA5 89042,470,0,470,0,-4.033326370408914
ZCTA5 98361,470,0,470,0,-4.033326370408914
ZCTA5 49092,788,6,782,0.007614213197969543,-4.033846546533242
ZCTA5 65668,788,6,782,0.007614213197969543,-4.033846546533242
ZCTA5 43240,1982,34,1948,0.017154389505549948,-4.0355138532297286
ZCTA5 99320,3677,79,3598,0.021484906173511016,-4.036270661924559
ZCTA5 26662,471,0,471,0,-4.0376148632422515
ZCTA5 27936,471,0,471,0,-4.0376148632422515
ZCTA5 03768,638,3,635,0.004702194357366771,-4.038707278617506
ZCTA5 46978,740,5,735,0.006756756756756757,-4.038773349854743
ZCTA5 45226,2526,48,2478,0.019002375296912115,-4.0392802726424915
ZCTA5 41003,978,10,968,0.010224948875255624,-4.039882244744495
ZCTA5 68765,585,2,583,0.003418803418803419,-4.039942320308394
ZCTA5 66086,3496,74,3422,0.02116704805491991,-4.040190401030112
ZCTA5 33026,11307,301,11006,0.02662067745644291,-4.040960555980572
ZCTA5 45245,8318,212,8106,0.02548689588843472,-4.0409798966943
ZCTA5 36786,1024,11,1013,0.0107421875,-4.041752241439178
ZCTA5 67758,472,0,472,0,-4.041898805946723
ZCTA5 23964,472,0,472,0,-4.041898805946723
ZCTA5 98603,472,0,472,0,-4.041898805946723
ZCTA5 14826,790,6,784,0.007594936708860759,-4.041975435241799
ZCTA5 21874,790,6,784,0.007594936708860759,-4.041975435241799
ZCTA5 62417,1373,19,1354,0.013838310269482883,-4.042104341264042
ZCTA5 36251,1905,32,1873,0.01679790026246719,-4.042876283405164
ZCTA5 34737,979,10,969,0.010214504596527068,-4.043764422971196
ZCTA5 01109,9267,240,9027,0.02589834898025251,-4.04500396508339
ZCTA5 49727,3018,61,2957,0.020212060967528166,-4.045596145884756
ZCTA5 42333,473,0,473,0,-4.04617821297485
ZCTA5 62338,473,0,473,0,-4.04617821297485
ZCTA5 70780,473,0,473,0,-4.04617821297485
ZCTA5 25692,473,0,473,0,-4.04617821297485
ZCTA5 54627,742,5,737,0.006738544474393531,-4.04698632775828
ZCTA5 61450,742,5,737,0.006738544474393531,-4.04698632775828
ZCTA5 61747,587,2,585,0.0034071550255536627,-4.048411764884878
ZCTA5 72641,1071,12,1059,0.011204481792717087,-4.049331771416035
ZCTA5 04562,1026,11,1015,0.010721247563352826,-4.049427368586332
ZCTA5 56544,2026,35,1991,0.017275419545903257,-4.049766413244378
ZCTA5 42076,474,0,474,0,-4.050453098702804
ZCTA5 62063,474,0,474,0,-4.050453098702804
ZCTA5 66546,474,0,474,0,-4.050453098702804
ZCTA5 80810,474,0,474,0,-4.050453098702804
ZCTA5 10969,474,0,474,0,-4.050453098702804
ZCTA5 16233,474,0,474,0,-4.050453098702804
ZCTA5 97063,474,0,474,0,-4.050453098702804
ZCTA5 98236,2682,52,2630,0.019388516032811335,-4.050931627488668
ZCTA5 80903,7027,174,6853,0.02476163369859115,-4.052272120071756
ZCTA5 19344,4226,94,4132,0.022243256034074774,-4.052956918213128
ZCTA5 75418,4868,112,4756,0.023007395234182416,-4.0534419911392705
ZCTA5 39320,475,0,475,0,-4.054723477430976
ZCTA5 43840,475,0,475,0,-4.054723477430976
ZCTA5 44427,475,0,475,0,-4.054723477430976
ZCTA5 61943,744,5,739,0.006720430107526882,-4.055184538758979
ZCTA5 56326,642,3,639,0.004672897196261682,-4.055476177834611
ZCTA5 31555,1073,12,1061,0.011183597390493943,-4.056915286842434
ZCTA5 60043,794,6,788,0.007556675062972292,-4.058191024842995
ZCTA5 36421,3940,86,3854,0.02182741116751269,-4.058568556978172
ZCTA5 28072,476,0,476,0,-4.058989363384528
ZCTA5 41250,476,0,476,0,-4.058989363384528
ZCTA5 61742,476,0,476,0,-4.058989363384528
ZCTA5 68428,476,0,476,0,-4.058989363384528
ZCTA5 04945,476,0,476,0,-4.058989363384528
ZCTA5 14506,476,0,476,0,-4.058989363384528
ZCTA5 15015,476,0,476,0,-4.058989363384528
ZCTA5 21645,476,0,476,0,-4.058989363384528
ZCTA5 54949,1420,20,1400,0.014084507042253521,-4.059113194817102
ZCTA5 37318,745,5,740,0.006711409395973154,-4.059278129942978
ZCTA5 14710,1293,17,1276,0.013147718484145398,-4.060674192543622
ZCTA5 28395,843,7,836,0.00830367734282325,-4.060923435751227
ZCTA5 23294,7614,191,7423,0.025085369057000262,-4.061036935235149
ZCTA5 73543,590,2,588,0.003389830508474576,-4.061083941101163
ZCTA5 11777,3431,72,3359,0.02098513552900029,-4.061711715804821
ZCTA5 07458,3724,80,3644,0.021482277121374866,-4.062877089657925
ZCTA5 16130,891,8,883,0.008978675645342313,-4.062888273819075
ZCTA5 61001,477,0,477,0,-4.063250770713955
ZCTA5 61859,477,0,477,0,-4.063250770713955
ZCTA5 75476,477,0,477,0,-4.063250770713955
ZCTA5 25676,477,0,477,0,-4.063250770713955
ZCTA5 59823,746,5,741,0.006702412868632708,-4.063368057252954
ZCTA5 76857,746,5,741,0.006702412868632708,-4.063368057252954
ZCTA5 58495,644,3,641,0.004658385093167702,-4.063836237408788
ZCTA5 11961,5577,132,5445,0.023668639053254437,-4.063978352814905
ZCTA5 38773,1251,16,1235,0.012789768185451638,-4.064585914648061
ZCTA5 61491,844,7,837,0.008293838862559242,-4.064920842810637
ZCTA5 67576,844,7,837,0.008293838862559242,-4.064920842810637
ZCTA5 39532,13972,381,13591,0.027268823361007728,-4.065950158426077
ZCTA5 54629,1120,13,1107,0.011607142857142858,-4.065987922498276
ZCTA5 66087,796,6,790,0.007537688442211055,-4.066277860570063
ZCTA5 83544,2459,46,2413,0.01870679137860919,-4.066863339296936
ZCTA5 44853,536,1,535,0.0018656716417910447,-4.067013501596228
ZCTA5 65641,536,1,535,0.0018656716417910447,-4.067013501596228
ZCTA5 15340,478,0,478,0,-4.067507713495617
ZCTA5 26623,478,0,478,0,-4.067507713495617
ZCTA5 27884,478,0,478,0,-4.067507713495617
ZCTA5 70770,1252,16,1236,0.012779552715654952,-4.068220252603433
ZCTA5 53119,2032,35,1997,0.017224409448818898,-4.068546040194443
ZCTA5 75424,1121,13,1108,0.01159678858162355,-4.069730595867963
ZCTA5 36475,893,8,885,0.008958566629339306,-4.070787431474492
ZCTA5 16258,893,8,885,0.008958566629339306,-4.070787431474492
ZCTA5 61870,537,1,536,0.00186219739292365,-4.071253314466589
ZCTA5 30522,479,0,479,0,-4.0717602057323
ZCTA5 25547,479,0,479,0,-4.0717602057323
ZCTA5 96140,479,0,479,0,-4.0717602057323
ZCTA5 25812,698,4,694,0.0057306590257879654,-4.073243106658134
ZCTA5 25159,1994,34,1960,0.017051153460381142,-4.073348310411096
ZCTA5 51560,798,6,792,0.007518796992481203,-4.0743508126163555
ZCTA5 24279,1875,31,1844,0.016533333333333334,-4.074625073306909
ZCTA5 65556,2152,38,2114,0.017657992565055763,-4.075101833348984
ZCTA5 38381,538,1,537,0.0018587360594795538,-4.075488765580036
ZCTA5 48108,10862,287,10575,0.026422389983428465,-4.075568745559363
ZCTA5 00617,7929,200,7729,0.02522386177323748,-4.075610226670456
ZCTA5 55722,480,0,480,0,-4.07600826135374
ZCTA5 89001,480,0,480,0,-4.07600826135374
ZCTA5 38553,1033,11,1022,0.010648596321393998,-4.0762031535254435
ZCTA5 30145,2577,49,2528,0.019014357780364765,-4.076470357922437
ZCTA5 35501,3693,79,3614,0.021391822366639588,-4.0765004878915265
ZCTA5 06092,1467,21,1446,0.014314928425357873,-4.07666222285567
ZCTA5 48615,1211,15,1196,0.012386457473162676,-4.077126987283867
ZCTA5 02466,2955,59,2896,0.01996615905245347,-4.07748483668379
ZCTA5 37040,17844,499,17345,0.027964581932302175,-4.078075753865142
ZCTA5 71653,1836,30,1806,0.016339869281045753,-4.078126171816397
ZCTA5 13142,2578,49,2529,0.01900698215671063,-4.079343802487503
ZCTA5 43723,2075,36,2039,0.017349397590361446,-4.079706584855845
ZCTA5 35963,481,0,481,0,-4.080251894217163
ZCTA5 60959,481,0,481,0,-4.080251894217163
ZCTA5 63452,481,0,481,0,-4.080251894217163
ZCTA5 68780,481,0,481,0,-4.080251894217163
ZCTA5 72581,481,0,481,0,-4.080251894217163
ZCTA5 95452,481,0,481,0,-4.080251894217163
ZCTA5 77531,5969,143,5826,0.02395711174401072,-4.080436910584679
ZCTA5 35097,648,3,645,0.004629629629629629,-4.080508028299169
ZCTA5 68876,648,3,645,0.004629629629629629,-4.080508028299169
ZCTA5 02109,1917,32,1885,0.016692749087115284,-4.081192613597673
ZCTA5 71403,1593,24,1569,0.015065913370998116,-4.081440460961488
ZCTA5 33067,8714,223,8491,0.025591002983704383,-4.082007591731494
ZCTA5 29353,1716,27,1689,0.015734265734265736,-4.082113775428849
ZCTA5 38039,595,2,593,0.0033613445378151263,-4.08211975820033
ZCTA5 38876,595,2,593,0.0033613445378151263,-4.08211975820033
ZCTA5 14605,4346,97,4249,0.0223193741371376,-4.082191392537703
ZCTA5 76476,989,10,979,0.010111223458038422,-4.082427161990238
ZCTA5 03844,896,8,888,0.008928571428571428,-4.082612611683977
ZCTA5 18832,751,5,746,0.006657789613848202,-4.083763056619028
ZCTA5 16232,1635,25,1610,0.01529051987767584,-4.084388557004923
ZCTA5 47020,482,0,482,0,-4.084491118107804
ZCTA5 53808,482,0,482,0,-4.084491118107804
ZCTA5 54554,482,0,482,0,-4.084491118107804
ZCTA5 05158,482,0,482,0,-4.084491118107804
ZCTA5 12442,482,0,482,0,-4.084491118107804
ZCTA5 10546,482,0,482,0,-4.084491118107804
ZCTA5 28393,849,7,842,0.008244994110718492,-4.084858413094092
ZCTA5 35618,849,7,842,0.008244994110718492,-4.084858413094092
ZCTA5 50604,801,6,795,0.00749063670411985,-4.086434353335392
ZCTA5 27041,3145,64,3081,0.020349761526232114,-4.086895412586676
ZCTA5 29646,10602,279,10323,0.02631578947368421,-4.0875358068047065
ZCTA5 54970,1214,15,1199,0.012355848434925865,-4.088104900985625
ZCTA5 15870,541,1,540,0.0018484288354898336,-4.088169081167002
ZCTA5 28909,483,0,483,0,-4.088725946739442
ZCTA5 45034,483,0,483,0,-4.088725946739442
ZCTA5 65612,483,0,483,0,-4.088725946739442
ZCTA5 25625,483,0,483,0,-4.088725946739442
ZCTA5 26031,702,4,698,0.005698005698005698,-4.089708880786086
ZCTA5 38671,13824,376,13448,0.027199074074074073,-4.089964076659854
ZCTA5 37149,991,10,981,0.010090817356205853,-4.090125310088592
ZCTA5 50658,991,10,981,0.010090817356205853,-4.090125310088592
ZCTA5 76825,2658,51,2607,0.019187358916478554,-4.090439387265585
ZCTA5 02721,11005,291,10714,0.026442526124488868,-4.090561585982414
ZCTA5 97045,20290,574,19716,0.028289797930014786,-4.090989524693009
ZCTA5 27360,18310,513,17797,0.028017476788640087,-4.091179032578004
ZCTA5 80102,2000,34,1966,0.017,-4.0921940496111535
ZCTA5 61728,484,0,484,0,-4.092956393754903
ZCTA5 78946,484,0,484,0,-4.092956393754903
ZCTA5 20611,484,0,484,0,-4.092956393754903
ZCTA5 60966,651,3,648,0.004608294930875576,-4.092969934858907
ZCTA5 32732,1760,28,1732,0.015909090909090907,-4.093330162619925
ZCTA5 49287,803,6,797,0.007471980074719801,-4.094472884462811
ZCTA5 75201,9532,247,9285,0.025912715065044063,-4.094631979154986
ZCTA5 15207,4887,112,4775,0.02291794556987927,-4.096119332344833
ZCTA5 14062,1346,18,1328,0.01337295690936107,-4.097107300790902
ZCTA5 50071,485,0,485,0,-4.097182472726587
ZCTA5 58458,485,0,485,0,-4.097182472726587
ZCTA5 66060,485,0,485,0,-4.097182472726587
ZCTA5 66023,485,0,485,0,-4.097182472726587
ZCTA5 65637,485,0,485,0,-4.097182472726587
ZCTA5 76483,485,0,485,0,-4.097182472726587
ZCTA5 27022,485,0,485,0,-4.097182472726587
ZCTA5 95672,1842,30,1812,0.016286644951140065,-4.09748768846672
ZCTA5 04350,1431,20,1411,0.013976240391334731,-4.097580793263333
ZCTA5 46628,10240,268,9972,0.026171875,-4.098133726017511
ZCTA5 71923,5978,143,5835,0.02392104382736701,-4.099020200757475
ZCTA5 75023,18121,507,17614,0.02797858837812483,-4.099121378353112
ZCTA5 08210,6187,149,6038,0.02408275416195248,-4.099322552953298
ZCTA5 51347,653,3,650,0.004594180704441042,-4.101258067662724
ZCTA5 64463,653,3,650,0.004594180704441042,-4.101258067662724
ZCTA5 29113,486,0,486,0,-4.101404197156962
ZCTA5 40868,486,0,486,0,-4.101404197156962
ZCTA5 98394,486,0,486,0,-4.101404197156962
ZCTA5 08322,3703,79,3624,0.02133405347015933,-4.101565411792473
ZCTA5 35748,2700,52,2648,0.01925925925925926,-4.101853290894411
ZCTA5 15559,805,6,799,0.007453416149068323,-4.102497761232817
ZCTA5 03470,2043,35,2008,0.017131669114047968,-4.10285475463731
ZCTA5 43963,600,2,598,0.0033333333333333335,-4.103051307176022
ZCTA5 68771,600,2,598,0.0033333333333333335,-4.103051307176022
ZCTA5 62933,654,3,651,0.0045871559633027525,-4.105396225208688
ZCTA5 42368,487,0,487,0,-4.105621580479081
ZCTA5 51238,487,0,487,0,-4.105621580479081
ZCTA5 59414,487,0,487,0,-4.105621580479081
ZCTA5 66020,487,0,487,0,-4.105621580479081
ZCTA5 66757,1391,19,1372,0.013659237958303379,-4.105655148623166
ZCTA5 32583,8558,218,8340,0.025473241411544754,-4.105887363428367
ZCTA5 40347,1086,12,1074,0.011049723756906077,-4.105951473056576
ZCTA5 50469,601,2,599,0.0033277870216306157,-4.10722523736859
ZCTA5 30543,1476,21,1455,0.014227642276422764,-4.1077970336651735
ZCTA5 15943,1560,23,1537,0.014743589743589743,-4.109741864687363
ZCTA5 31649,488,0,488,0,-4.1098346360570694
ZCTA5 04539,488,0,488,0,-4.1098346360570694
ZCTA5 51450,707,4,703,0.005657708628005658,-4.110206157826861
ZCTA5 01073,2397,44,2353,0.01835627868168544,-4.110699608558634
ZCTA5 14608,5071,117,4954,0.023072372313153223,-4.111363097003285
ZCTA5 68930,602,2,600,0.0033222591362126247,-4.111395068750427
ZCTA5 07711,602,2,600,0.0033222591362126247,-4.111395068750427
ZCTA5 50627,1264,16,1248,0.012658227848101266,-4.111657606144397
ZCTA5 70359,3005,60,2945,0.019966722129783693,-4.111664967923321
ZCTA5 97365,4894,112,4782,0.02288516550878627,-4.111804645708198
ZCTA5 38369,656,3,653,0.004573170731707317,-4.113660776464275
ZCTA5 92223,16599,460,16139,0.027712512801976022,-4.113839761468882
ZCTA5 64446,489,0,489,0,-4.1140433771866265
ZCTA5 01254,489,0,489,0,-4.1140433771866265
ZCTA5 06469,1133,13,1120,0.01147396293027361,-4.114446783984563
ZCTA5 30521,1807,29,1778,0.016048699501936912,-4.11462225708175
ZCTA5 36320,1351,18,1333,0.013323464100666173,-4.114826591513982
ZCTA5 99122,1603,24,1579,0.014971927635683094,-4.115157238293332
ZCTA5 98418,3818,82,3736,0.021477213200628602,-4.115574519337758
ZCTA5 05101,1968,33,1935,0.01676829268292683,-4.11648754537495
ZCTA5 61756,857,7,850,0.008168028004667444,-4.116588851221575
ZCTA5 44072,1808,29,1779,0.016039823008849558,-4.1178595807973215
ZCTA5 85257,14305,390,13915,0.027263194687172317,-4.11786132482723
ZCTA5 28611,490,0,490,0,-4.1182478170955115
ZCTA5 38452,490,0,490,0,-4.1182478170955115
ZCTA5 45881,490,0,490,0,-4.1182478170955115
ZCTA5 13318,490,0,490,0,-4.1182478170955115
ZCTA5 75762,4648,105,4543,0.022590361445783132,-4.1189022260543995
ZCTA5 52802,3784,81,3703,0.021405919661733615,-4.121597274674704
ZCTA5 12458,953,9,944,0.00944386149003148,-4.1220074584927
ZCTA5 31764,491,0,491,0,-4.122447968944028
ZCTA5 65771,491,0,491,0,-4.122447968944028
ZCTA5 67437,491,0,491,0,-4.122447968944028
ZCTA5 72045,491,0,491,0,-4.122447968944028
ZCTA5 46705,710,4,706,0.005633802816901409,-4.122459692826733
ZCTA5 05859,710,4,706,0.005633802816901409,-4.122459692826733
ZCTA5 49010,6788,166,6622,0.024454920447849145,-4.123292922927942
ZCTA5 53944,859,7,852,0.008149010477299184,-4.12448919756284
ZCTA5 06706,5077,117,4960,0.023045105377191254,-4.124599117479724
ZCTA5 57045,492,0,492,0,-4.126643845825508
ZCTA5 95306,492,0,492,0,-4.126643845825508
ZCTA5 02539,1397,19,1378,0.013600572655690766,-4.126694277454538
ZCTA5 21225,11996,320,11676,0.026675558519506502,-4.128831909762205
ZCTA5 85348,1137,13,1124,0.011433597185576077,-4.129272620511032
ZCTA5 24430,660,3,657,0.004545454545454545,-4.130143122337336
ZCTA5 21635,812,6,806,0.007389162561576354,-4.130478227505559
ZCTA5 26040,812,6,806,0.007389162561576354,-4.130478227505559
ZCTA5 56534,493,0,493,0,-4.130835460766786
ZCTA5 96107,493,0,493,0,-4.130835460766786
ZCTA5 35760,1893,31,1862,0.016376122556788168,-4.13217482885674
ZCTA5 57059,607,2,605,0.0032948929159802307,-4.132183153512688
ZCTA5 64855,909,8,901,0.0088008800880088,-4.133532623581366
ZCTA5 47649,661,3,658,0.0045385779122541605,-4.1342540295219266
ZCTA5 03263,1691,26,1665,0.01537551744529864,-4.1343088360874924
ZCTA5 50139,494,0,494,0,-4.135022826728668
ZCTA5 61259,494,0,494,0,-4.135022826728668
ZCTA5 72568,494,0,494,0,-4.135022826728668
ZCTA5 48750,3972,86,3886,0.0216515609264854,-4.136649358823633
ZCTA5 28905,1271,16,1255,0.012588512981904013,-4.13684871036043
ZCTA5 15357,553,1,552,0.0018083182640144665,-4.138506017040257
ZCTA5 01366,495,0,495,0,-4.139205956606405
ZCTA5 38915,1569,23,1546,0.014659018483110261,-4.14020917785963
ZCTA5 12928,765,5,760,0.006535947712418301,-4.140392567137839
ZCTA5 36912,911,8,903,0.008781558726673985,-4.141320563556124
ZCTA5 05494,663,3,660,0.004524886877828055,-4.1424643020388245
ZCTA5 14145,715,4,711,0.005594405594405594,-4.142808366872142
ZCTA5 34983,13795,374,13421,0.02711127220007249,-4.143021114809771
ZCTA5 11577,4300,95,4205,0.022093023255813953,-4.143072925611521
ZCTA5 47264,496,0,496,0,-4.1433848632301515
ZCTA5 70031,496,0,496,0,-4.1433848632301515
ZCTA5 05650,496,0,496,0,-4.1433848632301515
ZCTA5 14733,1570,23,1547,0.01464968152866242,-4.143585743550892
ZCTA5 05032,1005,10,995,0.009950248756218905,-4.143696777442106
ZCTA5 63382,1402,19,1383,0.01355206847360913,-4.144172486096101
ZCTA5 67730,766,5,761,0.006527415143603133,-4.144411102292749
ZCTA5 56050,610,2,608,0.003278688524590164,-4.144607563473932
ZCTA5 70079,1186,14,1172,0.011804384485666104,-4.146299618361009
ZCTA5 00911,3721,79,3642,0.02123085192152647,-4.146530983841391
ZCTA5 29107,1097,12,1085,0.010938924339106655,-4.147101659570098
ZCTA5 43748,1006,10,996,0.009940357852882704,-4.147502414507529
ZCTA5 41719,497,0,497,0,-4.147559559365428
ZCTA5 43337,497,0,497,0,-4.147559559365428
ZCTA5 58042,497,0,497,0,-4.147559559365428
ZCTA5 23035,497,0,497,0,-4.147559559365428
ZCTA5 87417,1898,31,1867,0.016332982086406742,-4.1480803288332515
ZCTA5 67039,1231,15,1216,0.012185215272136474,-4.149922065766872
ZCTA5 01952,3759,80,3679,0.021282255919127427,-4.150123488432101
ZCTA5 25571,817,6,811,0.0073439412484700125,-4.150363854047278
ZCTA5 61362,2333,42,2291,0.018002571795970854,-4.150459242277716
ZCTA5 04418,665,3,662,0.004511278195488722,-4.150659254530583
ZCTA5 74072,717,4,713,0.005578800557880056,-4.1509221981580735
ZCTA5 32701,9633,249,9384,0.025848645281843663,-4.151238071855849
ZCTA5 27332,10876,286,10590,0.026296432511952923,-4.151244639727401
ZCTA5 35592,1899,31,1868,0.016324381253291206,-4.151257263708944
ZCTA5 80808,2177,38,2139,0.017455213596692696,-4.151319607963368
ZCTA5 36752,498,0,498,0,-4.151730057713573
ZCTA5 53046,498,0,498,0,-4.151730057713573
ZCTA5 67878,768,5,763,0.006510416666666667,-4.152437746939153
ZCTA5 12865,1531,22,1509,0.014369693011103853,-4.1527215440645255
ZCTA5 74079,1573,23,1550,0.014621741894469168,-4.153705070510211
ZCTA5 46540,3797,81,3716,0.02133263102449302,-4.153785358065227
ZCTA5 75135,2373,43,2330,0.018120522545301308,-4.1539353947252
ZCTA5 80520,499,0,499,0,-4.1558963709121945
ZCTA5 18216,499,0,499,0,-4.1558963709121945
ZCTA5 23153,499,0,499,0,-4.1558963709121945
ZCTA5 25164,499,0,499,0,-4.1558963709121945
ZCTA5 86017,499,0,499,0,-4.1558963709121945
ZCTA5 27314,499,0,499,0,-4.1558963709121945
ZCTA5 03221,867,7,860,0.008073817762399077,-4.155963253603173
ZCTA5 54739,1861,30,1831,0.016120365394948953,-4.158457034320302
ZCTA5 89705,2140,37,2103,0.017289719626168223,-4.158465551486922
ZCTA5 16313,719,4,715,0.005563282336578581,-4.159021491306634
ZCTA5 66054,1055,11,1044,0.01042654028436019,-4.159490253807397
ZCTA5 45052,1533,22,1511,0.014350945857795172,-4.1595150506923755
ZCTA5 67208,7324,181,7143,0.024713271436373568,-4.160038386280584
ZCTA5 47949,500,0,500,0,-4.160058511535619
ZCTA5 10919,500,0,500,0,-4.160058511535619
ZCTA5 94923,500,0,500,0,-4.160058511535619
ZCTA5 48886,770,5,765,0.006493506493506494,-4.160450547007585
ZCTA5 14521,963,9,954,0.009345794392523364,-4.160501370857803
ZCTA5 49747,820,6,814,0.007317073170731708,-4.162255527916645
ZCTA5 27315,820,6,814,0.007317073170731708,-4.162255527916645
ZCTA5 67740,720,4,716,0.005555555555555556,-4.1630657092427255
ZCTA5 48509,3618,76,3542,0.021006080707573246,-4.163924937261361
ZCTA5 43762,1741,27,1714,0.015508328546812177,-4.164168357357706
ZCTA5 28527,501,0,501,0,-4.164216492095331
ZCTA5 47577,501,0,501,0,-4.164216492095331
ZCTA5 45889,501,0,501,0,-4.164216492095331
ZCTA5 05760,501,0,501,0,-4.164216492095331
ZCTA5 18425,501,0,501,0,-4.164216492095331
ZCTA5 97823,501,0,501,0,-4.164216492095331
ZCTA5 04048,1235,15,1220,0.012145748987854251,-4.164371948406455
ZCTA5 94965,5905,140,5765,0.023708721422523286,-4.164649614658357
ZCTA5 04040,1408,19,1389,0.013494318181818182,-4.16508159736314
ZCTA5 79007,4704,106,4598,0.022534013605442178,-4.165132463765029
ZCTA5 03561,2799,54,2745,0.01929260450160772,-4.166566285189209
ZCTA5 23959,560,1,559,0.0017857142857142857,-4.167591416372743
ZCTA5 36005,502,0,502,0,-4.168370325040416
ZCTA5 63932,502,0,502,0,-4.168370325040416
ZCTA5 65085,502,0,502,0,-4.168370325040416
ZCTA5 25181,502,0,502,0,-4.168370325040416
ZCTA5 36107,3101,62,3039,0.0199935504675911,-4.1685176010146545
ZCTA5 02559,1905,31,1874,0.01627296587926509,-4.170289845457301
ZCTA5 26452,3694,78,3616,0.021115322144017325,-4.170508349325224
ZCTA5 35078,722,4,718,0.00554016620498615,-4.171143333833066
ZCTA5 49893,722,4,718,0.00554016620498615,-4.171143333833066
ZCTA5 66401,722,4,718,0.00554016620498615,-4.171143333833066
ZCTA5 34433,2725,52,2673,0.01908256880733945,-4.172092759458519
ZCTA5 98337,3326,68,3258,0.020444978953698137,-4.172316163568333
ZCTA5 52351,503,0,503,0,-4.172520022757991
ZCTA5 67464,503,0,503,0,-4.172520022757991
ZCTA5 73766,503,0,503,0,-4.172520022757991
ZCTA5 25140,503,0,503,0,-4.172520022757991
ZCTA5 25252,503,0,503,0,-4.172520022757991
ZCTA5 75859,823,6,817,0.007290400972053463,-4.174117677439252
ZCTA5 68504,7778,194,7584,0.024942144510156854,-4.1747846768333225
ZCTA5 40208,6015,143,5872,0.02377389858686617,-4.1751497530283475
ZCTA5 97601,9681,250,9431,0.02582377853527528,-4.175174131055763
ZCTA5 13416,920,8,912,0.008695652173913044,-4.176217365035326
ZCTA5 42036,504,0,504,0,-4.176665597573636
ZCTA5 44250,504,0,504,0,-4.176665597573636
ZCTA5 53587,504,0,504,0,-4.176665597573636
ZCTA5 04607,504,0,504,0,-4.176665597573636
ZCTA5 14008,504,0,504,0,-4.176665597573636
ZCTA5 08609,4170,91,4079,0.02182254196642686,-4.177097793599121
ZCTA5 50424,618,2,616,0.003236245954692557,-4.177564370672299
ZCTA5 64748,618,2,616,0.003236245954692557,-4.177564370672299
ZCTA5 47260,724,4,720,0.0055248618784530384,-4.179206604268612
ZCTA5 97404,13391,361,13030,0.026958404898812634,-4.180279007500962
ZCTA5 16262,1106,12,1094,0.0108499095840868,-4.180541484109216
ZCTA5 70726,20332,573,19759,0.028182175880385598,-4.180561836976049
ZCTA5 00767,11730,311,11419,0.026513213981244673,-4.180578770527391
ZCTA5 40810,505,0,505,0,-4.180807061751827
ZCTA5 58785,505,0,505,0,-4.180807061751827
ZCTA5 61014,505,0,505,0,-4.180807061751827
ZCTA5 25502,505,0,505,0,-4.180807061751827
ZCTA5 26374,505,0,505,0,-4.180807061751827
ZCTA5 25646,505,0,505,0,-4.180807061751827
ZCTA5 96028,505,0,505,0,-4.180807061751827
ZCTA5 13797,825,6,819,0.007272727272727273,-4.182009475387783
ZCTA5 98024,2305,41,2264,0.017787418655097614,-4.182921962804175
ZCTA5 52144,564,1,563,0.0017730496453900709,-4.184121800260942
ZCTA5 14743,776,5,771,0.006443298969072165,-4.184406548241346
ZCTA5 45766,506,0,506,0,-4.184944427496348
ZCTA5 51235,506,0,506,0,-4.184944427496348
ZCTA5 14837,2149,37,2112,0.0172173103769195,-4.18586785124964
ZCTA5 16121,2070,35,2035,0.016908212560386472,-4.186415268622376
ZCTA5 03255,875,7,868,0.008,-4.1872362775460195
ZCTA5 33158,2110,36,2074,0.017061611374407582,-4.1874845988028
ZCTA5 28434,507,0,507,0,-4.189077706950725
ZCTA5 36456,507,0,507,0,-4.189077706950725
ZCTA5 41519,507,0,507,0,-4.189077706950725
ZCTA5 41837,507,0,507,0,-4.189077706950725
ZCTA5 58240,507,0,507,0,-4.189077706950725
ZCTA5 15049,507,0,507,0,-4.189077706950725
ZCTA5 22740,507,0,507,0,-4.189077706950725
ZCTA5 67003,1017,10,1007,0.00983284169124877,-4.189183637121391
ZCTA5 54170,1415,19,1396,0.01342756183745583,-4.189387075822349
ZCTA5 39039,827,6,821,0.007255139056831923,-4.189888301782269
ZCTA5 98648,1286,16,1270,0.012441679626749611,-4.190470610574652
ZCTA5 53579,727,4,723,0.005502063273727648,-4.191274754411301
ZCTA5 14741,727,4,723,0.005502063273727648,-4.191274754411301
ZCTA5 68117,3147,63,3084,0.02001906577693041,-4.191361536578921
ZCTA5 55751,675,3,672,0.0044444444444444444,-4.1914070722784
ZCTA5 20714,2032,34,1998,0.01673228346456693,-4.191913691171666
ZCTA5 33786,778,5,773,0.006426735218508998,-4.192364635917956
ZCTA5 14504,778,5,773,0.006426735218508998,-4.192364635917956
ZCTA5 08879,8913,227,8686,0.025468416919106923,-4.192714531068929
ZCTA5 35572,508,0,508,0,-4.193206912198627
ZCTA5 74427,508,0,508,0,-4.193206912198627
ZCTA5 13755,508,0,508,0,-4.193206912198627
ZCTA5 24976,508,0,508,0,-4.193206912198627
ZCTA5 70403,11070,291,10779,0.026287262872628725,-4.193470023402437
ZCTA5 83833,676,3,673,0.004437869822485207,-4.195461289934193
ZCTA5 79363,1913,31,1882,0.01620491374803973,-4.19558963861906
ZCTA5 47281,509,0,509,0,-4.197332055264289
ZCTA5 72471,509,0,509,0,-4.197332055264289
ZCTA5 72415,509,0,509,0,-4.197332055264289
ZCTA5 56266,623,2,621,0.0032102728731942215,-4.198035069274781
ZCTA5 61726,973,9,964,0.009249743062692703,-4.198709192825327
ZCTA5 30538,1111,12,1099,0.010801080108010801,-4.199031633355092
ZCTA5 54630,1711,26,1685,0.015195791934541203,-4.20002847715758
ZCTA5 28774,510,0,510,0,-4.2014531481129165
ZCTA5 43915,510,0,510,0,-4.2014531481129165
ZCTA5 51577,510,0,510,0,-4.2014531481129165
ZCTA5 55713,510,0,510,0,-4.2014531481129165
ZCTA5 70080,510,0,510,0,-4.2014531481129165
ZCTA5 01008,510,0,510,0,-4.2014531481129165
ZCTA5 08887,510,0,510,0,-4.2014531481129165
ZCTA5 99171,510,0,510,0,-4.2014531481129165
ZCTA5 31023,5572,130,5442,0.023330940416367553,-4.202340044283984
ZCTA5 30092,14530,395,14135,0.02718513420509291,-4.202446575961886
ZCTA5 46534,4217,92,4125,0.021816457197059522,-4.20276923435204
ZCTA5 64030,9799,253,9546,0.025818961118481476,-4.203194261201288
ZCTA5 87402,3744,79,3665,0.021100427350427352,-4.20370669947497
ZCTA5 28670,1202,14,1188,0.011647254575707155,-4.204469444619943
ZCTA5 50680,511,0,511,0,-4.205570202651091
ZCTA5 61242,511,0,511,0,-4.205570202651091
ZCTA5 23027,511,0,511,0,-4.205570202651091
ZCTA5 37701,3190,64,3126,0.02006269592476489,-4.206195429309048
ZCTA5 12015,1113,12,1101,0.01078167115902965,-4.2064103543452624
ZCTA5 27524,4758,107,4651,0.022488440521227407,-4.2064529594000515
ZCTA5 25045,1997,33,1964,0.016524787180771158,-4.20722114979814
ZCTA5 59063,782,5,777,0.00639386189258312,-4.208240333310084
ZCTA5 05156,3783,80,3703,0.021147237642083004,-4.209533128705565
ZCTA5 01702,15227,416,14811,0.027319892296578448,-4.209585860178142
ZCTA5 28439,512,0,512,0,-4.20968323072717
ZCTA5 59487,512,0,512,0,-4.20968323072717
ZCTA5 57311,512,0,512,0,-4.20968323072717
ZCTA5 23022,512,0,512,0,-4.20968323072717
ZCTA5 93424,512,0,512,0,-4.20968323072717
ZCTA5 56097,1548,22,1526,0.014211886304909561,-4.2102417129417535
ZCTA5 13471,1248,15,1233,0.01201923076923077,-4.2110878762946315
ZCTA5 08063,1069,11,1058,0.01028999064546305,-4.211825857629903
ZCTA5 65606,1336,17,1319,0.012724550898203593,-4.213658753240727
ZCTA5 48427,1115,12,1103,0.010762331838565023,-4.213779220663879
ZCTA5 61734,1115,12,1103,0.010762331838565023,-4.213779220663879
ZCTA5 48762,513,0,513,0,-4.213792244131685
ZCTA5 58638,513,0,513,0,-4.213792244131685
ZCTA5 18464,513,0,513,0,-4.213792244131685
ZCTA5 95453,4618,103,4515,0.022304027717626677,-4.213797018869031
ZCTA5 40229,14175,384,13791,0.02708994708994709,-4.213815134100286
ZCTA5 94118,17657,490,17167,0.027751033584414112,-4.214454875161516
ZCTA5 98383,8518,215,8303,0.025240666823197935,-4.215650422206901
ZCTA5 01005,1798,28,1770,0.01557285873192436,-4.21656967888772
ZCTA5 57043,572,1,571,0.0017482517482517483,-4.216990126176695
ZCTA5 43730,834,6,828,0.007194244604316547,-4.217362896371218
ZCTA5 54234,834,6,828,0.007194244604316547,-4.217362896371218
ZCTA5 98537,834,6,828,0.007194244604316547,-4.217362896371218
ZCTA5 22401,10582,276,10306,0.02608202608202608,-4.217406910593141
ZCTA5 60162,2969,58,2911,0.01953519703603907,-4.217721633547093
ZCTA5 72865,514,0,514,0,-4.217897254597738
ZCTA5 87732,514,0,514,0,-4.217897254597738
ZCTA5 81427,514,0,514,0,-4.217897254597738
ZCTA5 87801,2665,50,2615,0.01876172607879925,-4.218015208174641
ZCTA5 62674,628,2,626,0.0031847133757961785,-4.218409462791013
ZCTA5 68873,1466,20,1446,0.013642564802182811,-4.218436701051224
ZCTA5 55371,6176,147,6029,0.023801813471502592,-4.218457871401161
ZCTA5 54002,2550,47,2503,0.01843137254901961,-4.218774800813329
ZCTA5 47334,1294,16,1278,0.012364760432766615,-4.218871917520457
ZCTA5 46917,682,3,679,0.004398826979472141,-4.21970924816738
ZCTA5 01118,5686,133,5553,0.023390784382694336,-4.220016160615167
ZCTA5 63357,1840,29,1811,0.01576086956521739,-4.220684198909346
ZCTA5 27523,4116,89,4027,0.021622934888241012,-4.221179573583893
ZCTA5 18833,835,6,829,0.00718562874251497,-4.221275072666261
ZCTA5 35585,515,0,515,0,-4.221998273801393
ZCTA5 43413,515,0,515,0,-4.221998273801393
ZCTA5 51461,515,0,515,0,-4.221998273801393
ZCTA5 61841,515,0,515,0,-4.221998273801393
ZCTA5 25202,515,0,515,0,-4.221998273801393
ZCTA5 60963,683,3,680,0.004392386530014641,-4.223737773251254
ZCTA5 47353,2201,38,2163,0.017264879600181735,-4.223797712525872
ZCTA5 53061,2122,36,2086,0.016965127238454288,-4.224092027630359
ZCTA5 66748,1118,12,1106,0.01073345259391771,-4.224814119510931
ZCTA5 07803,1252,15,1237,0.011980830670926517,-4.225387114871355
ZCTA5 12919,1252,15,1237,0.011980830670926517,-4.225387114871355
ZCTA5 63070,3160,63,3097,0.019936708860759492,-4.2257555228267405
ZCTA5 29178,1296,16,1280,0.012345679012345678,-4.225951106710339
ZCTA5 65590,516,0,516,0,-4.226095313362057
ZCTA5 42347,2320,41,2279,0.01767241379310345,-4.227315417942804
ZCTA5 98620,3048,60,2988,0.01968503937007874,-4.227461407598794
ZCTA5 73669,684,3,681,0.0043859649122807015,-4.2277626662916505
ZCTA5 46371,1164,13,1151,0.011168384879725086,-4.228332415193736
ZCTA5 54161,1253,15,1238,0.011971268954509178,-4.228956470993522
ZCTA5 32668,2044,34,2010,0.016634050880626222,-4.228971019383412
ZCTA5 12149,981,9,972,0.009174311926605505,-4.229073314835864
ZCTA5 57212,886,7,879,0.007900677200902935,-4.22991487265715
ZCTA5 36758,517,0,517,0,-4.230188384842871
ZCTA5 54212,517,0,517,0,-4.230188384842871
ZCTA5 81023,517,0,517,0,-4.230188384842871
ZCTA5 04660,517,0,517,0,-4.230188384842871
ZCTA5 26802,517,0,517,0,-4.230188384842871
ZCTA5 59935,1554,22,1532,0.014157014157014158,-4.230422512186124
ZCTA5 31082,3755,79,3676,0.02103861517976032,-4.230941548749674
ZCTA5 03603,2164,37,2127,0.017097966728280962,-4.231324978182472
ZCTA5 74848,2243,39,2204,0.017387427552385197,-4.231630716544596
ZCTA5 16912,788,5,783,0.006345177664974619,-4.231953645603239
ZCTA5 55007,887,7,880,0.007891770011273957,-4.233776534732169
ZCTA5 08828,887,7,880,0.007891770011273957,-4.233776534732169
ZCTA5 87520,518,0,518,0,-4.23427749975109
ZCTA5 78954,518,0,518,0,-4.23427749975109
ZCTA5 26681,518,0,518,0,-4.23427749975109
ZCTA5 14775,1029,10,1019,0.009718172983479106,-4.234281872640719
ZCTA5 29048,2006,33,1973,0.016450648055832504,-4.235157098141437
ZCTA5 02825,2006,33,1973,0.016450648055832504,-4.235157098141437
ZCTA5 38126,2086,35,2051,0.016778523489932886,-4.235503513260365
ZCTA5 76021,15378,420,14958,0.027311744049941473,-4.236025985179334
ZCTA5 50619,983,9,974,0.009155645981688708,-4.236636643848529
ZCTA5 55381,839,6,833,0.007151370679380214,-4.236892151953261
ZCTA5 36351,1386,18,1368,0.012987012987012988,-4.237443957193538
ZCTA5 42352,888,7,881,0.007882882882882882,-4.237635190184927
ZCTA5 06793,519,0,519,0,-4.238362669538455
ZCTA5 15927,519,0,519,0,-4.238362669538455
ZCTA5 81055,739,4,735,0.005412719891745603,-4.239230820819969
ZCTA5 95926,14986,408,14578,0.027225410383024156,-4.240461405089232
ZCTA5 87107,13101,351,12750,0.026791847950538128,-4.240784124379845
ZCTA5 55767,1344,17,1327,0.012648809523809524,-4.241697398806868
ZCTA5 23919,1031,10,1021,0.009699321047526674,-4.2417610895004385
ZCTA5 30558,1968,32,1936,0.016260162601626018,-4.241845125565133
ZCTA5 23024,3241,65,3176,0.02005553841406973,-4.241951322737318
ZCTA5 45853,520,0,520,0,-4.242443905601574
ZCTA5 50162,520,0,520,0,-4.242443905601574
ZCTA5 17352,520,0,520,0,-4.242443905601574
ZCTA5 59041,740,4,736,0.005405405405405406,-4.243204601396476
ZCTA5 72067,1257,15,1242,0.011933174224343675,-4.243212186570288
ZCTA5 69145,1345,17,1328,0.012639405204460967,-4.245193131303858
ZCTA5 56072,890,7,883,0.007865168539325843,-4.2453435071139065
ZCTA5 79364,3017,59,2958,0.0195558501823003,-4.245370356065875
ZCTA5 43445,521,0,521,0,-4.246521219282289
ZCTA5 59317,521,0,521,0,-4.246521219282289
ZCTA5 57012,521,0,521,0,-4.246521219282289
ZCTA5 61572,521,0,521,0,-4.246521219282289
ZCTA5 11548,521,0,521,0,-4.246521219282289
ZCTA5 12913,521,0,521,0,-4.246521219282289
ZCTA5 16443,521,0,521,0,-4.246521219282289
ZCTA5 93544,521,0,521,0,-4.246521219282289
ZCTA5 13783,1124,12,1112,0.010676156583629894,-4.246818105920429
ZCTA5 43071,741,4,737,0.005398110661268556,-4.2471749514987405
ZCTA5 02125,12474,332,12142,0.026615359948693282,-4.247678102288637
ZCTA5 71409,2090,35,2055,0.01674641148325359,-4.247726467737374
ZCTA5 26260,689,3,686,0.0043541364296081275,-4.247832980523918
ZCTA5 66615,1389,18,1371,0.012958963282937365,-4.247841021880777
ZCTA5 58012,986,9,977,0.009127789046653144,-4.24796103976473
ZCTA5 19541,1726,26,1700,0.015063731170336037,-4.248909777895222
ZCTA5 46524,891,7,884,0.007856341189674524,-4.249193181479988
ZCTA5 26059,1033,10,1023,0.00968054211035818,-4.249229798394317
ZCTA5 38067,580,1,579,0.0017241379310344827,-4.2496067306403935
ZCTA5 45694,4562,101,4461,0.022139412538360367,-4.250001492157735
ZCTA5 76638,1125,12,1113,0.010666666666666666,-4.250476956263389
ZCTA5 47223,522,0,522,0,-4.250594621868045
ZCTA5 61353,522,0,522,0,-4.250594621868045
ZCTA5 66865,522,0,522,0,-4.250594621868045
ZCTA5 87548,522,0,522,0,-4.250594621868045
ZCTA5 26559,522,0,522,0,-4.250594621868045
ZCTA5 93923,5489,127,5362,0.023137183457824742,-4.250753949447802
ZCTA5 30662,3468,71,3397,0.020472895040369088,-4.251309226894227
ZCTA5 12062,690,3,687,0.004347826086956522,-4.251836278558569
ZCTA5 45223,5596,130,5466,0.023230879199428164,-4.253006882684935
ZCTA5 32408,7408,182,7226,0.02456803455723542,-4.253343333531547
ZCTA5 29536,5702,133,5569,0.023325149070501577,-4.253511629680702
ZCTA5 21161,1891,30,1861,0.015864621893178214,-4.253687226396432
ZCTA5 30171,1260,15,1245,0.011904761904761904,-4.253881276324808
ZCTA5 39751,523,0,523,0,-4.25466412459225
ZCTA5 69129,523,0,523,0,-4.25466412459225
ZCTA5 15030,523,0,523,0,-4.25466412459225
ZCTA5 25501,523,0,523,0,-4.25466412459225
ZCTA5 97419,523,0,523,0,-4.25466412459225
ZCTA5 49072,1216,14,1202,0.011513157894736841,-4.254888290700239
ZCTA5 54635,743,4,739,0.005383580080753701,-4.25510539404826
ZCTA5 47305,1728,26,1702,0.015046296296296295,-4.255401226923723
ZCTA5 61232,524,0,524,0,-4.258729738634648
ZCTA5 84328,524,0,524,0,-4.258729738634648
ZCTA5 12166,524,0,524,0,-4.258729738634648
ZCTA5 14731,524,0,524,0,-4.258729738634648
ZCTA5 30205,1082,11,1071,0.010166358595194085,-4.259973846560429
ZCTA5 49252,1036,10,1026,0.009652509652509652,-4.260413246599517
ZCTA5 04049,1262,15,1247,0.011885895404120444,-4.260983246636161
ZCTA5 30750,1306,16,1290,0.01225114854517611,-4.261221542135111
ZCTA5 46118,1934,31,1903,0.016028955532574975,-4.261588304540854
ZCTA5 46601,2214,38,2176,0.017163504968383016,-4.2627796594770055
ZCTA5 43432,525,0,525,0,-4.262791475121665
ZCTA5 50251,525,0,525,0,-4.262791475121665
ZCTA5 24946,525,0,525,0,-4.262791475121665
ZCTA5 91701,13050,349,12701,0.02674329501915709,-4.263366679110726
ZCTA5 72372,846,6,840,0.0070921985815602835,-4.264101373171036
ZCTA5 45648,4497,99,4398,0.022014676450967312,-4.266133103497886
ZCTA5 47432,1976,32,1944,0.016194331983805668,-4.266731652088941
ZCTA5 71027,526,0,526,0,-4.266849345126769
ZCTA5 76679,526,0,526,0,-4.266849345126769
ZCTA5 79012,526,0,526,0,-4.266849345126769
ZCTA5 08326,526,0,526,0,-4.266849345126769
ZCTA5 25043,526,0,526,0,-4.266849345126769
ZCTA5 26055,526,0,526,0,-4.266849345126769
ZCTA5 54871,1264,15,1249,0.011867088607594937,-4.268076644047741
ZCTA5 18015,11151,292,10859,0.026185992287687202,-4.268254768813205
ZCTA5 54982,3026,59,2967,0.019497686715135493,-4.2694907614060735
ZCTA5 28447,527,0,527,0,-4.270903359670824
ZCTA5 58646,527,0,527,0,-4.270903359670824
ZCTA5 05682,527,0,527,0,-4.270903359670824
ZCTA5 14858,527,0,527,0,-4.270903359670824
ZCTA5 51005,641,2,639,0.0031201248049922,-4.270941546941987
ZCTA5 13034,798,5,793,0.006265664160401002,-4.271212725879522
ZCTA5 33712,9366,239,9127,0.025517830450565878,-4.271346530065005
ZCTA5 46994,1039,10,1029,0.009624639076034648,-4.271573275476589
ZCTA5 24639,1265,15,1250,0.011857707509881422,-4.271620136459243
ZCTA5 56284,848,6,842,0.007075471698113208,-4.271847501514711
ZCTA5 47553,3140,62,3078,0.019745222929936305,-4.272032861899434
ZCTA5 48811,1221,14,1207,0.011466011466011465,-4.272788598636431
ZCTA5 12926,993,9,984,0.00906344410876133,-4.274289265131451
ZCTA5 12548,528,0,528,0,-4.274953529722438
ZCTA5 03047,642,2,640,0.003115264797507788,-4.274956522362643
ZCTA5 49735,7970,198,7772,0.024843161856963614,-4.2751396910975314
ZCTA5 48624,6658,160,6498,0.024031240612796635,-4.275871415363794
ZCTA5 32322,1132,12,1120,0.01060070671378092,-4.27602162036475
ZCTA5 31329,3404,69,3335,0.02027027027027027,-4.277641931307712
ZCTA5 43746,529,0,529,0,-4.278999866198308
ZCTA5 49612,529,0,529,0,-4.278999866198308
ZCTA5 56028,529,0,529,0,-4.278999866198308
ZCTA5 72534,529,0,529,0,-4.278999866198308
ZCTA5 80454,529,0,529,0,-4.278999866198308
ZCTA5 04932,529,0,529,0,-4.278999866198308
ZCTA5 23433,529,0,529,0,-4.278999866198308
ZCTA5 38641,800,5,795,0.00625,-4.279025629005618
ZCTA5 33823,10923,285,10638,0.026091733040373523,-4.2791783147158435
ZCTA5 62520,697,3,694,0.00430416068866571,-4.27976000998815
ZCTA5 62086,588,1,587,0.0017006802721088435,-4.281977265050185
ZCTA5 11786,1900,30,1870,0.015789473684210527,-4.282013915108828
ZCTA5 39094,1442,19,1423,0.013176144244105409,-4.282261134601317
ZCTA5 71070,750,4,746,0.005333333333333333,-4.28275511439666
ZCTA5 14544,750,4,746,0.005333333333333333,-4.28275511439666
ZCTA5 16510,10016,258,9758,0.025758785942492014,-4.28297049622045
ZCTA5 64473,644,2,642,0.003105590062111801,-4.282975508934276
ZCTA5 46911,530,0,530,0,-4.283042379963563
ZCTA5 52640,530,0,530,0,-4.283042379963563
ZCTA5 52320,530,0,530,0,-4.283042379963563
ZCTA5 03251,530,0,530,0,-4.283042379963563
ZCTA5 42202,948,8,940,0.008438818565400843,-4.2832685277035845
ZCTA5 88048,948,8,940,0.008438818565400843,-4.2832685277035845
ZCTA5 49338,698,3,695,0.004297994269340974,-4.283735029776054
ZCTA5 06375,1443,19,1424,0.013167013167013167,-4.285674649460174
ZCTA5 57042,3370,68,3302,0.020178041543026708,-4.2859997304190935
ZCTA5 60446,11665,307,11358,0.02631804543506215,-4.286203339385706
ZCTA5 43217,751,4,747,0.005326231691078562,-4.286691619049817
ZCTA5 53125,802,5,797,0.006234413965087282,-4.28682570187705
ZCTA5 73859,531,0,531,0,-4.287081081832106
ZCTA5 50207,852,6,846,0.007042253521126761,-4.287302870408279
ZCTA5 60531,699,3,696,0.004291845493562232,-4.287706555317144
ZCTA5 64062,2183,37,2146,0.01694915254237288,-4.288526431658459
ZCTA5 58341,1181,13,1168,0.01100762066045724,-4.289821471994753
ZCTA5 54974,590,1,589,0.001694915254237288,-4.290032092618607
ZCTA5 37828,532,0,532,0,-4.291115982566952
ZCTA5 61776,532,0,532,0,-4.291115982566952
ZCTA5 56149,532,0,532,0,-4.291115982566952
ZCTA5 10917,532,0,532,0,-4.291115982566952
ZCTA5 14869,532,0,532,0,-4.291115982566952
ZCTA5 16935,532,0,532,0,-4.291115982566952
ZCTA5 18503,532,0,532,0,-4.291115982566952
ZCTA5 68112,4364,95,4269,0.021769019248395968,-4.292821071527733
ZCTA5 11005,1271,15,1256,0.011801730920535013,-4.292836416631049
ZCTA5 04110,533,0,533,0,-4.295147092880562
ZCTA5 07620,533,0,533,0,-4.295147092880562
ZCTA5 48836,5048,114,4934,0.022583201267828843,-4.295307270131101
ZCTA5 23487,2225,38,2187,0.01707865168539326,-4.295614646524903
ZCTA5 68853,701,3,698,0.0042796005706134095,-4.295639159155899
ZCTA5 65616,11504,302,11202,0.026251738525730182,-4.296071527257339
ZCTA5 04861,1316,16,1300,0.0121580547112462,-4.296285160377739
ZCTA5 83801,2616,48,2568,0.01834862385321101,-4.2965585115022495
ZCTA5 65656,1782,27,1755,0.015151515151515152,-4.296679599912533
ZCTA5 63468,999,9,990,0.009009009009009009,-4.296751160595393
ZCTA5 44609,1574,22,1552,0.01397712833545108,-4.297246573276962
ZCTA5 48449,1138,12,1126,0.01054481546572935,-4.297824089624552
ZCTA5 13073,2578,47,2531,0.018231186966640806,-4.298398053923844
ZCTA5 12023,805,5,800,0.006211180124223602,-4.2985018843011265
ZCTA5 17099,534,0,534,0,-4.299174423435172
ZCTA5 80110,9281,236,9045,0.025428294364831378,-4.299889086284345
ZCTA5 08846,4943,111,4832,0.022455998381549665,-4.300134880976044
ZCTA5 70070,4620,102,4518,0.02207792207792208,-4.30017581579841
ZCTA5 71860,953,8,945,0.008394543546694649,-4.302150170628656
ZCTA5 57216,535,0,535,0,-4.303197984843126
ZCTA5 61078,535,0,535,0,-4.303197984843126
ZCTA5 70531,535,0,535,0,-4.303197984843126
ZCTA5 01262,535,0,535,0,-4.303197984843126
ZCTA5 30222,1618,23,1595,0.014215080346106305,-4.303667550675265
ZCTA5 15722,954,8,946,0.008385744234800839,-4.30591816357142
ZCTA5 70663,10469,271,10198,0.02588594899226287,-4.306397419206379
ZCTA5 17935,650,2,648,0.003076923076923077,-4.306945452546754
ZCTA5 96118,650,2,648,0.003076923076923077,-4.306945452546754
ZCTA5 12307,1908,30,1878,0.015723270440251572,-4.307100898859368
ZCTA5 44638,536,0,536,0,-4.307217787667201
ZCTA5 68523,536,0,536,0,-4.307217787667201
ZCTA5 72368,536,0,536,0,-4.307217787667201
ZCTA5 25082,536,0,536,0,-4.307217787667201
ZCTA5 35205,9489,242,9247,0.025503214248076722,-4.307219867563223
ZCTA5 35463,704,3,701,0.004261363636363636,-4.3075120789612
ZCTA5 34734,1363,17,1346,0.012472487160674981,-4.307775238743546
ZCTA5 43060,1002,9,993,0.008982035928143712,-4.307946086889192
ZCTA5 49862,1493,20,1473,0.013395847287340924,-4.310120216210491
ZCTA5 07606,808,5,803,0.006188118811881188,-4.310149530891993
ZCTA5 44702,537,0,537,0,-4.311233842420931
ZCTA5 48649,537,0,537,0,-4.311233842420931
ZCTA5 57234,537,0,537,0,-4.311233842420931
ZCTA5 62979,537,0,537,0,-4.311233842420931
ZCTA5 12726,537,0,537,0,-4.311233842420931
ZCTA5 36856,2427,43,2384,0.017717346518335394,-4.311389887583142
ZCTA5 17751,2583,47,2536,0.018195896244676733,-4.3125387600615985
ZCTA5 93546,3080,60,3020,0.01948051948051948,-4.312715891492109
ZCTA5 95405,8369,209,8160,0.024973115067511053,-4.314732448251077
ZCTA5 93238,538,0,538,0,-4.315246159568923
ZCTA5 04085,706,3,703,0.00424929178470255,-4.315410136807693
ZCTA5 70422,5093,115,4978,0.022580011780875712,-4.315675698939231
ZCTA5 47993,1495,20,1475,0.013377926421404682,-4.3168595236073655
ZCTA5 41010,1366,17,1349,0.012445095168374817,-4.3181434463558395
ZCTA5 98012,23593,670,22923,0.02839825371932353,-4.31878337811303
ZCTA5 12529,1005,9,996,0.008955223880597015,-4.319117185296101
ZCTA5 36871,539,0,539,0,-4.319254749527184
ZCTA5 17985,539,0,539,0,-4.319254749527184
ZCTA5 25938,539,0,539,0,-4.319254749527184
ZCTA5 11718,1144,12,1132,0.01048951048951049,-4.319541698684459
ZCTA5 59019,1665,24,1641,0.014414414414414415,-4.3204943866773835
ZCTA5 21754,2273,39,2234,0.01715794104707435,-4.32067994912356
ZCTA5 04347,1099,11,1088,0.010009099181073703,-4.322301049317232
ZCTA5 29351,540,0,540,0,-4.3232596226634294
ZCTA5 04095,540,0,540,0,-4.3232596226634294
ZCTA5 12959,540,0,540,0,-4.3232596226634294
ZCTA5 18631,540,0,540,0,-4.3232596226634294
ZCTA5 25844,540,0,540,0,-4.3232596226634294
ZCTA5 99101,540,0,540,0,-4.3232596226634294
ZCTA5 00917,8238,205,8033,0.02488468074775431,-4.325466979445655
ZCTA5 39766,1191,13,1178,0.0109151973131822,-4.325682845829575
ZCTA5 44507,2076,34,2042,0.016377649325626204,-4.326913649230435
ZCTA5 44449,541,0,541,0,-4.327260789297398
ZCTA5 65016,541,0,541,0,-4.327260789297398
ZCTA5 21921,16236,444,15792,0.027346637102734665,-4.327869192677615
ZCTA5 53585,863,6,857,0.006952491309385863,-4.329554688203664
ZCTA5 65565,1956,31,1925,0.015848670756646217,-4.330099489501999
ZCTA5 55013,2628,48,2580,0.0182648401826484,-4.330287276377605
ZCTA5 38577,542,0,542,0,-4.331258259701162
ZCTA5 12719,542,0,542,0,-4.331258259701162
ZCTA5 10986,542,0,542,0,-4.331258259701162
ZCTA5 36352,1875,29,1846,0.015466666666666667,-4.331482724526652
ZCTA5 43910,1282,15,1267,0.01170046801872075,-4.331535903971447
ZCTA5 76932,1148,12,1136,0.010452961672473868,-4.333973395997926
ZCTA5 31822,2317,40,2277,0.017263703064307294,-4.333987623357745
ZCTA5 44503,543,0,543,0,-4.335252044099436
ZCTA5 04290,543,0,543,0,-4.335252044099436
ZCTA5 15665,543,0,543,0,-4.335252044099436
ZCTA5 24530,543,0,543,0,-4.335252044099436
ZCTA5 03748,2159,36,2123,0.01667438628994905,-4.33588625571291
ZCTA5 44840,962,8,954,0.008316008316008316,-4.335963018207226
ZCTA5 65613,6654,159,6495,0.023895401262398558,-4.336207989810812
ZCTA5 41059,914,7,907,0.007658643326039387,-4.336925686209811
ZCTA5 35217,4889,109,4780,0.022294947842094497,-4.339205094205497
ZCTA5 65040,544,0,544,0,-4.33924215266988
ZCTA5 68714,544,0,544,0,-4.33924215266988
ZCTA5 79414,7834,193,7641,0.024636201174368138,-4.340376447154971
ZCTA5 74561,816,5,811,0.006127450980392157,-4.341071900584496
ZCTA5 29583,1919,30,1889,0.015633142261594582,-4.34145510765119
ZCTA5 06756,1058,10,1048,0.00945179584120983,-4.341718062599273
ZCTA5 83611,659,2,657,0.0030349013657056147,-4.3426592719048065
ZCTA5 13746,867,6,861,0.006920415224913495,-4.34482917361769
ZCTA5 49730,817,5,812,0.006119951040391677,-4.344923209582653
ZCTA5 28420,1330,16,1314,0.012030075187969926,-4.345032787405006
ZCTA5 69336,1059,10,1049,0.009442870632672332,-4.34538464150007
ZCTA5 47385,604,1,603,0.0016556291390728477,-4.3460017046854595
ZCTA5 54407,604,1,603,0.0016556291390728477,-4.3460017046854595
ZCTA5 28651,3055,59,2996,0.019312602291325694,-4.346790895271304
ZCTA5 05822,714,3,711,0.004201680672268907,-4.346866083550085
ZCTA5 48028,546,0,546,0,-4.347211382804469
ZCTA5 50597,546,0,546,0,-4.347211382804469
ZCTA5 63626,546,0,546,0,-4.347211382804469
ZCTA5 66956,546,0,546,0,-4.347211382804469
ZCTA5 20620,546,0,546,0,-4.347211382804469
ZCTA5 03908,2865,54,2811,0.018848167539267015,-4.347696196621109
ZCTA5 06247,1106,11,1095,0.009945750452079566,-4.347760469424394
ZCTA5 54740,818,5,813,0.006112469437652812,-4.3487714338423364
ZCTA5 37025,2043,33,2010,0.016152716593245228,-4.348924919167658
ZCTA5 67101,1632,23,1609,0.014093137254901961,-4.3496421040002735
ZCTA5 43315,2635,48,2587,0.018216318785578747,-4.349901745882389
ZCTA5 68064,1590,22,1568,0.013836477987421384,-4.350221577210325
ZCTA5 46147,1198,13,1185,0.010851419031719533,-4.350652348247212
ZCTA5 46030,1198,13,1185,0.010851419031719533,-4.350652348247212
ZCTA5 51038,715,3,712,0.004195804195804196,-4.350782884841637
ZCTA5 06752,715,3,712,0.004195804195804196,-4.350782884841637
ZCTA5 36575,7391,180,7211,0.02435394398592883,-4.350815969926224
ZCTA5 71203,13808,370,13438,0.026796060254924682,-4.350955702117148
ZCTA5 55385,547,0,547,0,-4.3511905244913764
ZCTA5 61283,547,0,547,0,-4.3511905244913764
ZCTA5 69154,547,0,547,0,-4.3511905244913764
ZCTA5 11713,3208,63,3145,0.01963840399002494,-4.3516884027789215
ZCTA5 77551,8425,210,8215,0.024925816023738872,-4.353287609254032
ZCTA5 30534,10397,268,10129,0.025776666346061364,-4.3535314858739484
ZCTA5 40360,2481,44,2437,0.0177347843611447,-4.354259321369775
ZCTA5 14561,1108,11,1097,0.009927797833935019,-4.355012994429481
ZCTA5 32140,548,0,548,0,-4.3551660305965765
ZCTA5 48745,548,0,548,0,-4.3551660305965765
ZCTA5 58060,548,0,548,0,-4.3551660305965765
ZCTA5 87535,548,0,548,0,-4.3551660305965765
ZCTA5 08310,548,0,548,0,-4.3551660305965765
ZCTA5 19954,548,0,548,0,-4.3551660305965765
ZCTA5 20684,548,0,548,0,-4.3551660305965765
ZCTA5 23415,548,0,548,0,-4.3551660305965765
ZCTA5 37060,870,6,864,0.006896551724137931,-4.356254013158249
ZCTA5 66508,1924,30,1894,0.015592515592515593,-4.3570173844265385
ZCTA5 48860,607,1,606,0.0016474464579901153,-4.357902509117014
ZCTA5 26807,1245,14,1231,0.011244979919678716,-4.357948521170545
ZCTA5 23669,15699,427,15272,0.027199184661443405,-4.358438754073691
ZCTA5 24465,717,3,714,0.0041841004184100415,-4.358606451480927
ZCTA5 49887,1109,11,1098,0.009918845807033363,-4.358635679112514
ZCTA5 72554,1109,11,1098,0.009918845807033363,-4.358635679112514
ZCTA5 52223,549,0,549,0,-4.35913791106695
ZCTA5 75451,549,0,549,0,-4.35913791106695
ZCTA5 06481,549,0,549,0,-4.35913791106695
ZCTA5 10964,549,0,549,0,-4.35913791106695
ZCTA5 14477,549,0,549,0,-4.35913791106695
ZCTA5 18211,549,0,549,0,-4.35913791106695
ZCTA5 66935,1110,11,1099,0.00990990990990991,-4.362255984232521
ZCTA5 68466,718,3,715,0.004178272980501393,-4.362513233370166
ZCTA5 28682,550,0,550,0,-4.363106175804107
ZCTA5 36776,550,0,550,0,-4.363106175804107
ZCTA5 44418,550,0,550,0,-4.363106175804107
ZCTA5 49726,550,0,550,0,-4.363106175804107
ZCTA5 59932,550,0,550,0,-4.363106175804107
ZCTA5 13778,2288,39,2249,0.017045454545454544,-4.364835104387395
ZCTA5 36528,551,0,551,0,-4.367070834664665
ZCTA5 52352,551,0,551,0,-4.367070834664665
ZCTA5 61602,551,0,551,0,-4.367070834664665
ZCTA5 04666,551,0,551,0,-4.367070834664665
ZCTA5 17774,551,0,551,0,-4.367070834664665
ZCTA5 36009,922,7,915,0.007592190889370932,-4.367085521968316
ZCTA5 39601,8296,206,8090,0.024831243972999035,-4.367733944550661
ZCTA5 40464,552,0,552,0,-4.371031897460545
ZCTA5 43066,552,0,552,0,-4.371031897460545
ZCTA5 48889,552,0,552,0,-4.371031897460545
ZCTA5 02462,552,0,552,0,-4.371031897460545
ZCTA5 12515,552,0,552,0,-4.371031897460545
ZCTA5 98638,552,0,552,0,-4.371031897460545
ZCTA5 38066,1113,11,1102,0.009883198562443846,-4.373102664382723
ZCTA5 74450,667,2,665,0.0029985007496251873,-4.37416683231011
ZCTA5 97828,1426,18,1408,0.012622720897615708,-4.37465739225821
ZCTA5 32792,20657,578,20079,0.02798082974294428,-4.374772926030443
ZCTA5 30619,553,0,553,0,-4.374989373959249
ZCTA5 12910,553,0,553,0,-4.374989373959249
ZCTA5 18041,1930,30,1900,0.015544041450777202,-4.3756485150731255
ZCTA5 53968,973,8,965,0.008221993833504625,-4.376990876618347
ZCTA5 48813,8061,199,7862,0.02468676342885498,-4.377565823471641
ZCTA5 52041,668,2,666,0.0029940119760479044,-4.378089767155492
ZCTA5 61813,668,2,666,0.0029940119760479044,-4.378089767155492
ZCTA5 12883,2093,34,2059,0.016244624940277116,-4.378437489323868
ZCTA5 76305,1849,28,1821,0.015143320713899405,-4.378667552766621
ZCTA5 13807,554,0,554,0,-4.378943273884138
ZCTA5 23084,554,0,554,0,-4.378943273884138
ZCTA5 27973,554,0,554,0,-4.378943273884138
ZCTA5 42721,1340,16,1324,0.011940298507462687,-4.379612821009337
ZCTA5 41064,775,4,771,0.005161290322580645,-4.380184148827322
ZCTA5 21919,1115,11,1104,0.009865470852017937,-4.380321963771233
ZCTA5 64720,1471,19,1452,0.01291638341264446,-4.380511232799584
ZCTA5 74344,6677,159,6518,0.023813089710948032,-4.381099427677456
ZCTA5 28792,14559,392,14167,0.026924926162511163,-4.38124042494473
ZCTA5 29137,723,3,720,0.004149377593360996,-4.381997456365964
ZCTA5 14541,926,7,919,0.00755939524838013,-4.382098235231038
ZCTA5 70062,6152,144,6008,0.02340702210663199,-4.382455710600351
ZCTA5 45169,1809,27,1782,0.014925373134328358,-4.382596733697605
ZCTA5 78609,877,6,871,0.0068415051311288486,-4.382809596275718
ZCTA5 30177,555,0,555,0,-4.382893606914721
ZCTA5 12985,555,0,555,0,-4.382893606914721
ZCTA5 19503,555,0,555,0,-4.382893606914721
ZCTA5 61360,1341,16,1325,0.011931394481730051,-4.383059976248613
ZCTA5 58639,827,5,822,0.006045949214026602,-4.3832677837593454
ZCTA5 38555,8133,201,7932,0.02471412762818148,-4.383348638404798
ZCTA5 81082,5410,123,5287,0.022735674676524955,-4.384285405285083
ZCTA5 12547,1023,9,1014,0.008797653958944282,-4.385651042027561
ZCTA5 95634,1386,17,1369,0.012265512265512266,-4.3868202001810435
ZCTA5 52216,556,0,556,0,-4.386840382686922
ZCTA5 62668,556,0,556,0,-4.386840382686922
ZCTA5 22938,556,0,556,0,-4.386840382686922
ZCTA5 23315,556,0,556,0,-4.386840382686922
ZCTA5 56256,1163,12,1151,0.010318142734307825,-4.387764212335049
ZCTA5 16342,777,4,773,0.005148005148005148,-4.387891758698799
ZCTA5 03258,976,8,968,0.00819672131147541,-4.388124086004613
ZCTA5 55710,615,1,614,0.0016260162601626016,-4.389481622458394
ZCTA5 46986,671,2,669,0.0029806259314456036,-4.389838103131955
ZCTA5 73150,1687,24,1663,0.014226437462951986,-4.391880889046081
ZCTA5 13343,726,3,723,0.004132231404958678,-4.393648532840517
ZCTA5 78620,5805,134,5671,0.023083548664944015,-4.394124516636589
ZCTA5 36075,880,6,874,0.006818181818181818,-4.394147092681824
ZCTA5 36258,558,0,558,0,-4.394723300783604
ZCTA5 41645,558,0,558,0,-4.394723300783604
ZCTA5 13315,558,0,558,0,-4.394723300783604
ZCTA5 14571,558,0,558,0,-4.394723300783604
ZCTA5 30401,5022,112,4910,0.022301871764237355,-4.395102080425662
ZCTA5 16749,1646,23,1623,0.013973268529769137,-4.395303627751602
ZCTA5 60026,5344,121,5223,0.022642215568862277,-4.39545426970668
ZCTA5 36323,2921,55,2866,0.018829168093118794,-4.395691586082536
ZCTA5 41649,1026,9,1017,0.008771929824561403,-4.39665914532947
ZCTA5 57017,617,1,616,0.0016207455429497568,-4.397341271498334
ZCTA5 08349,727,3,724,0.0041265474552957355,-4.397525696934663
ZCTA5 04849,1647,23,1624,0.013964784456587736,-4.398553331965275
ZCTA5 32350,559,0,559,0,-4.398659462164483
ZCTA5 57438,559,0,559,0,-4.398659462164483
ZCTA5 23960,559,0,559,0,-4.398659462164483
ZCTA5 01054,780,4,776,0.005128205128205128,-4.399429650645823
ZCTA5 49437,2769,51,2718,0.018418201516793065,-4.400057215802565
ZCTA5 54486,931,7,924,0.007518796992481203,-4.400801855152325
ZCTA5 02646,931,7,924,0.007518796992481203,-4.400801855152325
ZCTA5 30113,2419,42,2377,0.017362546506821,-4.401321421914442
ZCTA5 76374,1648,23,1625,0.013956310679611651,-4.401801468929781
ZCTA5 52659,560,0,560,0,-4.402592104400308
ZCTA5 72675,560,0,560,0,-4.402592104400308
ZCTA5 03462,560,0,560,0,-4.402592104400308
ZCTA5 79912,28539,821,27718,0.028767651284207576,-4.402914298241652
ZCTA5 33576,2061,33,2028,0.01601164483260553,-4.4036569259110525
ZCTA5 43533,675,2,673,0.002962962962962963,-4.40545511496152
ZCTA5 47840,675,2,673,0.002962962962962963,-4.40545511496152
ZCTA5 59014,675,2,673,0.002962962962962963,-4.40545511496152
ZCTA5 06783,883,6,877,0.006795016987542469,-4.405458749614735
ZCTA5 10580,6058,141,5917,0.023275008253549025,-4.405986708083903
ZCTA5 04253,833,5,828,0.006002400960384154,-4.406129321761228
ZCTA5 38582,561,0,561,0,-4.406521236913165
ZCTA5 61535,561,0,561,0,-4.406521236913165
ZCTA5 12481,561,0,561,0,-4.406521236913165
ZCTA5 24326,561,0,561,0,-4.406521236913165
ZCTA5 50237,1259,14,1245,0.011119936457505957,-4.407056399632688
ZCTA5 73737,1392,17,1375,0.01221264367816092,-4.407274567228735
ZCTA5 43001,1029,9,1020,0.008746355685131196,-4.407644491893681
ZCTA5 40108,4487,97,4390,0.021618007577445954,-4.409151380095338
ZCTA5 91030,9992,255,9737,0.025520416333066454,-4.410343498478395
ZCTA5 50233,562,0,562,0,-4.410446869083169
ZCTA5 71266,562,0,562,0,-4.410446869083169
ZCTA5 04556,562,0,562,0,-4.410446869083169
ZCTA5 21237,11244,292,10952,0.025969405905371754,-4.4137353265771315
ZCTA5 58267,563,0,563,0,-4.414369010248729
ZCTA5 80809,563,0,563,0,-4.414369010248729
ZCTA5 82214,563,0,563,0,-4.414369010248729
ZCTA5 04622,563,0,563,0,-4.414369010248729
ZCTA5 15823,563,0,563,0,-4.414369010248729
ZCTA5 26547,1078,10,1068,0.00927643784786642,-4.414581257299625
ZCTA5 53048,1438,18,1420,0.012517385257301807,-4.4152390716392995
ZCTA5 27027,1861,28,1833,0.015045674368619023,-4.416279024441905
ZCTA5 46402,2659,48,2611,0.01805189921022941,-4.416816005585138
ZCTA5 25901,4744,104,4640,0.021922428330522766,-4.417060835640507
ZCTA5 50626,678,2,676,0.0029498525073746312,-4.417132596856206
ZCTA5 55775,678,2,676,0.0029498525073746312,-4.417132596856206
ZCTA5 55072,1262,14,1248,0.011093502377179081,-4.4175261808265764
ZCTA5 24088,1568,21,1547,0.013392857142857142,-4.417710425562513
ZCTA5 95536,1079,10,1069,0.009267840593141797,-4.41819884663141
ZCTA5 43067,564,0,564,0,-4.418287669706799
ZCTA5 63940,564,0,564,0,-4.418287669706799
ZCTA5 75839,2066,33,2033,0.015972894482090997,-4.4187903296635564
ZCTA5 49622,1126,11,1115,0.009769094138543518,-4.4198606556873425
ZCTA5 17321,887,6,881,0.006764374295377677,-4.420501048572497
ZCTA5 13063,733,3,730,0.004092769440654843,-4.420720690344578
ZCTA5 35594,2738,50,2688,0.018261504747991233,-4.420955122930393
ZCTA5 75076,3159,61,3098,0.019309908198797087,-4.421001710588092
ZCTA5 40204,7151,172,6979,0.024052580058733043,-4.42131550187328
ZCTA5 31072,565,0,565,0,-4.422202856713149
ZCTA5 76933,565,0,565,0,-4.422202856713149
ZCTA5 24350,565,0,565,0,-4.422202856713149
ZCTA5 18458,1127,11,1116,0.009760425909494233,-4.423441144843847
ZCTA5 72132,1353,16,1337,0.011825572801182557,-4.424273756422156
ZCTA5 68430,624,1,623,0.0016025641025641025,-4.424741030950439
ZCTA5 66549,680,2,678,0.0029411764705882353,-4.424900913254179
ZCTA5 29666,2662,48,2614,0.018031555221637866,-4.425144108172876
ZCTA5 45745,566,0,566,0,-4.426114580482608
ZCTA5 73645,566,0,566,0,-4.426114580482608
ZCTA5 03856,566,0,566,0,-4.426114580482608
ZCTA5 21545,787,4,783,0.005082592121982211,-4.42624264157438
ZCTA5 54228,1128,11,1117,0.00975177304964539,-4.427019328681475
ZCTA5 54968,1265,14,1251,0.011067193675889328,-4.427977336432556
ZCTA5 24572,6456,152,6304,0.023543990086741014,-4.428227498143462
ZCTA5 22060,2702,49,2653,0.018134715025906734,-4.428446309834103
ZCTA5 57369,987,8,979,0.008105369807497468,-4.4287431263240284
ZCTA5 76207,5431,123,5308,0.022647762842938686,-4.428815254140844
ZCTA5 12486,567,0,567,0,-4.4300228501893235
ZCTA5 07040,7987,196,7791,0.024539877300613498,-4.430428635040198
ZCTA5 11934,2547,45,2502,0.0176678445229682,-4.430582782576069
ZCTA5 97496,3087,59,3028,0.019112406867508907,-4.431353645081263
ZCTA5 53517,736,3,733,0.004076086956521739,-4.432274829743875
ZCTA5 51455,988,8,980,0.008097165991902834,-4.432420123488693
ZCTA5 14591,626,1,625,0.001597444089456869,-4.432538685200775
ZCTA5 36867,9394,237,9157,0.025228869491164572,-4.433476274012489
ZCTA5 49336,1530,20,1510,0.013071895424836602,-4.433668325838394
ZCTA5 40109,789,4,785,0.005069708491761723,-4.433875788003517
ZCTA5 04971,789,4,785,0.005069708491761723,-4.433875788003517
ZCTA5 29635,568,0,568,0,-4.433927674967007
ZCTA5 37328,568,0,568,0,-4.433927674967007
ZCTA5 04414,568,0,568,0,-4.433927674967007
ZCTA5 20861,568,0,568,0,-4.433927674967007
ZCTA5 01832,8849,221,8628,0.024974573398124082,-4.435979199498724
ZCTA5 66218,2666,48,2618,0.01800450112528132,-4.436235841145319
ZCTA5 27305,683,2,681,0.0029282576866764276,-4.436528547832489
ZCTA5 46746,1659,23,1636,0.013863773357444244,-4.437428093422314
ZCTA5 61752,1659,23,1636,0.013863773357444244,-4.437428093422314
ZCTA5 28538,790,4,786,0.005063291139240506,-4.437687778591219
ZCTA5 01011,569,0,569,0,-4.437829063909192
ZCTA5 73115,8439,209,8230,0.024765967531698067,-4.438564551059363
ZCTA5 60472,1617,22,1595,0.013605442176870748,-4.4386670569147615
ZCTA5 50514,684,2,682,0.0029239766081871343,-4.440397835166824
ZCTA5 47243,2033,32,2001,0.01574028529267093,-4.441683365816935
ZCTA5 31042,570,0,570,0,-4.4417270260694695
ZCTA5 49029,570,0,570,0,-4.4417270260694695
ZCTA5 16738,570,0,570,0,-4.4417270260694695
ZCTA5 49266,1269,14,1255,0.01103230890464933,-4.441883389732204
ZCTA5 64776,1703,24,1679,0.014092777451556078,-4.443332788863073
ZCTA5 40150,1533,20,1513,0.01304631441617743,-4.443582888428471
ZCTA5 04342,739,3,736,0.0040595399188092015,-4.443800341739392
ZCTA5 72010,2630,47,2583,0.017870722433460075,-4.444334895348719
ZCTA5 29714,1133,11,1122,0.009708737864077669,-4.44487580831575
ZCTA5 18434,1619,22,1597,0.013588634959851761,-4.445172028459755
ZCTA5 65680,571,0,571,0,-4.445621570461743
ZCTA5 68065,571,0,571,0,-4.445621570461743
ZCTA5 78672,571,0,571,0,-4.445621570461743
ZCTA5 29360,8203,202,8001,0.02462513714494697,-4.446993956392245
ZCTA5 00664,5118,114,5004,0.022274325908558032,-4.447870330388756
ZCTA5 42456,630,1,629,0.0015873015873015873,-4.448093324279322
ZCTA5 56474,1830,27,1803,0.014754098360655738,-4.448707021217915
ZCTA5 42079,572,0,572,0,-4.4495127060604664
ZCTA5 77577,572,0,572,0,-4.4495127060604664
ZCTA5 21521,572,0,572,0,-4.4495127060604664
ZCTA5 89008,572,0,572,0,-4.4495127060604664
ZCTA5 07717,895,6,889,0.0067039106145251395,-4.450450251949884
ZCTA5 50536,1831,27,1804,0.01474604041507373,-4.45183983249588
ZCTA5 80135,1449,18,1431,0.012422360248447204,-4.4522098196720314
ZCTA5 48861,573,0,573,0,-4.453400441800887
ZCTA5 73860,573,0,573,0,-4.453400441800887
ZCTA5 78055,573,0,573,0,-4.453400441800887
ZCTA5 45218,1579,21,1558,0.013299556681443952,-4.4537967340099724
ZCTA5 05458,896,6,890,0.006696428571428571,-4.454181324620862
ZCTA5 13060,1089,10,1079,0.009182736455463728,-4.454243294324017
ZCTA5 31795,742,3,739,0.004043126684636119,-4.455297431395872
ZCTA5 68317,688,2,686,0.0029069767441860465,-4.455842248931647
ZCTA5 44707,3736,76,3660,0.020342612419700215,-4.456803596837538
ZCTA5 72360,2399,41,2358,0.01709045435598166,-4.4572018419345945
ZCTA5 28902,574,0,574,0,-4.457284786579284
ZCTA5 77663,574,0,574,0,-4.457284786579284
ZCTA5 33931,5623,128,5495,0.02276364929752801,-4.458094513778839
ZCTA5 22656,1183,12,1171,0.01014370245139476,-4.458697230635976
ZCTA5 43945,1229,13,1216,0.010577705451586655,-4.459944992196332
ZCTA5 58425,575,0,575,0,-4.461165749253208
ZCTA5 36108,7520,182,7338,0.02420212765957447,-4.46183395234487
ZCTA5 44253,1044,9,1035,0.008620689655172414,-4.462234332473969
ZCTA5 94954,13754,366,13388,0.026610440599098444,-4.463499825458209
ZCTA5 44404,576,0,576,0,-4.465043338641713
ZCTA5 42049,576,0,576,0,-4.465043338641713
ZCTA5 47948,576,0,576,0,-4.465043338641713
ZCTA5 55909,576,0,576,0,-4.465043338641713
ZCTA5 83250,576,0,576,0,-4.465043338641713
ZCTA5 26812,576,0,576,0,-4.465043338641713
ZCTA5 48041,1752,25,1727,0.014269406392694063,-4.465688713581042
ZCTA5 13642,3777,77,3700,0.020386550172094255,-4.46617532778641
ZCTA5 50047,2283,38,2245,0.016644765659220323,-4.4665322819191715
ZCTA5 55806,4257,90,4167,0.021141649048625793,-4.467501981580514
ZCTA5 45693,3404,67,3337,0.019682726204465335,-4.468275056324964
ZCTA5 75840,2403,41,2362,0.01706200582605077,-4.468671499940166
ZCTA5 72342,1753,25,1728,0.01426126640045636,-4.46885828689988
ZCTA5 87025,577,0,577,0,-4.468917563525594
ZCTA5 24526,577,0,577,0,-4.468917563525594
ZCTA5 27212,577,0,577,0,-4.468917563525594
ZCTA5 49259,900,6,894,0.006666666666666667,-4.4690779177386375
ZCTA5 54984,1367,16,1351,0.011704462326261888,-4.4720063675091115
ZCTA5 70002,8733,217,8516,0.0248482766517806,-4.472443279099214
ZCTA5 39140,999,8,991,0.008008008008008008,-4.472697567854387
ZCTA5 28531,578,0,578,0,-4.472788432647618
ZCTA5 42207,578,0,578,0,-4.472788432647618
ZCTA5 46156,578,0,578,0,-4.472788432647618
ZCTA5 46216,1278,14,1264,0.010954616588419406,-4.473052586070794
ZCTA5 54124,1542,20,1522,0.01297016861219196,-4.47323601776375
ZCTA5 39576,2365,40,2325,0.016913319238900635,-4.473409405439155
ZCTA5 28436,747,3,744,0.004016064257028112,-4.474396636171843
ZCTA5 91737,7977,195,7782,0.024445280180518992,-4.474639417516518
ZCTA5 56332,637,1,636,0.0015698587127158557,-4.475184911874783
ZCTA5 29482,800,4,796,0.005,-4.475641310886287
ZCTA5 98446,3632,73,3559,0.020099118942731278,-4.475939424539588
ZCTA5 29471,579,0,579,0,-4.476655954712751
ZCTA5 65072,579,0,579,0,-4.476655954712751
ZCTA5 04088,579,0,579,0,-4.476655954712751
ZCTA5 98547,579,0,579,0,-4.476655954712751
ZCTA5 49079,5239,117,5122,0.022332506203473945,-4.476722840631351
ZCTA5 13754,1324,15,1309,0.011329305135951661,-4.477022986576257
ZCTA5 81005,12595,331,12264,0.02628026994839222,-4.477363542602471
ZCTA5 56465,852,5,847,0.005868544600938967,-4.477824088679745
ZCTA5 16351,694,2,692,0.002881844380403458,-4.478911552278071
ZCTA5 40806,1049,9,1040,0.008579599618684462,-4.48030794532239
ZCTA5 30669,1325,15,1310,0.011320754716981131,-4.480444232315467
ZCTA5 29545,580,0,580,0,-4.480520138388392
ZCTA5 30218,580,0,580,0,-4.480520138388392
ZCTA5 46798,580,0,580,0,-4.480520138388392
ZCTA5 47564,580,0,580,0,-4.480520138388392
ZCTA5 52654,580,0,580,0,-4.480520138388392
ZCTA5 65761,580,0,580,0,-4.480520138388392
ZCTA5 67119,580,0,580,0,-4.480520138388392
ZCTA5 15673,580,0,580,0,-4.480520138388392
ZCTA5 54021,2565,45,2520,0.017543859649122806,-4.481131093710544
ZCTA5 05855,3068,58,3010,0.018904823989569754,-4.481636885221886
ZCTA5 67058,749,3,746,0.004005340453938585,-4.4820145767539135
ZCTA5 54159,581,0,581,0,-4.484380992304594
ZCTA5 68463,581,0,581,0,-4.484380992304594
ZCTA5 48625,5386,121,5265,0.02246565168956554,-4.484753672479231
ZCTA5 66414,1191,12,1179,0.010075566750629723,-4.48682429557314
ZCTA5 97366,803,4,799,0.0049813200498132005,-4.486969006639055
ZCTA5 54028,955,7,948,0.007329842931937173,-4.4896373732391774
ZCTA5 27283,1283,14,1269,0.010911925175370226,-4.4902980249373075
ZCTA5 55118,11832,308,11524,0.026031102096010818,-4.490351140270382
ZCTA5 85119,10177,259,9918,0.025449543087353838,-4.490745407978591
ZCTA5 65787,583,0,583,0,-4.492092745193529
ZCTA5 29563,956,7,949,0.007322175732217573,-4.493305698077525
ZCTA5 14757,1284,14,1270,0.010903426791277258,-4.4937410929512565
ZCTA5 60146,1005,8,997,0.007960199004975124,-4.4945375931500955
ZCTA5 64482,1005,8,997,0.007960199004975124,-4.4945375931500955
ZCTA5 54738,1239,13,1226,0.010492332526230832,-4.4947644775515805
ZCTA5 14809,907,6,901,0.006615214994487321,-4.495041204249832
ZCTA5 27320,15801,427,15374,0.027023606100879692,-4.495312117386522
ZCTA5 31811,2132,34,2098,0.01594746716697936,-4.495345497970353
ZCTA5 36024,2011,31,1980,0.015415216310293387,-4.4986523901457325
ZCTA5 47448,3151,60,3091,0.01904157410345922,-4.499165304357186
ZCTA5 29510,4013,83,3930,0.020682780961873908,-4.4992337828907685
ZCTA5 03109,4050,84,3966,0.02074074074074074,-4.499415296208525
ZCTA5 67579,1195,12,1183,0.0100418410041841,-4.50083601694144
ZCTA5 52218,700,2,698,0.002857142857142857,-4.501865600770384
ZCTA5 15034,909,6,903,0.006600660066006601,-4.502434786319261
ZCTA5 12832,2768,50,2718,0.018063583815028903,-4.503017041653567
ZCTA5 38372,6740,159,6581,0.023590504451038576,-4.503341972089091
ZCTA5 48738,586,0,586,0,-4.503635614960066
ZCTA5 67108,586,0,586,0,-4.503635614960066
ZCTA5 01351,959,7,952,0.0072992700729927005,-4.504295053095022
ZCTA5 35952,2691,48,2643,0.017837235228539576,-4.505240703827509
ZCTA5 48092,10390,265,10125,0.02550529355149182,-4.505894335344347
ZCTA5 45862,587,0,587,0,-4.507476669487656
ZCTA5 24938,587,0,587,0,-4.507476669487656
ZCTA5 71292,7684,186,7498,0.024206142634044768,-4.508267300509154
ZCTA5 56069,1766,25,1741,0.014156285390713477,-4.509931939923534
ZCTA5 54891,1510,19,1491,0.012582781456953643,-4.510291540158167
ZCTA5 48062,3383,66,3317,0.01950931126219332,-4.510562829511012
ZCTA5 28683,588,0,588,0,-4.511314453639242
ZCTA5 40111,588,0,588,0,-4.511314453639242
ZCTA5 41265,588,0,588,0,-4.511314453639242
ZCTA5 12516,588,0,588,0,-4.511314453639242
ZCTA5 97361,4203,88,4115,0.02093742564834642,-4.512705347331409
ZCTA5 08810,2888,53,2835,0.018351800554016622,-4.513454967884684
ZCTA5 88316,862,5,857,0.00580046403712297,-4.515141520076916
ZCTA5 63559,589,0,589,0,-4.515148975754082
ZCTA5 04020,589,0,589,0,-4.515148975754082
ZCTA5 06778,589,0,589,0,-4.515148975754082
ZCTA5 56110,704,2,702,0.002840909090909091,-4.5171051000797275
ZCTA5 89835,648,1,647,0.0015432098765432098,-4.517431765811767
ZCTA5 46160,2578,45,2533,0.017455391776570985,-4.517452305360185
ZCTA5 78023,8931,222,8709,0.024857238831037957,-4.518150052128153
ZCTA5 72519,1200,12,1188,0.01,-4.51830254962227
ZCTA5 93723,3836,78,3758,0.020333680917622523,-4.519132732681436
ZCTA5 35079,3197,61,3136,0.019080387863622147,-4.519682432305683
ZCTA5 60465,6714,158,6556,0.023532916294310396,-4.520889007592244
ZCTA5 79415,6257,145,6112,0.023174045069522135,-4.522181297659703
ZCTA5 95682,11010,283,10727,0.025703905540417803,-4.522491667136274
ZCTA5 37330,2930,54,2876,0.018430034129692834,-4.522605990937627
ZCTA5 43356,591,0,591,0,-4.522808267053859
ZCTA5 47166,591,0,591,0,-4.522808267053859
ZCTA5 61412,591,0,591,0,-4.522808267053859
ZCTA5 15321,591,0,591,0,-4.522808267053859
ZCTA5 95426,591,0,591,0,-4.522808267053859
ZCTA5 72634,1729,24,1705,0.013880855986119144,-4.52612733674075
ZCTA5 52347,592,0,592,0,-4.5266330527412455
ZCTA5 55310,592,0,592,0,-4.5266330527412455
ZCTA5 61235,592,0,592,0,-4.5266330527412455
ZCTA5 13796,592,0,592,0,-4.5266330527412455
ZCTA5 39556,3276,63,3213,0.019230769230769232,-4.527317618655925
ZCTA5 73095,761,3,758,0.003942181340341655,-4.52746517814843
ZCTA5 34429,3765,76,3689,0.020185922974767595,-4.527534656852997
ZCTA5 03588,707,2,705,0.002828854314002829,-4.52850189242044
ZCTA5 02452,4939,108,4831,0.021866774650739017,-4.528678176454568
ZCTA5 73061,651,1,650,0.0015360983102918587,-4.528885773134039
ZCTA5 19348,8525,210,8315,0.02463343108504399,-4.529176190521262
ZCTA5 44275,1249,13,1236,0.010408326661329063,-4.529376965695285
ZCTA5 62983,593,0,593,0,-4.5304546093972
ZCTA5 24250,593,0,593,0,-4.5304546093972
ZCTA5 85641,8904,221,8683,0.024820305480682838,-4.530696219097222
ZCTA5 35650,5265,117,5148,0.022222222222222223,-4.532319098266923
ZCTA5 97002,2185,35,2150,0.016018306636155607,-4.532463354296423
ZCTA5 66053,2779,50,2729,0.017992083483267363,-4.532916806764687
ZCTA5 18930,1158,11,1147,0.009499136442141624,-4.533312409869405
ZCTA5 78861,3842,78,3764,0.02030192608016658,-4.533611511901232
ZCTA5 78940,867,5,862,0.0057670126874279125,-4.533695093632208
ZCTA5 12067,594,0,594,0,-4.534272945186156
ZCTA5 03819,1604,21,1583,0.013092269326683292,-4.535084007729165
ZCTA5 48723,4942,108,4834,0.021853500607041682,-4.5352427581180335
ZCTA5 29059,2186,35,2151,0.016010978956999086,-4.5354056744727105
ZCTA5 21703,13237,349,12888,0.02636549067009141,-4.535530835118513
ZCTA5 47990,709,2,707,0.0028208744710860366,-4.53608423255112
ZCTA5 45882,1112,10,1102,0.008992805755395683,-4.536256717435201
ZCTA5 65074,1065,9,1056,0.008450704225352112,-4.537739292054798
ZCTA5 44443,595,0,595,0,-4.538088068238201
ZCTA5 44010,595,0,595,0,-4.538088068238201
ZCTA5 60913,595,0,595,0,-4.538088068238201
ZCTA5 66860,595,0,595,0,-4.538088068238201
ZCTA5 76837,595,0,595,0,-4.538088068238201
ZCTA5 37180,1297,14,1283,0.01079414032382421,-4.538320161097115
ZCTA5 28618,1113,10,1103,0.008984725965858042,-4.539794974420183
ZCTA5 49241,969,7,962,0.007223942208462332,-4.540758575333819
ZCTA5 61341,3129,59,3070,0.018855864493448386,-4.541201134225185
ZCTA5 59846,596,0,596,0,-4.54189998664928
ZCTA5 71670,596,0,596,0,-4.54189998664928
ZCTA5 15142,596,0,596,0,-4.54189998664928
ZCTA5 34449,1388,16,1372,0.011527377521613832,-4.542914448860995
ZCTA5 48741,818,4,814,0.004889975550122249,-4.5432118291981185
ZCTA5 29126,870,5,865,0.005747126436781609,-4.54479402107486
ZCTA5 13110,870,5,865,0.005747126436781609,-4.54479402107486
ZCTA5 04355,1019,8,1011,0.007850834151128557,-4.5451491404555595
ZCTA5 77339,15474,416,15058,0.02688380509241308,-4.545264686988221
ZCTA5 40144,597,0,597,0,-4.5457087084813885
ZCTA5 56152,597,0,597,0,-4.5457087084813885
ZCTA5 12117,1389,16,1373,0.011519078473722102,-4.546270706588129
ZCTA5 76424,3016,56,2960,0.01856763925729443,-4.546473138039366
ZCTA5 62271,921,6,915,0.006514657980456026,-4.546570882796472
ZCTA5 98223,15807,426,15381,0.026950085405200226,-4.547569589733099
ZCTA5 17062,1565,20,1545,0.012779552715654952,-4.548408516131321
ZCTA5 49713,871,5,866,0.0057405281285878304,-4.5484881625949285
ZCTA5 65722,598,0,598,0,-4.549514241762776
ZCTA5 70725,598,0,598,0,-4.549514241762776
ZCTA5 28763,1255,13,1242,0.010358565737051793,-4.550046465651107
ZCTA5 50247,922,6,916,0.006507592190889371,-4.550231626918067
ZCTA5 65275,1116,10,1106,0.008960573476702509,-4.550396190240294
ZCTA5 18470,820,4,816,0.004878048780487805,-4.550661784234599
ZCTA5 84642,1163,11,1152,0.009458297506448839,-4.550833918980345
ZCTA5 31650,1210,12,1198,0.009917355371900827,-4.553076879813853
ZCTA5 52554,599,0,599,0,-4.553316594488146
ZCTA5 15533,599,0,599,0,-4.553316594488146
ZCTA5 51546,1117,10,1107,0.008952551477170993,-4.553925423597766
ZCTA5 62411,1610,21,1589,0.013043478260869565,-4.554445372481594
ZCTA5 77002,3739,75,3664,0.020058839261834716,-4.55508927995183
ZCTA5 35023,8333,204,8129,0.024480979239169566,-4.555274779215626
ZCTA5 30630,873,5,868,0.0057273768613974796,-4.555868229019621
ZCTA5 55312,600,0,600,0,-4.557115774618847
ZCTA5 73547,600,0,600,0,-4.557115774618847
ZCTA5 73151,600,0,600,0,-4.557115774618847
ZCTA5 08738,600,0,600,0,-4.557115774618847
ZCTA5 14861,600,0,600,0,-4.557115774618847
ZCTA5 15225,600,0,600,0,-4.557115774618847
ZCTA5 26335,600,0,600,0,-4.557115774618847
ZCTA5 67669,769,3,766,0.0039011703511053317,-4.5575249191439084
ZCTA5 14040,822,4,818,0.004866180048661801,-4.558100350318301
ZCTA5 66092,1348,15,1333,0.01112759643916914,-4.5586023948579
ZCTA5 13825,1303,14,1289,0.010744435917114352,-4.558783015421291
ZCTA5 34436,3591,71,3520,0.019771651350598718,-4.559733046713375
ZCTA5 61234,601,0,601,0,-4.560911790083067
ZCTA5 01266,601,0,601,0,-4.560911790083067
ZCTA5 24176,601,0,601,0,-4.560911790083067
ZCTA5 03256,925,6,919,0.006486486486486486,-4.5611980955121405
ZCTA5 28449,823,4,819,0.004860267314702308,-4.561815378123711
ZCTA5 45302,1438,17,1421,0.011821974965229486,-4.561889624396071
ZCTA5 03785,875,5,870,0.005714285714285714,-4.563237378390124
ZCTA5 81152,602,0,602,0,-4.564704648776034
ZCTA5 83850,926,6,920,0.0064794816414686825,-4.564848348139207
ZCTA5 14779,2713,48,2665,0.017692591227423518,-4.565516823320577
ZCTA5 54004,976,7,969,0.007172131147540984,-4.566131560431861
ZCTA5 65583,4080,84,3996,0.020588235294117647,-4.570221514099118
ZCTA5 16052,1026,8,1018,0.007797270955165692,-4.570275033701038
ZCTA5 43416,1261,13,1248,0.010309278350515464,-4.570643320483269
ZCTA5 31031,2279,37,2242,0.016235190873189996,-4.571352494951568
ZCTA5 00727,19711,544,19167,0.027598802699000557,-4.571697695211696
ZCTA5 23801,1352,15,1337,0.011094674556213017,-4.572092766693164
ZCTA5 46702,928,6,922,0.00646551724137931,-4.572141029691785
ZCTA5 44276,604,0,604,0,-4.57228092726542
ZCTA5 54979,604,0,604,0,-4.57228092726542
ZCTA5 68745,604,0,604,0,-4.57228092726542
ZCTA5 80002,8239,201,8038,0.02439616458308047,-4.572321704158308
ZCTA5 82732,773,3,770,0.0038809831824062097,-4.572483914358616
ZCTA5 35221,1828,26,1802,0.014223194748358862,-4.572506630974027
ZCTA5 14427,826,4,822,0.004842615012106538,-4.572943515043183
ZCTA5 99025,1870,27,1843,0.014438502673796792,-4.572959275282414
ZCTA5 56312,978,7,971,0.007157464212678937,-4.573358353383708
ZCTA5 14420,7022,166,6856,0.023639988607234406,-4.573525995681594
ZCTA5 24315,1216,12,1204,0.009868421052631578,-4.573841044013
ZCTA5 27806,1027,8,1019,0.007789678675754625,-4.573854791709752
ZCTA5 83127,1486,18,1468,0.012113055181695828,-4.575001799115408
ZCTA5 76574,6531,152,6379,0.023273618128923597,-4.57538553945281
ZCTA5 31787,605,0,605,0,-4.57606436268918
ZCTA5 22454,605,0,605,0,-4.57606436268918
ZCTA5 73772,1263,13,1250,0.010292953285827395,-4.577492913764811
ZCTA5 68359,606,0,606,0,-4.579844672596739
ZCTA5 13328,606,0,606,0,-4.579844672596739
ZCTA5 05660,775,3,772,0.003870967741935484,-4.579945881379913
ZCTA5 57103,14203,377,13826,0.026543687953249313,-4.580010996142261
ZCTA5 07720,2120,33,2087,0.015566037735849057,-4.580343001942133
ZCTA5 52625,1029,8,1021,0.007774538386783284,-4.581007111146642
ZCTA5 38112,6499,151,6348,0.02323434374519157,-4.581770169311558
ZCTA5 36505,607,0,607,0,-4.58362186472134
ZCTA5 62084,607,0,607,0,-4.58362186472134
ZCTA5 65053,607,0,607,0,-4.58362186472134
ZCTA5 71277,607,0,607,0,-4.58362186472134
ZCTA5 73062,607,0,607,0,-4.58362186472134
ZCTA5 19967,607,0,607,0,-4.58362186472134
ZCTA5 24348,1705,23,1682,0.013489736070381233,-4.58441648845097
ZCTA5 70043,7587,182,7405,0.0239884012126005,-4.585194070267314
ZCTA5 47633,1126,10,1116,0.008880994671403197,-4.585587916407879
ZCTA5 92011,9451,236,9215,0.02497090254999471,-4.58637171396777
ZCTA5 39743,608,0,608,0,-4.587395946764388
ZCTA5 19372,608,0,608,0,-4.587395946764388
ZCTA5 21531,830,4,826,0.004819277108433735,-4.587741718687943
ZCTA5 37352,1266,13,1253,0.010268562401263823,-4.5877523665314905
ZCTA5 41048,4821,104,4717,0.02157228790707322,-4.587962418889864
ZCTA5 04468,4014,82,3932,0.02042850024912805,-4.589385509220252
ZCTA5 62821,3186,60,3126,0.018832391713747645,-4.589745283280652
ZCTA5 11782,5220,115,5105,0.022030651340996167,-4.5898797848252135
ZCTA5 33327,6609,154,6455,0.023301558480859436,-4.5899947225130004
ZCTA5 43908,609,0,609,0,-4.591166926395633
ZCTA5 95246,609,0,609,0,-4.591166926395633
ZCTA5 15618,1032,8,1024,0.007751937984496124,-4.5917176655606715
ZCTA5 17365,1032,8,1024,0.007751937984496124,-4.5917176655606715
ZCTA5 13207,5329,118,5211,0.022142991180334023,-4.591947587238853
ZCTA5 37361,610,0,610,0,-4.594934811253357
ZCTA5 26206,1359,15,1344,0.011037527593818985,-4.595629165098526
ZCTA5 12033,3074,57,3017,0.018542615484710475,-4.597696616630374
ZCTA5 30173,2085,32,2053,0.015347721822541967,-4.597813448202811
ZCTA5 25962,1493,18,1475,0.012056262558606833,-4.5979682313332315
ZCTA5 69021,611,0,611,0,-4.598699608944547
ZCTA5 29146,670,1,669,0.0014925373134328358,-4.600770638703457
ZCTA5 96143,1450,17,1433,0.011724137931034483,-4.601602513213586
ZCTA5 22572,2410,40,2370,0.016597510373443983,-4.601985336342459
ZCTA5 18445,986,7,979,0.007099391480730223,-4.602166038161035
ZCTA5 37713,612,0,612,0,-4.602461327045077
ZCTA5 48469,612,0,612,0,-4.602461327045077
ZCTA5 47992,612,0,612,0,-4.602461327045077
ZCTA5 50236,612,0,612,0,-4.602461327045077
ZCTA5 51458,612,0,612,0,-4.602461327045077
ZCTA5 53079,612,0,612,0,-4.602461327045077
ZCTA5 56728,612,0,612,0,-4.602461327045077
ZCTA5 01053,612,0,612,0,-4.602461327045077
ZCTA5 28323,1316,14,1302,0.010638297872340425,-4.602880252352249
ZCTA5 19027,8533,209,8324,0.02449314426344779,-4.6033668982526414
ZCTA5 61310,1582,20,1562,0.012642225031605562,-4.603421180488084
ZCTA5 55396,886,5,881,0.0056433408577878106,-4.603574590920254
ZCTA5 08733,937,6,931,0.0064034151547491995,-4.60483003767538
ZCTA5 46165,613,0,613,0,-4.606219973099888
ZCTA5 47862,613,0,613,0,-4.606219973099888
ZCTA5 03845,613,0,613,0,-4.606219973099888
ZCTA5 12463,613,0,613,0,-4.606219973099888
ZCTA5 24460,613,0,613,0,-4.606219973099888
ZCTA5 42141,12279,319,11960,0.025979314276406873,-4.606298435191878
ZCTA5 31907,20036,553,19483,0.027600319425034936,-4.608039341559296
ZCTA5 47598,1272,13,1259,0.010220125786163521,-4.608217805677041
ZCTA5 16002,6052,138,5914,0.02280237937871778,-4.6082758011990705
ZCTA5 03839,1408,16,1392,0.011363636363636364,-4.609695536929998
ZCTA5 06777,614,0,614,0,-4.609975554623162
ZCTA5 15865,614,0,614,0,-4.609975554623162
ZCTA5 16411,614,0,614,0,-4.609975554623162
ZCTA5 47340,1180,11,1169,0.009322033898305085,-4.610004454094073
ZCTA5 54950,1180,11,1169,0.009322033898305085,-4.610004454094073
ZCTA5 29379,7462,178,7284,0.023854194585901902,-4.611736447812629
ZCTA5 53075,1364,15,1349,0.010997067448680353,-4.612385405044383
ZCTA5 71419,784,3,781,0.003826530612244898,-4.613381734363455
ZCTA5 06081,615,0,615,0,-4.613728079098499
ZCTA5 48876,1629,21,1608,0.01289134438305709,-4.615387376277403
ZCTA5 70450,1087,9,1078,0.00827966881324747,-4.6157275107576465
ZCTA5 76087,9640,241,9399,0.025,-4.616116034728693
ZCTA5 50058,785,3,782,0.003821656050955414,-4.61708251452166
ZCTA5 02333,4907,106,4801,0.021601793356429592,-4.617208939649521
ZCTA5 50248,1758,24,1734,0.013651877133105802,-4.617318172764817
ZCTA5 43913,616,0,616,0,-4.617477553979091
ZCTA5 52161,616,0,616,0,-4.617477553979091
ZCTA5 70750,616,0,616,0,-4.617477553979091
ZCTA5 72858,1499,18,1481,0.01200800533689126,-4.6175882763391805
ZCTA5 29530,890,5,885,0.0056179775280898875,-4.618162595024723
ZCTA5 65305,890,5,885,0.0056179775280898875,-4.618162595024723
ZCTA5 89403,6057,138,5919,0.022783556215948488,-4.618325777760342
ZCTA5 55089,731,2,729,0.0027359781121751026,-4.618687794656997
ZCTA5 31027,3426,66,3360,0.01926444833625219,-4.618842273007029
ZCTA5 47163,617,0,617,0,-4.621223986687892
ZCTA5 63637,617,0,617,0,-4.621223986687892
ZCTA5 95962,617,0,617,0,-4.621223986687892
ZCTA5 12603,15431,413,15018,0.026764305618560042,-4.621496707564086
ZCTA5 54020,2851,51,2800,0.017888460189407224,-4.622031485552689
ZCTA5 98294,2734,48,2686,0.01755669348939283,-4.622668623614822
ZCTA5 37308,1137,10,1127,0.008795074758135445,-4.624043544471003
ZCTA5 22923,2176,34,2142,0.015625,-4.6251481851055685
ZCTA5 72121,1413,16,1397,0.01132342533616419,-4.626278918862133
ZCTA5 16929,943,6,937,0.006362672322375398,-4.626507602548362
ZCTA5 22660,788,3,785,0.0038071065989847717,-4.628167843743232
ZCTA5 15958,841,4,837,0.0047562425683709865,-4.62820811081494
ZCTA5 55009,3201,60,3141,0.01874414245548266,-4.628303319517205
ZCTA5 38856,619,0,619,0,-4.628707755131785
ZCTA5 38580,619,0,619,0,-4.628707755131785
ZCTA5 15923,619,0,619,0,-4.628707755131785
ZCTA5 55390,944,6,938,0.006355932203389831,-4.630111671788784
ZCTA5 53950,2014,30,1984,0.014895729890764648,-4.631655048889899
ZCTA5 32667,1720,23,1697,0.013372093023255814,-4.631671122828105
ZCTA5 30541,620,0,620,0,-4.632445105563144
ZCTA5 58027,620,0,620,0,-4.632445105563144
ZCTA5 46616,2097,32,2065,0.015259895088221268,-4.633391623040088
ZCTA5 64057,5958,135,5823,0.022658610271903322,-4.634061076911496
ZCTA5 49272,1044,8,1036,0.007662835249042145,-4.63434702468752
ZCTA5 29726,621,0,621,0,-4.63617944321558
ZCTA5 30817,3319,63,3256,0.01898162097017174,-4.636755376388566
ZCTA5 79501,1093,9,1084,0.008234217749313814,-4.636805241207854
ZCTA5 39428,3509,68,3441,0.01937874038187518,-4.6368061441081
ZCTA5 07876,3660,72,3588,0.019672131147540985,-4.636813842933566
ZCTA5 04282,2302,37,2265,0.016072980017376195,-4.637642808759222
ZCTA5 95631,2582,44,2538,0.017041053446940357,-4.638039248275392
ZCTA5 29316,9893,248,9645,0.02506823006165976,-4.638558187251319
ZCTA5 46737,3320,63,3257,0.01897590361445783,-4.639285848865431
ZCTA5 58730,622,0,622,0,-4.639910775363416
ZCTA5 86436,622,0,622,0,-4.639910775363416
ZCTA5 95462,622,0,622,0,-4.639910775363416
ZCTA5 97022,1373,15,1358,0.010924981791697014,-4.642431332415022
ZCTA5 25649,623,0,623,0,-4.643639109251744
ZCTA5 54945,1551,19,1532,0.012250161186331399,-4.643961894403613
ZCTA5 32460,1463,17,1446,0.01161995898838004,-4.644344128133974
ZCTA5 61540,1047,8,1039,0.007640878701050621,-4.644951733733326
ZCTA5 60480,1977,29,1948,0.014668689934243804,-4.64505236665937
ZCTA5 75640,1767,24,1743,0.013582342954159592,-4.645376888117267
ZCTA5 65767,793,3,790,0.0037831021437578815,-4.646587065757511
ZCTA5 57754,1810,25,1785,0.013812154696132596,-4.64718791726527
ZCTA5 40046,624,0,624,0,-4.6473644520966
ZCTA5 98303,624,0,624,0,-4.6473644520966
ZCTA5 61264,4739,101,4638,0.02131251318843638,-4.648226616092401
ZCTA5 18214,794,3,791,0.003778337531486146,-4.6502625172691046
ZCTA5 12570,2507,42,2465,0.016753091344236137,-4.650363477064758
ZCTA5 40033,5140,112,5028,0.02178988326848249,-4.650566385505222
ZCTA5 02764,1465,17,1448,0.011604095563139932,-4.6508941731737705
ZCTA5 54227,625,0,625,0,-4.651086811085118
ZCTA5 23063,1597,20,1577,0.012523481527864746,-4.65158290343743
ZCTA5 80524,14622,388,14234,0.026535357680207906,-4.652678758877171
ZCTA5 40831,2186,34,2152,0.01555352241537054,-4.65434844998601
ZCTA5 46182,626,0,626,0,-4.654806193375695
ZCTA5 17881,626,0,626,0,-4.654806193375695
ZCTA5 88045,1377,15,1362,0.010893246187363835,-4.6557379066099935
ZCTA5 48726,2309,37,2272,0.01602425292334344,-4.657709646226308
ZCTA5 29152,627,0,627,0,-4.658522606098153
ZCTA5 10526,627,0,627,0,-4.658522606098153
ZCTA5 13040,1002,7,995,0.006986027944111776,-4.65931172086469
ZCTA5 38821,5181,113,5068,0.02181046130090716,-4.660840433756814
ZCTA5 54014,850,4,846,0.004705882352941176,-4.661071774087385
ZCTA5 30103,5900,133,5767,0.02254237288135593,-4.661101861863564
ZCTA5 38367,1195,11,1184,0.009205020920502092,-4.661707547819226
ZCTA5 02763,628,0,628,0,-4.662236056353897
ZCTA5 05473,628,0,628,0,-4.662236056353897
ZCTA5 01521,953,6,947,0.0062959076600209865,-4.66243559490057
ZCTA5 17353,1424,16,1408,0.011235955056179775,-4.6626074891240386
ZCTA5 47126,1644,21,1623,0.012773722627737226,-4.663109886318027
ZCTA5 67855,687,1,686,0.001455604075691412,-4.664156431533661
ZCTA5 55342,798,3,795,0.0037593984962406013,-4.664936552405855
ZCTA5 67473,798,3,795,0.0037593984962406013,-4.664936552405855
ZCTA5 77096,13595,357,13238,0.02625965428466348,-4.665080140621035
ZCTA5 26601,1816,25,1791,0.013766519823788546,-4.665698851410884
ZCTA5 37391,629,0,629,0,-4.665946551216069
ZCTA5 43734,629,0,629,0,-4.665946551216069
ZCTA5 27876,629,0,629,0,-4.665946551216069
ZCTA5 53147,7037,165,6872,0.023447491828904363,-4.668209081562345
ZCTA5 59870,4085,83,4002,0.020318237454100368,-4.668987495869842
ZCTA5 70785,7598,181,7417,0.02382205843643064,-4.669150512159098
ZCTA5 95982,1150,10,1140,0.008695652173913044,-4.669152958517022
ZCTA5 18701,955,6,949,0.0062827225130890054,-4.669591355399656
ZCTA5 69348,630,0,630,0,-4.669654097729716
ZCTA5 17983,630,0,630,0,-4.669654097729716
ZCTA5 48911,16131,433,15698,0.02684272518752712,-4.669768834614397
ZCTA5 52227,1005,7,998,0.006965174129353234,-4.669958001004091
ZCTA5 68823,1005,7,998,0.006965174129353234,-4.669958001004091
ZCTA5 08078,3179,59,3120,0.018559295375904374,-4.670330091073466
ZCTA5 44470,1471,17,1454,0.011556764106050306,-4.670503759903284
ZCTA5 26651,4049,82,3967,0.020251914052852555,-4.671838205837476
ZCTA5 30547,1198,11,1187,0.009181969949916527,-4.671992307240504
ZCTA5 43739,800,3,797,0.00375,-4.672256992766956
ZCTA5 56531,905,5,900,0.0055248618784530384,-4.67249502958034
ZCTA5 85613,905,5,900,0.0055248618784530384,-4.67249502958034
ZCTA5 32949,956,6,950,0.006276150627615063,-4.673165537421119
ZCTA5 50468,631,0,631,0,-4.673358702911935
ZCTA5 77407,15337,409,14928,0.026667536023994264,-4.674044694664175
ZCTA5 53059,746,2,744,0.002680965147453083,-4.674190503956489
ZCTA5 49715,1292,13,1279,0.010061919504643963,-4.675928732121854
ZCTA5 72227,4934,106,4828,0.021483583299554115,-4.676070337829139
ZCTA5 18219,632,0,632,0,-4.6770603737520355
ZCTA5 23438,632,0,632,0,-4.6770603737520355
ZCTA5 24553,632,0,632,0,-4.6770603737520355
ZCTA5 75161,2153,33,2120,0.015327450069670227,-4.677419135411613
ZCTA5 12084,2112,32,2080,0.015151515151515152,-4.677632270227323
ZCTA5 72601,11956,308,11648,0.02576112412177986,-4.677985835381231
ZCTA5 18330,2794,49,2745,0.017537580529706515,-4.67873586615172
ZCTA5 37806,1153,10,1143,0.008673026886383347,-4.679511591347037
ZCTA5 25524,1153,10,1143,0.008673026886383347,-4.679511591347037
ZCTA5 39744,2154,33,2121,0.01532033426183844,-4.680341847004414
ZCTA5 53126,2716,47,2669,0.017304860088365244,-4.6804125257527245
ZCTA5 72847,1008,7,1001,0.006944444444444444,-4.680582936145098
ZCTA5 44695,633,0,633,0,-4.680759117211687
ZCTA5 47234,633,0,633,0,-4.680759117211687
ZCTA5 50070,633,0,633,0,-4.680759117211687
ZCTA5 23937,633,0,633,0,-4.680759117211687
ZCTA5 25520,633,0,633,0,-4.680759117211687
ZCTA5 85742,10296,259,10037,0.025155400155400156,-4.682904347641508
ZCTA5 64127,6232,142,6090,0.022785622593068038,-4.6836603271891075
ZCTA5 66021,959,6,953,0.006256517205422315,-4.683873348035365
ZCTA5 47380,634,0,634,0,-4.684454940225077
ZCTA5 32442,1431,16,1415,0.011180992313067784,-4.68561599036466
ZCTA5 04941,693,1,692,0.001443001443001443,-4.686324626863663
ZCTA5 57451,857,4,853,0.004667444574095682,-4.686482728425313
ZCTA5 72434,857,4,853,0.004667444574095682,-4.686482728425313
ZCTA5 14840,1341,14,1327,0.010439970171513796,-4.686783726714276
ZCTA5 04652,804,3,801,0.0037313432835820895,-4.686864960508624
ZCTA5 57038,635,0,635,0,-4.68814784969906
ZCTA5 12853,635,0,635,0,-4.68814784969906
ZCTA5 15637,635,0,635,0,-4.68814784969906
ZCTA5 21777,635,0,635,0,-4.68814784969906
ZCTA5 75559,2033,30,2003,0.014756517461878997,-4.688357977744156
ZCTA5 39657,750,2,748,0.0026666666666666666,-4.6888827205444175
ZCTA5 53806,750,2,748,0.0026666666666666666,-4.6888827205444175
ZCTA5 62692,858,4,854,0.004662004662004662,-4.690102301084894
ZCTA5 24486,1342,14,1328,0.010432190760059613,-4.690115739489696
ZCTA5 26287,1342,14,1328,0.010432190760059613,-4.690115739489696
ZCTA5 49305,910,5,905,0.005494505494505495,-4.690477228866069
ZCTA5 29856,1060,8,1052,0.007547169811320755,-4.690666306748868
ZCTA5 68370,961,6,955,0.006243496357960458,-4.690999656490542
ZCTA5 08562,1739,23,1716,0.013225991949396205,-4.691064557115424
ZCTA5 19555,1388,15,1373,0.010806916426512969,-4.69218303328101
ZCTA5 45370,962,6,956,0.006237006237006237,-4.694559155330526
ZCTA5 44441,637,0,637,0,-4.6955249555204714
ZCTA5 42082,637,0,637,0,-4.6955249555204714
ZCTA5 50166,637,0,637,0,-4.6955249555204714
ZCTA5 61060,637,0,637,0,-4.6955249555204714
ZCTA5 18826,637,0,637,0,-4.6955249555204714
ZCTA5 24324,637,0,637,0,-4.6955249555204714
ZCTA5 53156,1205,11,1194,0.009128630705394191,-4.69591864962525
ZCTA5 12740,752,2,750,0.0026595744680851063,-4.696211967646086
ZCTA5 15537,3228,60,3168,0.01858736059479554,-4.6973184321265276
ZCTA5 55974,912,5,907,0.005482456140350877,-4.697652368922774
ZCTA5 67756,912,5,907,0.005482456140350877,-4.697652368922774
ZCTA5 67749,1062,8,1054,0.007532956685499058,-4.697665195277611
ZCTA5 76365,1784,24,1760,0.013452914798206279,-4.6980706825649845
ZCTA5 42765,2404,39,2365,0.01622296173044925,-4.698379691199988
ZCTA5 47356,2242,35,2207,0.015611061552185548,-4.698436891450565
ZCTA5 04847,638,0,638,0,-4.699209165546297
ZCTA5 04974,1299,13,1286,0.010007698229407237,-4.699446305965754
ZCTA5 37090,5597,124,5473,0.022154725745935324,-4.701115642415749
ZCTA5 49776,808,3,805,0.0037128712871287127,-4.701429362191516
ZCTA5 53507,808,3,805,0.0037128712871287127,-4.701429362191516
ZCTA5 37214,13822,363,13459,0.02626248010418174,-4.702018526001494
ZCTA5 54724,2998,54,2944,0.01801200800533689,-4.702072242014716
ZCTA5 72002,5992,135,5857,0.02253004005340454,-4.702611070157787
ZCTA5 29015,639,0,639,0,-4.70289048938981
ZCTA5 87415,639,0,639,0,-4.70289048938981
ZCTA5 00985,12344,319,12025,0.02584251458198315,-4.702997530664544
ZCTA5 62264,1481,17,1464,0.011478730587440918,-4.703052346007922
ZCTA5 72204,11499,294,11205,0.025567440647012784,-4.703211307903612
ZCTA5 14716,862,4,858,0.004640371229698376,-4.704554403066957
ZCTA5 38321,914,5,909,0.005470459518599562,-4.704817433019017
ZCTA5 66076,965,6,959,0.0062176165803108805,-4.7052230866993705
ZCTA5 61760,1015,7,1008,0.006896551724137931,-4.705292112612873
ZCTA5 04631,640,0,640,0,-4.7065689338234415
ZCTA5 13607,640,0,640,0,-4.7065689338234415
ZCTA5 60548,4398,91,4307,0.020691223283310595,-4.7070023601813915
ZCTA5 61422,1255,12,1243,0.009561752988047808,-4.707025366685026
ZCTA5 71343,2883,51,2832,0.01768990634755463,-4.7071858359702805
ZCTA5 91354,10277,258,10019,0.02510460251046025,-4.707219307384815
ZCTA5 42404,1065,8,1057,0.007511737089201878,-4.708146650139227
ZCTA5 66733,863,4,859,0.004634994206257242,-4.708160908661984
ZCTA5 50648,1571,19,1552,0.0120942075111394,-4.708183043281055
ZCTA5 07080,7829,187,7642,0.02388555371056329,-4.708353204416908
ZCTA5 48436,1438,16,1422,0.011126564673157162,-4.708540177152843
ZCTA5 54853,1830,25,1805,0.01366120218579235,-4.70870357894679
ZCTA5 83301,21104,583,20521,0.027625094768764215,-4.709243086309128
ZCTA5 45845,1114,9,1105,0.00807899461400359,-4.709948445809253
ZCTA5 61818,641,0,641,0,-4.710244505593178
ZCTA5 76265,641,0,641,0,-4.710244505593178
ZCTA5 06110,4951,106,4845,0.021409816198747728,-4.7129841158316665
ZCTA5 18103,17853,484,17369,0.027110289587184228,-4.713887022891443
ZCTA5 29426,642,0,642,0,-4.713917211418708
ZCTA5 42441,642,0,642,0,-4.713917211418708
ZCTA5 60550,642,0,642,0,-4.713917211418708
ZCTA5 02558,642,0,642,0,-4.713917211418708
ZCTA5 22959,642,0,642,0,-4.713917211418708
ZCTA5 14505,2042,30,2012,0.014691478942213516,-4.71506821786474
ZCTA5 53013,1304,13,1291,0.009969325153374233,-4.716187965483429
ZCTA5 50161,758,2,756,0.002638522427440633,-4.718132868884956
ZCTA5 42088,969,6,963,0.006191950464396285,-4.7194078506177215
ZCTA5 16646,969,6,963,0.006191950464396285,-4.7194078506177215
ZCTA5 98612,1212,11,1201,0.009075907590759076,-4.719745905117263
ZCTA5 51030,644,0,644,0,-4.721254051985248
ZCTA5 61565,644,0,644,0,-4.721254051985248
ZCTA5 68520,644,0,644,0,-4.721254051985248
ZCTA5 04970,644,0,644,0,-4.721254051985248
ZCTA5 14750,2086,31,2055,0.014860977948226271,-4.72254503374688
ZCTA5 16028,814,3,811,0.0036855036855036856,-4.723195101125702
ZCTA5 45159,1352,14,1338,0.010355029585798817,-4.723335598909062
ZCTA5 72959,1118,9,1109,0.008050089445438283,-4.723771556546637
ZCTA5 14489,2653,45,2608,0.016961929890689786,-4.72403939760918
ZCTA5 53216,13133,342,12791,0.02604127008299703,-4.724304751655035
ZCTA5 78263,1620,20,1600,0.012345679012345678,-4.724756972097392
ZCTA5 08802,1443,16,1427,0.011088011088011088,-4.724863429302769
ZCTA5 50621,645,0,645,0,-4.724918200035417
ZCTA5 29030,760,2,758,0.002631578947368421,-4.725417721756033
ZCTA5 15535,868,4,864,0.004608294930875576,-4.72615458735167
ZCTA5 54401,13168,343,12825,0.026047995139732685,-4.7263042011243455
ZCTA5 47579,971,6,965,0.006179196704428424,-4.7264858253471775
ZCTA5 26175,1353,14,1339,0.010347376201034738,-4.726647616871414
ZCTA5 47032,1119,9,1110,0.00804289544235925,-4.7272219690532875
ZCTA5 47940,646,0,646,0,-4.7285795087599745
ZCTA5 59645,646,0,646,0,-4.7285795087599745
ZCTA5 65462,646,0,646,0,-4.7285795087599745
ZCTA5 14011,2655,45,2610,0.01694915254237288,-4.72948100968662
ZCTA5 47841,921,5,916,0.0054288816503800215,-4.729816388624613
ZCTA5 16922,816,3,813,0.003676470588235294,-4.7304289692341515
ZCTA5 60642,9263,228,9035,0.02461405592140775,-4.7315207292072685
ZCTA5 63565,1400,15,1385,0.010714285714285714,-4.731697051668087
ZCTA5 59874,647,0,647,0,-4.732237984749237
ZCTA5 05151,647,0,647,0,-4.732237984749237
ZCTA5 63056,762,2,760,0.0026246719160104987,-4.732691599519079
ZCTA5 16141,706,1,705,0.00141643059490085,-4.73400201001153
ZCTA5 42464,648,0,648,0,-4.7358936345680664
ZCTA5 45418,648,0,648,0,-4.7358936345680664
ZCTA5 47848,648,0,648,0,-4.7358936345680664
ZCTA5 12137,648,0,648,0,-4.7358936345680664
ZCTA5 50250,923,5,918,0.005417118093174431,-4.7369366058537885
ZCTA5 81639,923,5,918,0.005417118093174431,-4.7369366058537885
ZCTA5 56048,1536,18,1518,0.01171875,-4.737272610024268
ZCTA5 78832,1170,10,1160,0.008547008547008548,-4.737854263859361
ZCTA5 46392,2973,53,2920,0.01782711066263034,-4.738491090294341
ZCTA5 31002,1074,8,1066,0.0074487895716946,-4.739470501159608
ZCTA5 49630,649,0,649,0,-4.739546464756003
ZCTA5 49719,649,0,649,0,-4.739546464756003
ZCTA5 25265,649,0,649,0,-4.739546464756003
ZCTA5 24122,649,0,649,0,-4.739546464756003
ZCTA5 98586,649,0,649,0,-4.739546464756003
ZCTA5 45157,3589,69,3520,0.019225410977988296,-4.740447298023928
ZCTA5 51445,1265,12,1253,0.009486166007905139,-4.74069173637918
ZCTA5 73632,1448,16,1432,0.011049723756906077,-4.74114437649751
ZCTA5 97385,1358,14,1344,0.010309278350515464,-4.74318073321379
ZCTA5 64139,650,0,650,0,-4.743196481827411
ZCTA5 71422,650,0,650,0,-4.743196481827411
ZCTA5 15311,650,0,650,0,-4.743196481827411
ZCTA5 17224,650,0,650,0,-4.743196481827411
ZCTA5 24120,650,0,650,0,-4.743196481827411
ZCTA5 60475,4340,89,4251,0.020506912442396313,-4.7433859316334726
ZCTA5 30234,765,2,763,0.00261437908496732,-4.74358194418114
ZCTA5 35564,925,5,920,0.005405405405405406,-4.74404696558121
ZCTA5 42452,925,5,920,0.005405405405405406,-4.74404696558121
ZCTA5 02904,12507,323,12184,0.025825537698888623,-4.744505146853502
ZCTA5 03452,2094,31,2063,0.014804202483285577,-4.746040211298499
ZCTA5 43719,1076,8,1068,0.007434944237918215,-4.746407010807528
ZCTA5 39741,651,0,651,0,-4.7468436922716055
ZCTA5 50475,651,0,651,0,-4.7468436922716055
ZCTA5 70740,651,0,651,0,-4.7468436922716055
ZCTA5 76132,12711,329,12382,0.025883093383683425,-4.746955926523707
ZCTA5 77627,8789,214,8575,0.02434861759016953,-4.747259394930626
ZCTA5 39327,1495,17,1478,0.01137123745819398,-4.748342638917084
ZCTA5 06320,10985,278,10707,0.02530723714155667,-4.748555792981694
ZCTA5 43360,652,0,652,0,-4.750488102552992
ZCTA5 13694,652,0,652,0,-4.750488102552992
ZCTA5 21541,652,0,652,0,-4.750488102552992
ZCTA5 55070,2663,45,2618,0.016898235073225687,-4.751213243044528
ZCTA5 65231,1269,12,1257,0.009456264775413711,-4.754104548993347
ZCTA5 28624,653,0,653,0,-4.754129719111199
ZCTA5 50061,653,0,653,0,-4.754129719111199
ZCTA5 24594,653,0,653,0,-4.754129719111199
ZCTA5 23696,1452,16,1436,0.011019283746556474,-4.754138870604259
ZCTA5 04543,928,5,923,0.005387931034482759,-4.754694107380497
ZCTA5 63074,6517,149,6368,0.022863280650606107,-4.754695316821918
ZCTA5 90094,4345,89,4256,0.02048331415420023,-4.754767957058831
ZCTA5 68057,654,0,654,0,-4.757768548361208
ZCTA5 14055,654,0,654,0,-4.757768548361208
ZCTA5 47342,1128,9,1119,0.007978723404255319,-4.758179877096693
ZCTA5 72102,1128,9,1119,0.007978723404255319,-4.758179877096693
ZCTA5 74525,3748,73,3675,0.019477054429028817,-4.758641197743056
ZCTA5 13461,1271,12,1259,0.00944138473642801,-4.760799535442908
ZCTA5 55382,1409,15,1394,0.0106458481192335,-4.761167803138778
ZCTA5 03584,1499,17,1482,0.01134089392928619,-4.76122395504824
ZCTA5 64624,655,0,655,0,-4.761404596693493
ZCTA5 68371,655,0,655,0,-4.761404596693493
ZCTA5 13304,655,0,655,0,-4.761404596693493
ZCTA5 14550,655,0,655,0,-4.761404596693493
ZCTA5 70711,1500,17,1483,0.011333333333333334,-4.764440237598867
ZCTA5 25306,2983,53,2930,0.017767348307073418,-4.764605315593596
ZCTA5 47978,4238,86,4152,0.020292590844738084,-4.7649049507093775
ZCTA5 89439,656,0,656,0,-4.76503787047414
ZCTA5 15050,982,6,976,0.006109979633401222,-4.765244846720503
ZCTA5 15428,771,2,769,0.0025940337224383916,-4.765289528901926
ZCTA5 56360,1633,20,1613,0.01224739742804654,-4.765763026128355
ZCTA5 61273,1365,14,1351,0.010256410256410256,-4.766252046196489
ZCTA5 37337,657,0,657,0,-4.768668376044986
ZCTA5 44417,657,0,657,0,-4.768668376044986
ZCTA5 15952,657,0,657,0,-4.768668376044986
ZCTA5 31060,772,2,770,0.0025906735751295338,-4.76889805247007
ZCTA5 67017,880,4,876,0.004545454545454545,-4.7690784869462846
ZCTA5 76205,7548,178,7370,0.023582405935347113,-4.7695493982729404
ZCTA5 95445,1034,7,1027,0.006769825918762089,-4.771789092962312
ZCTA5 48441,1722,22,1700,0.012775842044134728,-4.7719601284598125
ZCTA5 66409,1367,14,1353,0.010241404535479151,-4.7728278766523085
ZCTA5 35957,5705,126,5579,0.022085889570552148,-4.7751693812262
ZCTA5 30668,659,0,659,0,-4.77592110780414
ZCTA5 41033,659,0,659,0,-4.77592110780414
ZCTA5 51559,659,0,659,0,-4.77592110780414
ZCTA5 14883,1895,26,1869,0.013720316622691292,-4.777287716332049
ZCTA5 05488,2949,52,2897,0.017633095964733808,-4.777917808907956
ZCTA5 04257,986,6,980,0.006085192697768763,-4.779268537359187
ZCTA5 56340,935,5,930,0.0053475935828877,-4.7794522545545854
ZCTA5 46926,660,0,660,0,-4.779543346556021
ZCTA5 67443,660,0,660,0,-4.779543346556021
ZCTA5 74447,6245,141,6104,0.022578062449959968,-4.779759342454684
ZCTA5 54011,2634,44,2590,0.016704631738800303,-4.780528694230121
ZCTA5 80202,8947,218,8729,0.0243657091762602,-4.780749598974637
ZCTA5 48342,6495,148,6347,0.022786759045419554,-4.7809585874063245
ZCTA5 22469,661,0,661,0,-4.7831628422255
ZCTA5 24479,661,0,661,0,-4.7831628422255
ZCTA5 16254,1278,12,1266,0.009389671361502348,-4.784172432696468
ZCTA5 53091,831,3,828,0.0036101083032490976,-4.784347796870829
ZCTA5 54514,831,3,828,0.0036101083032490976,-4.784347796870829
ZCTA5 43516,1087,8,1079,0.007359705611775529,-4.7844016005404235
ZCTA5 73078,3263,60,3203,0.018387986515476556,-4.786049915876754
ZCTA5 64755,988,6,982,0.006072874493927126,-4.7862664331870235
ZCTA5 44620,662,0,662,0,-4.786779601035076
ZCTA5 49089,662,0,662,0,-4.786779601035076
ZCTA5 80547,662,0,662,0,-4.786779601035076
ZCTA5 49621,1372,14,1358,0.01020408163265306,-4.789236603094629
ZCTA5 49060,663,0,663,0,-4.7903936291837566
ZCTA5 67022,663,0,663,0,-4.7903936291837566
ZCTA5 29678,9091,222,8869,0.024419755802441975,-4.790411136484144
ZCTA5 66609,3071,55,3016,0.017909475740801043,-4.790572939941901
ZCTA5 59729,1089,8,1081,0.0073461891643709825,-4.791281553585684
ZCTA5 59330,3724,72,3652,0.01933404940923738,-4.791911954372806
ZCTA5 84754,1327,13,1314,0.009796533534287867,-4.792602603568336
ZCTA5 43732,664,0,664,0,-4.794004932847183
ZCTA5 57070,664,0,664,0,-4.794004932847183
ZCTA5 18350,664,0,664,0,-4.794004932847183
ZCTA5 40468,723,1,722,0.0013831258644536654,-4.795638851553342
ZCTA5 23102,1139,9,1130,0.007901668129938543,-4.795785902699177
ZCTA5 33549,6858,158,6700,0.023038786818314377,-4.796676711358378
ZCTA5 45506,5354,116,5238,0.021666044079193127,-4.796782430815458
ZCTA5 14476,940,5,935,0.005319148936170213,-4.797064341895354
ZCTA5 15954,940,5,935,0.005319148936170213,-4.797064341895354
ZCTA5 41171,1643,20,1623,0.012172854534388313,-4.797135855595135
ZCTA5 31017,665,0,665,0,-4.797613518177753
ZCTA5 12759,665,0,665,0,-4.797613518177753
ZCTA5 61011,835,3,832,0.003592814371257485,-4.798627723647711
ZCTA5 36782,992,6,986,0.006048387096774193,-4.800234499890137
ZCTA5 42056,666,0,666,0,-4.801219391304747
ZCTA5 70051,666,0,666,0,-4.801219391304747
ZCTA5 80926,666,0,666,0,-4.801219391304747
ZCTA5 67135,1092,8,1084,0.007326007326007326,-4.801585391216455
ZCTA5 38329,1330,13,1317,0.009774436090225564,-4.802498534347469
ZCTA5 39041,1330,13,1317,0.009774436090225564,-4.802498534347469
ZCTA5 08075,10884,274,10610,0.02517456817346564,-4.803646362300059
ZCTA5 46555,1237,11,1226,0.00889248181083266,-4.804051051153659
ZCTA5 33149,4367,89,4278,0.02038012365468285,-4.80471242707346
ZCTA5 28606,667,0,667,0,-4.804822558334441
ZCTA5 68640,667,0,667,0,-4.804822558334441
ZCTA5 87036,667,0,667,0,-4.804822558334441
ZCTA5 07847,667,0,667,0,-4.804822558334441
ZCTA5 29468,782,2,780,0.0025575447570332483,-4.804837278783268
ZCTA5 64490,782,2,780,0.0025575447570332483,-4.804837278783268
ZCTA5 30707,6294,142,6152,0.02256116936765173,-4.805927435008107
ZCTA5 46974,726,1,725,0.0013774104683195593,-4.806434412333993
ZCTA5 19001,6223,140,6083,0.02249718785151856,-4.806812114517341
ZCTA5 99347,994,6,988,0.006036217303822937,-4.807204739751507
ZCTA5 28623,668,0,668,0,-4.808423025350237
ZCTA5 31641,668,0,668,0,-4.808423025350237
ZCTA5 50624,668,0,668,0,-4.808423025350237
ZCTA5 64146,668,0,668,0,-4.808423025350237
ZCTA5 65624,668,0,668,0,-4.808423025350237
ZCTA5 12723,668,0,668,0,-4.808423025350237
ZCTA5 12052,668,0,668,0,-4.808423025350237
ZCTA5 12491,668,0,668,0,-4.808423025350237
ZCTA5 21668,668,0,668,0,-4.808423025350237
ZCTA5 47634,838,3,835,0.003579952267303103,-4.809310888662592
ZCTA5 62320,838,3,835,0.003579952267303103,-4.809310888662592
ZCTA5 57231,727,1,726,0.001375515818431912,-4.810027581981385
ZCTA5 00638,5938,132,5806,0.02222970697204446,-4.810075441416716
ZCTA5 38572,4776,100,4676,0.020938023450586266,-4.810261641455294
ZCTA5 35148,995,6,989,0.006030150753768844,-4.810686426298724
ZCTA5 50682,669,0,669,0,-4.812020798412775
ZCTA5 60924,669,0,669,0,-4.812020798412775
ZCTA5 16865,669,0,669,0,-4.812020798412775
ZCTA5 21737,669,0,669,0,-4.812020798412775
ZCTA5 26851,669,0,669,0,-4.812020798412775
ZCTA5 16037,1864,25,1839,0.013412017167381975,-4.812072814599145
ZCTA5 70555,2923,51,2872,0.017447827574409852,-4.81251184612877
ZCTA5 45877,839,3,836,0.003575685339690107,-4.81286687101557
ZCTA5 29003,2364,37,2327,0.015651438240270727,-4.8136606159795035
ZCTA5 07666,13330,346,12984,0.02595648912228057,-4.814040836627798
ZCTA5 40013,1950,27,1923,0.013846153846153847,-4.815217032749602
ZCTA5 01068,670,0,670,0,-4.815615883560058
ZCTA5 95255,670,0,670,0,-4.815615883560058
ZCTA5 71040,3120,56,3064,0.017948717948717947,-4.816450476760601
ZCTA5 46741,1426,15,1411,0.010518934081346423,-4.816456301444894
ZCTA5 95658,2727,46,2681,0.016868353502016868,-4.816645126211455
ZCTA5 76821,1737,22,1715,0.012665515256188831,-4.81826964534845
ZCTA5 12903,671,0,671,0,-4.819208286807567
ZCTA5 17721,671,0,671,0,-4.819208286807567
ZCTA5 19960,2528,41,2487,0.016218354430379747,-4.819317288770727
ZCTA5 57638,841,3,838,0.0035671819262782403,-4.819971258325889
ZCTA5 06514,10142,252,9890,0.02484717018339578,-4.820374141185865
ZCTA5 49045,1994,28,1966,0.014042126379137413,-4.820574045045326
ZCTA5 29555,2078,30,2048,0.014436958614051972,-4.8209715096987855
ZCTA5 24641,2448,39,2409,0.015931372549019607,-4.821412190372791
ZCTA5 36311,1098,8,1090,0.007285974499089253,-4.822135503212022
ZCTA5 48725,1098,8,1090,0.007285974499089253,-4.822135503212022
ZCTA5 87511,787,2,785,0.0025412960609911056,-4.822708484197118
ZCTA5 36353,672,0,672,0,-4.822798014148376
ZCTA5 46923,3201,58,3143,0.01811933770696657,-4.824888287395987
ZCTA5 72943,948,5,943,0.005274261603375527,-4.825119969542853
ZCTA5 85638,948,5,943,0.005274261603375527,-4.825119969542853
ZCTA5 80116,1474,16,1458,0.010854816824966078,-4.8251344934871545
ZCTA5 59901,20514,562,19952,0.027395924734327778,-4.825483809975424
ZCTA5 37022,2163,32,2131,0.014794267221451687,-4.826170164563971
ZCTA5 35981,673,0,673,0,-4.826385071553276
ZCTA5 66968,673,0,673,0,-4.826385071553276
ZCTA5 56529,1653,20,1633,0.012099213551119177,-4.828362607110327
ZCTA5 29481,674,0,674,0,-4.829969464970883
ZCTA5 72530,674,0,674,0,-4.829969464970883
ZCTA5 20689,674,0,674,0,-4.829969464970883
ZCTA5 97458,1955,27,1928,0.01381074168797954,-4.830093844288285
ZCTA5 02460,3664,70,3594,0.01910480349344978,-4.83032118796099
ZCTA5 19962,4042,80,3962,0.01979218208807521,-4.830340221784981
ZCTA5 18655,2411,38,2373,0.015761094981335544,-4.8313335212662425
ZCTA5 03869,1001,6,995,0.005994005994005994,-4.831528745406831
ZCTA5 95242,10046,249,9797,0.024785984471431415,-4.831610406265059
ZCTA5 96025,950,5,945,0.005263157894736842,-4.8321103144731925
ZCTA5 66839,1566,18,1548,0.011494252873563218,-4.832716202375127
ZCTA5 93527,675,0,675,0,-4.833551200327759
ZCTA5 68713,951,5,946,0.005257623554153523,-4.8356019774978964
ZCTA5 65542,1957,27,1930,0.013796627491057742,-4.836036128922225
ZCTA5 06235,899,4,895,0.004449388209121246,-4.836306137346458
ZCTA5 80863,5118,109,5009,0.021297381789761625,-4.836542111792094
ZCTA5 44859,676,0,676,0,-4.837130283528522
ZCTA5 26283,676,0,676,0,-4.837130283528522
ZCTA5 14125,1387,14,1373,0.010093727469358327,-4.838201131130402
ZCTA5 54610,735,1,734,0.0013605442176870747,-4.838677475725806
ZCTA5 44818,952,5,947,0.005252100840336135,-4.839091306865605
ZCTA5 49125,1103,8,1095,0.007252946509519492,-4.8392024387124275
ZCTA5 03269,1152,9,1143,0.0078125,-4.8399072319857375
ZCTA5 67117,677,0,677,0,-4.840706720455962
ZCTA5 84325,677,0,677,0,-4.840706720455962
ZCTA5 15055,677,0,677,0,-4.840706720455962
ZCTA5 03101,1657,20,1637,0.012070006035003017,-4.840812805887561
ZCTA5 36576,1613,19,1594,0.011779293242405457,-4.841038736007283
ZCTA5 48730,2210,33,2177,0.01493212669683258,-4.842281577165947
ZCTA5 35979,678,0,678,0,-4.844280516971155
ZCTA5 77046,678,0,678,0,-4.844280516971155
ZCTA5 38851,2896,50,2846,0.017265193370165747,-4.844890332020506
ZCTA5 55802,1343,13,1330,0.00967982129560685,-4.845194677634413
ZCTA5 45153,679,0,679,0,-4.84785167891357
ZCTA5 65023,679,0,679,0,-4.84785167891357
ZCTA5 22460,679,0,679,0,-4.84785167891357
ZCTA5 35611,9678,238,9440,0.024591857821864023,-4.848494294484721
ZCTA5 38382,3672,70,3602,0.01906318082788671,-4.849617929434461
ZCTA5 98249,1962,27,1935,0.013761467889908258,-4.850870828959112
ZCTA5 32625,680,0,680,0,-4.8514202121011865
ZCTA5 71960,680,0,680,0,-4.8514202121011865
ZCTA5 78056,680,0,680,0,-4.8514202121011865
ZCTA5 20197,680,0,680,0,-4.8514202121011865
ZCTA5 54859,850,3,847,0.0035294117647058825,-4.851817003274876
ZCTA5 14080,1748,22,1726,0.012585812356979404,-4.852033423920217
ZCTA5 06441,2005,28,1977,0.013965087281795512,-4.8530358881510445
ZCTA5 90713,9267,226,9041,0.024387611956404445,-4.8537675738628
ZCTA5 08059,2131,31,2100,0.014547160957297044,-4.853773729348475
ZCTA5 76302,4980,105,4875,0.02108433734939759,-4.85449914340199
ZCTA5 39747,796,2,794,0.002512562814070352,-4.854714148855828
ZCTA5 29114,681,0,681,0,-4.8549861223306
ZCTA5 49780,681,0,681,0,-4.8549861223306
ZCTA5 65724,681,0,681,0,-4.8549861223306
ZCTA5 05830,681,0,681,0,-4.8549861223306
ZCTA5 98592,681,0,681,0,-4.8549861223306
ZCTA5 44843,851,3,848,0.0035252643948296123,-4.855342997149685
ZCTA5 52637,1008,6,1002,0.005952380952380952,-4.85574210720805
ZCTA5 28128,2979,52,2927,0.01745552198724404,-4.856057678677888
ZCTA5 22539,1108,8,1100,0.007220216606498195,-4.856216986891275
ZCTA5 40069,3291,60,3231,0.018231540565177756,-4.856451184947119
ZCTA5 56520,1793,23,1770,0.012827663134411601,-4.857140301352171
ZCTA5 35546,1484,16,1468,0.01078167115902965,-4.857144300806533
ZCTA5 38652,5998,133,5865,0.02217405801933978,-4.858283389350649
ZCTA5 12140,682,0,682,0,-4.858549415377137
ZCTA5 49031,2980,52,2928,0.0174496644295302,-4.858650888258404
ZCTA5 51039,1009,6,1003,0.005946481665014866,-4.859192209696565
ZCTA5 29458,1109,8,1101,0.007213706041478809,-4.8596136494692574
ZCTA5 70577,1619,19,1600,0.01173563928350834,-4.859802272812312
ZCTA5 13205,7069,163,6906,0.023058424105248266,-4.860725641952736
ZCTA5 48849,2340,36,2304,0.015384615384615385,-4.860941911004193
ZCTA5 19115,13767,358,13409,0.0260042129730515,-4.861174341193646
ZCTA5 51241,683,0,683,0,-4.862110096994958
ZCTA5 83648,1010,6,1004,0.005940594059405941,-4.862640087182181
ZCTA5 15027,1010,6,1004,0.005940594059405941,-4.862640087182181
ZCTA5 35045,5748,126,5622,0.021920668058455117,-4.8627921624411705
ZCTA5 30213,11094,279,10815,0.025148729042725797,-4.864901735913609
ZCTA5 71449,3564,67,3497,0.018799102132435467,-4.865440663572173
ZCTA5 45743,684,0,684,0,-4.865668172917171
ZCTA5 53078,684,0,684,0,-4.865668172917171
ZCTA5 62530,684,0,684,0,-4.865668172917171
ZCTA5 12070,684,0,684,0,-4.865668172917171
ZCTA5 49307,7001,161,6840,0.022996714755034994,-4.866004386923911
ZCTA5 72644,1111,8,1103,0.0072007200720072,-4.8664007559835785
ZCTA5 08741,960,5,955,0.005208333333333333,-4.8669224625070555
ZCTA5 48731,685,0,685,0,-4.869223648855937
ZCTA5 71726,685,0,685,0,-4.869223648855937
ZCTA5 14030,685,0,685,0,-4.869223648855937
ZCTA5 45334,855,3,852,0.0035087719298245615,-4.869422364885555
ZCTA5 81432,1397,14,1383,0.010021474588403722,-4.870629203925394
ZCTA5 46176,11098,279,10819,0.025139664804469275,-4.871088962467473
ZCTA5 04654,1351,13,1338,0.009622501850481125,-4.871320572829171
ZCTA5 08045,1063,7,1056,0.00658513640639699,-4.871728850634714
ZCTA5 54568,2507,40,2467,0.015955325089748704,-4.872497957292693
ZCTA5 49440,686,0,686,0,-4.872776530502576
ZCTA5 77951,686,0,686,0,-4.872776530502576
ZCTA5 23038,686,0,686,0,-4.872776530502576
ZCTA5 97054,686,0,686,0,-4.872776530502576
ZCTA5 73662,1927,26,1901,0.013492475350285417,-4.873075487755006
ZCTA5 46562,2012,28,1984,0.013916500994035786,-4.873619812193996
ZCTA5 56131,962,5,957,0.005197505197505198,-4.873857223892175
ZCTA5 72153,962,5,957,0.005197505197505198,-4.873857223892175
ZCTA5 36442,1211,10,1201,0.008257638315441783,-4.876153297726476
ZCTA5 72042,2097,30,2067,0.01430615164520744,-4.876272838580552
ZCTA5 43760,687,0,687,0,-4.876326823527677
ZCTA5 48417,1014,6,1008,0.005917159763313609,-4.876409428290292
ZCTA5 42048,857,3,854,0.003500583430571762,-4.876447354159892
ZCTA5 96122,1399,14,1385,0.010007147962830594,-4.8770944464888455
ZCTA5 95687,22429,619,21810,0.027598198760533238,-4.877226476217262
ZCTA5 30540,7361,171,7190,0.02323053932889553,-4.8779807165455376
ZCTA5 80540,1800,23,1777,0.012777777777777779,-4.87838226877652
ZCTA5 55932,803,2,801,0.0024906600249066002,-4.879465128815299
ZCTA5 43534,688,0,688,0,-4.879874533581198
ZCTA5 71941,858,3,855,0.0034965034965034965,-4.879956192548488
ZCTA5 45715,964,5,959,0.005186721991701245,-4.880782843897736
ZCTA5 53948,3301,60,3241,0.018176310209027567,-4.8814706808919
ZCTA5 02116,12160,310,11850,0.02549342105263158,-4.881892273367216
ZCTA5 27607,8729,210,8519,0.024057738572574178,-4.882160023976945
ZCTA5 12159,3340,61,3279,0.018263473053892216,-4.882208797613575
ZCTA5 28717,689,0,689,0,-4.883419666292578
ZCTA5 40472,689,0,689,0,-4.883419666292578
ZCTA5 44064,689,0,689,0,-4.883419666292578
ZCTA5 50244,689,0,689,0,-4.883419666292578
ZCTA5 99354,9078,220,8858,0.024234412866270105,-4.885189954129147
ZCTA5 54247,913,4,909,0.004381161007667032,-4.885282740837905
ZCTA5 80440,1017,6,1011,0.0058997050147492625,-4.886713269769881
ZCTA5 60150,690,0,690,0,-4.8869622272708355
ZCTA5 14028,690,0,690,0,-4.8869622272708355
ZCTA5 20842,690,0,690,0,-4.8869622272708355
ZCTA5 13605,1846,24,1822,0.013001083423618635,-4.886968472385346
ZCTA5 56096,1262,11,1251,0.008716323296354992,-4.887154983397823
ZCTA5 36748,1215,10,1205,0.00823045267489712,-4.8894695210277055
ZCTA5 30216,861,3,858,0.003484320557491289,-4.890468141883194
ZCTA5 51526,691,0,691,0,-4.890502222104671
ZCTA5 81236,691,0,691,0,-4.890502222104671
ZCTA5 05051,691,0,691,0,-4.890502222104671
ZCTA5 55734,2675,44,2631,0.01644859813084112,-4.891232511306725
ZCTA5 25315,1450,15,1435,0.010344827586206896,-4.893687437515525
ZCTA5 21557,692,0,692,0,-4.894039656362576
ZCTA5 45786,1312,12,1300,0.009146341463414634,-4.896408540510089
ZCTA5 35046,1935,26,1909,0.013436692506459949,-4.896826338547646
ZCTA5 71260,1169,9,1160,0.007698887938408896,-4.897089613369493
ZCTA5 43045,693,0,693,0,-4.897574535592932
ZCTA5 14047,2517,40,2477,0.015891934843067144,-4.899891973327896
ZCTA5 46770,1121,8,1113,0.007136485280999108,-4.900212828030435
ZCTA5 68372,1121,8,1113,0.007136485280999108,-4.900212828030435
ZCTA5 00637,7479,174,7305,0.023265142398716406,-4.900281565032588
ZCTA5 42406,1266,11,1255,0.008688783570300158,-4.900343237182381
ZCTA5 13143,1021,6,1015,0.005876591576885406,-4.900421044493058
ZCTA5 29148,2957,51,2906,0.017247210010145418,-4.901087948774418
ZCTA5 01474,694,0,694,0,-4.90110686532411
ZCTA5 54963,2719,45,2674,0.01655020228025009,-4.901832246367811
ZCTA5 38862,918,4,914,0.004357298474945534,-4.902662176623019
ZCTA5 45346,810,2,808,0.0024691358024691358,-4.904093579326794
ZCTA5 61570,695,0,695,0,-4.904636651064574
ZCTA5 59313,1073,7,1066,0.0065237651444548,-4.905769855911626
ZCTA5 51024,754,1,753,0.001326259946949602,-4.906054497421336
ZCTA5 15014,1315,12,1303,0.009125475285171103,-4.90621130629456
ZCTA5 42066,9195,223,8972,0.02425231103860794,-4.907025689459414
ZCTA5 72837,2761,46,2715,0.01666063020644694,-4.907277872286776
ZCTA5 32008,1853,24,1829,0.012951969778737183,-4.907982531157456
ZCTA5 36860,696,0,696,0,-4.908163898302981
ZCTA5 52306,696,0,696,0,-4.908163898302981
ZCTA5 06058,696,0,696,0,-4.908163898302981
ZCTA5 88005,10609,264,10345,0.024884532001131113,-4.9087042894005375
ZCTA5 22815,3659,69,3590,0.018857611369226566,-4.910177467873061
ZCTA5 54758,1897,25,1872,0.013178703215603585,-4.910993663710188
ZCTA5 30741,11158,280,10878,0.025094102885821833,-4.911003141565402
ZCTA5 61080,3888,75,3813,0.019290123456790122,-4.911521546939138
ZCTA5 67554,1636,19,1617,0.011613691931540342,-4.912680442566522
ZCTA5 17028,1547,17,1530,0.01098901098901099,-4.913821034665844
ZCTA5 45337,698,0,698,0,-4.915210799129811
ZCTA5 25678,698,0,698,0,-4.915210799129811
ZCTA5 68361,974,5,969,0.00513347022587269,-4.915275021492472
ZCTA5 04021,2360,36,2324,0.015254237288135594,-4.9168937609581
ZCTA5 66106,8331,198,8133,0.023766654663305724,-4.917310981814447
ZCTA5 76201,9927,244,9683,0.024579429837816056,-4.91735641835622
ZCTA5 38260,1503,16,1487,0.010645375914836993,-4.917523827653382
ZCTA5 32266,2924,50,2874,0.01709986320109439,-4.9179723112053395
ZCTA5 57437,699,0,699,0,-4.918730463597402
ZCTA5 58852,699,0,699,0,-4.918730463597402
ZCTA5 07865,699,0,699,0,-4.918730463597402
ZCTA5 26159,1224,10,1214,0.008169934640522876,-4.919319652442392
ZCTA5 12514,1127,8,1119,0.00709849157054126,-4.9204023005103865
ZCTA5 07980,815,2,813,0.00245398773006135,-4.9216112970172095
ZCTA5 62012,2525,40,2485,0.015841584158415842,-4.9217428380335
ZCTA5 23866,870,3,867,0.0034482758620689655,-4.921874036908083
ZCTA5 54173,1639,19,1620,0.011592434411226357,-4.921968588599485
ZCTA5 46991,700,0,700,0,-4.92224761132147
ZCTA5 75487,700,0,700,0,-4.92224761132147
ZCTA5 04276,2403,37,2366,0.015397419891801914,-4.922452442867402
ZCTA5 48140,1225,10,1215,0.00816326530612245,-4.922626884714159
ZCTA5 63089,2029,28,2001,0.013799901429275506,-4.923373803250993
ZCTA5 56452,924,4,920,0.004329004329004329,-4.923440802974906
ZCTA5 49070,1028,6,1022,0.005836575875486381,-4.9243259875656875
ZCTA5 38366,701,0,701,0,-4.925762247693114
ZCTA5 42732,701,0,701,0,-4.925762247693114
ZCTA5 54475,701,0,701,0,-4.925762247693114
ZCTA5 64470,701,0,701,0,-4.925762247693114
ZCTA5 27551,701,0,701,0,-4.925762247693114
ZCTA5 11568,1079,7,1072,0.006487488415199258,-4.9260935452055765
ZCTA5 53181,2848,48,2800,0.016853932584269662,-4.9266250993854674
ZCTA5 48880,2446,38,2408,0.01553556827473426,-4.9283031400122965
ZCTA5 43901,817,2,815,0.0024479804161566705,-4.92860127618878
ZCTA5 26347,817,2,815,0.0024479804161566705,-4.92860127618878
ZCTA5 61376,872,3,869,0.0034403669724770644,-4.928826899700604
ZCTA5 99148,872,3,869,0.0034403669724770644,-4.928826899700604
ZCTA5 36907,702,0,702,0,-4.929274378084215
ZCTA5 15360,702,0,702,0,-4.929274378084215
ZCTA5 24471,702,0,702,0,-4.929274378084215
ZCTA5 67950,818,2,816,0.0024449877750611247,-4.9320926199096835
ZCTA5 53177,2610,42,2568,0.016091954022988506,-4.932766297697838
ZCTA5 36053,703,0,703,0,-4.932784007847528
ZCTA5 95977,703,0,703,0,-4.932784007847528
ZCTA5 76310,7214,166,7048,0.02301081230939839,-4.932813196469569
ZCTA5 54406,1370,13,1357,0.00948905109489051,-4.932924369313353
ZCTA5 15104,3745,71,3674,0.018958611481975966,-4.933173492264022
ZCTA5 24236,1276,11,1265,0.008620689655172414,-4.9331856691527145
ZCTA5 39483,2407,37,2370,0.015371832156211051,-4.93352890960399
ZCTA5 36832,9834,241,9593,0.024506813097417125,-4.934314902205977
ZCTA5 48353,2489,39,2450,0.01566894335074327,-4.93442937381988
ZCTA5 68122,4200,83,4117,0.019761904761904762,-4.93475519367738
ZCTA5 06905,7639,178,7461,0.023301479251210892,-4.9347590753312325
ZCTA5 23836,4944,103,4841,0.020833333333333332,-4.935069295802364
ZCTA5 26833,704,0,704,0,-4.936291142316781
ZCTA5 08007,2034,28,2006,0.01376597836774828,-4.937944448239902
ZCTA5 93465,3285,59,3226,0.01796042617960426,-4.938435994290518
ZCTA5 73104,1230,10,1220,0.008130081300813009,-4.939134921089927
ZCTA5 93667,875,3,872,0.0034285714285714284,-4.939238479234229
ZCTA5 53820,981,5,976,0.0050968399592252805,-4.939286343297078
ZCTA5 12192,705,0,705,0,-4.93979578680677
ZCTA5 72416,2161,31,2130,0.014345210550670985,-4.940027573267268
ZCTA5 46056,929,4,925,0.004305705059203444,-4.940693066650039
ZCTA5 70806,12370,315,12055,0.025464834276475345,-4.941547584988521
ZCTA5 30316,13183,339,12844,0.025714935902298414,-4.941658273094963
ZCTA5 55309,6220,138,6082,0.022186495176848873,-4.941919913756143
ZCTA5 85396,6292,140,6152,0.02225047679593134,-4.942216747159
ZCTA5 97018,821,2,819,0.00243605359317905,-4.942552127396374
ZCTA5 68465,876,3,873,0.003424657534246575,-4.942704300580088
ZCTA5 74019,6900,157,6743,0.0227536231884058,-4.943071409253617
ZCTA5 31331,3442,63,3379,0.01830331202789076,-4.9431988581777215
ZCTA5 45696,706,0,706,0,-4.943297946613447
ZCTA5 55334,1134,8,1126,0.007054673721340388,-4.943865194807088
ZCTA5 95963,5352,114,5238,0.021300448430493273,-4.944624518148337
ZCTA5 62454,4167,82,4085,0.019678425725941924,-4.945298049173301
ZCTA5 22181,5206,110,5096,0.021129466000768343,-4.945321411924129
ZCTA5 59404,10702,266,10436,0.024855167258456365,-4.947066127879248
ZCTA5 66712,708,0,708,0,-4.950294833267036
ZCTA5 68073,708,0,708,0,-4.950294833267036
ZCTA5 21036,708,0,708,0,-4.950294833267036
ZCTA5 36613,4282,85,4197,0.019850537132181222,-4.9504412953157395
ZCTA5 38375,3523,65,3458,0.01845018450184502,-4.952544670521523
ZCTA5 44485,7012,160,6852,0.022818026240730177,-4.953036629138555
ZCTA5 63638,1087,7,1080,0.006439742410303588,-4.9530756903232
ZCTA5 39652,2898,49,2849,0.016908212560386472,-4.953433346871278
ZCTA5 12974,709,0,709,0,-4.953789570612494
ZCTA5 13490,709,0,709,0,-4.953789570612494
ZCTA5 14042,1560,17,1543,0.010897435897435897,-4.954538350272277
ZCTA5 64070,1283,11,1272,0.00857365549493375,-4.956067554551616
ZCTA5 44254,2083,29,2054,0.013922227556409025,-4.957411643710831
ZCTA5 46982,934,4,930,0.004282655246252677,-4.957888409018523
ZCTA5 48217,2860,48,2812,0.016783216783216783,-4.958024446232363
ZCTA5 00653,3564,66,3498,0.018518518518518517,-4.95859311740263
ZCTA5 31622,826,2,824,0.002421307506053269,-4.959936523777578
ZCTA5 73529,2084,29,2055,0.013915547024952015,-4.960297459063903
ZCTA5 23921,711,0,711,0,-4.960771659448429
ZCTA5 80215,8357,198,8159,0.02369271269594352,-4.96256876600026
ZCTA5 20716,8602,205,8397,0.023831667054173448,-4.96311685319939
ZCTA5 29052,712,0,712,0,-4.964259021326901
ZCTA5 47971,712,0,712,0,-4.964259021326901
ZCTA5 47954,883,3,880,0.0033975084937712344,-4.966899653709352
ZCTA5 15610,1564,17,1547,0.010869565217391304,-4.967015812940969
ZCTA5 44637,1141,8,1133,0.007011393514460999,-4.967230651758816
ZCTA5 16159,1959,26,1933,0.013272077590607452,-4.967618813786634
ZCTA5 47470,713,0,713,0,-4.9677439350739805
ZCTA5 23071,713,0,713,0,-4.9677439350739805
ZCTA5 92661,1519,16,1503,0.01053324555628703,-4.9679322814802855
ZCTA5 55341,1041,6,1035,0.005763688760806916,-4.968442408690407
ZCTA5 31036,4140,81,4059,0.01956521739130435,-4.9697586137111545
ZCTA5 68978,990,5,985,0.005050505050505051,-4.969999430074521
ZCTA5 21758,1917,25,1892,0.013041210224308816,-4.970291632197847
ZCTA5 51551,714,0,714,0,-4.971226405838213
ZCTA5 14814,714,0,714,0,-4.971226405838213
ZCTA5 23821,714,0,714,0,-4.971226405838213
ZCTA5 13424,938,4,934,0.0042643923240938165,-4.971604063185625
ZCTA5 07460,1240,10,1230,0.008064516129032258,-4.972011534717281
ZCTA5 06422,2665,43,2622,0.016135084427767354,-4.972086801256007
ZCTA5 66604,9858,241,9617,0.024447149523229864,-4.973275640362798
ZCTA5 14813,991,5,986,0.005045408678102927,-4.973401095015446
ZCTA5 43780,830,2,828,0.0024096385542168677,-4.973801087922875
ZCTA5 49777,830,2,828,0.0024096385542168677,-4.973801087922875
ZCTA5 21028,1143,8,1135,0.00699912510936133,-4.973888757874226
ZCTA5 70814,4999,104,4895,0.02080416083216643,-4.973914094048837
ZCTA5 46186,715,0,715,0,-4.974706438750122
ZCTA5 10973,715,0,715,0,-4.974706438750122
ZCTA5 27842,715,0,715,0,-4.974706438750122
ZCTA5 18850,939,4,935,0.004259850905218318,-4.9750273707540975
ZCTA5 44455,716,0,716,0,-4.978184038922297
ZCTA5 61744,716,0,716,0,-4.978184038922297
ZCTA5 12086,716,0,716,0,-4.978184038922297
ZCTA5 19352,2828,47,2781,0.01661951909476662,-4.978620372553489
ZCTA5 15846,1523,16,1507,0.010505581089954037,-4.980472964207349
ZCTA5 98133,21305,582,20723,0.027317531095986856,-4.98127021590766
ZCTA5 60477,15030,393,14637,0.026147704590818364,-4.981437511057522
ZCTA5 23847,5113,107,5006,0.020927048699393703,-4.98144199147974
ZCTA5 61051,717,0,717,0,-4.981659211449486
ZCTA5 71438,717,0,717,0,-4.981659211449486
ZCTA5 15019,717,0,717,0,-4.981659211449486
ZCTA5 71837,2007,27,1980,0.013452914798206279,-4.983056457203119
ZCTA5 66439,1096,7,1089,0.006386861313868613,-4.983274072762611
ZCTA5 26541,994,5,989,0.005030181086519115,-4.983593113060384
ZCTA5 45217,3068,53,3015,0.01727509778357236,-4.983638915956625
ZCTA5 17023,1339,12,1327,0.008961911874533234,-4.984064691540478
ZCTA5 39750,888,3,885,0.0033783783783783786,-4.984112576374394
ZCTA5 03861,1922,25,1897,0.013007284079084287,-4.985040584039231
ZCTA5 21863,1748,21,1727,0.012013729977116704,-4.985045916858019
ZCTA5 11941,718,0,718,0,-4.985131961408676
ZCTA5 04419,1046,6,1040,0.0057361376673040155,-4.985315289530452
ZCTA5 08251,4260,84,4176,0.01971830985915493,-4.985701990083298
ZCTA5 66534,1433,14,1419,0.009769713886950453,-4.985986676126198
ZCTA5 53561,777,1,776,0.001287001287001287,-4.98640517857641
ZCTA5 42159,719,0,719,0,-4.988602293859185
ZCTA5 12521,719,0,719,0,-4.988602293859185
ZCTA5 42348,1837,23,1814,0.012520413718018509,-4.989609240415123
ZCTA5 62330,778,1,777,0.0012853470437017994,-4.989869499209834
ZCTA5 02120,4933,102,4831,0.020677072775187513,-4.99060964570445
ZCTA5 71336,720,0,720,0,-4.992070213842742
ZCTA5 26050,720,0,720,0,-4.992070213842742
ZCTA5 27507,720,0,720,0,-4.992070213842742
ZCTA5 27527,7566,175,7391,0.023129791171028286,-4.994173032806583
ZCTA5 29169,11041,275,10766,0.02490716420614075,-4.9944236979785694
ZCTA5 53818,5486,117,5369,0.02132701421800948,-4.9951996051365555
ZCTA5 52248,721,0,721,0,-4.995535726383579
ZCTA5 05486,721,0,721,0,-4.995535726383579
ZCTA5 56026,780,1,779,0.001282051282051282,-4.996790974325479
ZCTA5 41095,1343,12,1331,0.008935219657483246,-4.996943434136291
ZCTA5 43988,998,5,993,0.00501002004008016,-4.9971523381054235
ZCTA5 97267,13019,333,12686,0.02557800138259467,-4.997713331565481
ZCTA5 57469,1483,15,1468,0.010114632501685773,-4.998358995023444
ZCTA5 52328,1050,6,1044,0.005714285714285714,-4.998776094790016
ZCTA5 54466,1200,9,1191,0.0075,-4.9999106456592894
ZCTA5 56362,2390,36,2354,0.01506276150627615,-5.00010313257336
ZCTA5 13624,2013,27,1986,0.013412816691505217,-5.000504224791633
ZCTA5 83340,2098,29,2069,0.013822688274547188,-5.000583974292188
ZCTA5 04989,1709,20,1689,0.011702750146284377,-5.000614483086195
ZCTA5 74074,12036,304,11732,0.025257560651379195,-5.000836759453262
ZCTA5 24528,1297,11,1286,0.008481110254433308,-5.001569079467887
ZCTA5 57066,723,0,723,0,-5.002459549147031
ZCTA5 43143,2183,31,2152,0.014200641319285386,-5.00267328970945
ZCTA5 30293,1201,9,1192,0.00749375520399667,-5.003197026800694
ZCTA5 62694,1201,9,1192,0.00749375520399667,-5.003197026800694
ZCTA5 39347,724,0,724,0,-5.00591786933137
ZCTA5 47030,724,0,724,0,-5.00591786933137
ZCTA5 93553,724,0,724,0,-5.00591786933137
ZCTA5 81428,1393,13,1380,0.00933237616654702,-5.006678857623979
ZCTA5 36759,725,0,725,0,-5.009373801996605
ZCTA5 45768,725,0,725,0,-5.009373801996605
ZCTA5 10537,725,0,725,0,-5.009373801996605
ZCTA5 48202,7540,174,7366,0.023076923076923078,-5.011114104478284
ZCTA5 28098,1252,10,1242,0.007987220447284345,-5.011221426210966
ZCTA5 52623,726,0,726,0,-5.012827352080731
ZCTA5 52324,726,0,726,0,-5.012827352080731
ZCTA5 21678,726,0,726,0,-5.012827352080731
ZCTA5 95346,726,0,726,0,-5.012827352080731
ZCTA5 66047,8351,197,8154,0.023589989222847562,-5.012990776709879
ZCTA5 76823,1105,7,1098,0.006334841628959276,-5.013309152211474
ZCTA5 46310,5239,110,5129,0.020996373353693452,-5.014542889811406
ZCTA5 54245,897,3,894,0.0033444816053511705,-5.014951928333876
ZCTA5 48857,1055,6,1049,0.005687203791469194,-5.0155556094357605
ZCTA5 24422,2560,40,2520,0.015625,-5.016677566370389
ZCTA5 23103,2146,30,2116,0.013979496738117428,-5.0170676336152935
ZCTA5 18421,2019,27,1992,0.01337295690936107,-5.017911154184694
ZCTA5 62870,843,2,841,0.002372479240806643,-5.018601112682282
ZCTA5 87557,2189,31,2158,0.01416171767930562,-5.0196709593066595
ZCTA5 55012,728,0,728,0,-5.01972732417273
ZCTA5 05459,728,0,728,0,-5.01972732417273
ZCTA5 47710,8074,189,7885,0.02340847163735447,-5.019853975748323
ZCTA5 43554,1005,5,1000,0.004975124378109453,-5.020798816712082
ZCTA5 44412,1005,5,1000,0.004975124378109453,-5.020798816712082
ZCTA5 20158,1444,14,1430,0.009695290858725761,-5.020814113653451
ZCTA5 62288,1255,10,1245,0.00796812749003984,-5.020983168752865
ZCTA5 65279,729,0,729,0,-5.023173755971928
ZCTA5 71354,729,0,729,0,-5.023173755971928
ZCTA5 83629,729,0,729,0,-5.023173755971928
ZCTA5 19534,729,0,729,0,-5.023173755971928
ZCTA5 24839,729,0,729,0,-5.023173755971928
ZCTA5 53153,900,3,897,0.0033333333333333335,-5.02519104552039
ZCTA5 75931,900,3,897,0.0033333333333333335,-5.02519104552039
ZCTA5 58278,730,0,730,0,-5.026617824772828
ZCTA5 66517,730,0,730,0,-5.026617824772828
ZCTA5 12461,730,0,730,0,-5.026617824772828
ZCTA5 06078,3861,73,3788,0.018907018907018906,-5.026820374753355
ZCTA5 51534,3321,59,3262,0.017765733212887685,-5.027816905369478
ZCTA5 84097,6336,140,6196,0.022095959595959596,-5.027865774752413
ZCTA5 07628,6373,141,6232,0.02212458810607249,-5.029815226517185
ZCTA5 10976,731,0,731,0,-5.03005953542925
ZCTA5 73750,2687,43,2644,0.016002977298101972,-5.030649611295184
ZCTA5 30450,902,3,899,0.0033259423503325942,-5.032005928714689
ZCTA5 69138,1585,17,1568,0.010725552050473186,-5.032135482940801
ZCTA5 48740,1060,6,1054,0.005660377358490566,-5.032283885552454
ZCTA5 98058,15739,413,15326,0.026240548954825593,-5.032801666316817
ZCTA5 81223,732,0,732,0,-5.033498892778414
ZCTA5 21210,5175,108,5067,0.020869565217391306,-5.034549832561763
ZCTA5 30816,791,1,790,0.0012642225031605564,-5.034689918463975
ZCTA5 61738,1586,17,1569,0.010718789407313998,-5.035220379084907
ZCTA5 37876,12434,315,12119,0.025333762264757923,-5.035593437223785
ZCTA5 34691,8575,203,8372,0.0236734693877551,-5.036788333643656
ZCTA5 06763,733,0,733,0,-5.036935901641028
ZCTA5 98588,733,0,733,0,-5.036935901641028
ZCTA5 23927,1721,20,1701,0.011621150493898896,-5.036965354217493
ZCTA5 54015,1308,11,1297,0.008409785932721712,-5.037078864672821
ZCTA5 14105,1810,22,1788,0.012154696132596685,-5.039331502002895
ZCTA5 28510,734,0,734,0,-5.040370566821364
ZCTA5 48435,734,0,734,0,-5.040370566821364
ZCTA5 71362,734,0,734,0,-5.040370566821364
ZCTA5 49093,7273,166,7107,0.022824144094596453,-5.041473699578191
ZCTA5 76107,14065,363,13702,0.025808745111980093,-5.042421536204227
ZCTA5 62613,1543,16,1527,0.010369410239792612,-5.042814145894919
ZCTA5 44086,959,4,955,0.004171011470281543,-5.043029937916053
ZCTA5 36742,735,0,735,0,-5.043802893107334
ZCTA5 40003,735,0,735,0,-5.043802893107334
ZCTA5 20778,735,0,735,0,-5.043802893107334
ZCTA5 41030,2240,32,2208,0.014285714285714285,-5.04517320035957
ZCTA5 13332,1064,6,1058,0.005639097744360902,-5.045629912721068
ZCTA5 73052,2571,40,2531,0.015558148580318941,-5.046294615904415
ZCTA5 46172,960,4,956,0.004166666666666667,-5.046407202715892
ZCTA5 72007,2693,43,2650,0.01596732268845154,-5.0465526980429525
ZCTA5 75966,1680,19,1661,0.01130952380952381,-5.0476367104661355
ZCTA5 80924,2653,42,2611,0.0158311345646438,-5.047942999139152
ZCTA5 96137,1591,17,1574,0.010685103708359522,-5.050623233196504
ZCTA5 30105,737,0,737,0,-5.050660548066512
ZCTA5 80828,737,0,737,0,-5.050660548066512
ZCTA5 05829,737,0,737,0,-5.050660548066512
ZCTA5 12066,796,1,795,0.001256281407035176,-5.05182322092727
ZCTA5 56368,1726,20,1706,0.011587485515643106,-5.0520548555516855
ZCTA5 45723,1454,14,1440,0.009628610729023384,-5.052308960814112
ZCTA5 50616,4365,86,4279,0.01970217640320733,-5.05269913441231
ZCTA5 50841,1117,7,1110,0.006266786034019696,-5.053106157774673
ZCTA5 46068,1167,8,1159,0.006855184233076264,-5.0531820875751015
ZCTA5 63069,5624,120,5504,0.021337126600284494,-5.053419021882587
ZCTA5 72376,738,0,738,0,-5.054085886234455
ZCTA5 26456,1361,12,1349,0.00881704628949302,-5.054562987807715
ZCTA5 48393,7174,163,7011,0.022720936715918596,-5.055657131493895
ZCTA5 48335,10738,265,10473,0.024678711119389084,-5.0570658610317265
ZCTA5 36316,739,0,739,0,-5.057508904497659
ZCTA5 59263,739,0,739,0,-5.057508904497659
ZCTA5 78164,1362,12,1350,0.00881057268722467,-5.057748187266925
ZCTA5 55706,855,2,853,0.0023391812865497076,-5.059609041690369
ZCTA5 12775,740,0,740,0,-5.060929607563409
ZCTA5 18615,740,0,740,0,-5.060929607563409
ZCTA5 07442,3952,75,3877,0.018977732793522266,-5.060992417720334
ZCTA5 50129,2077,28,2049,0.013480982185844969,-5.062097512049396
ZCTA5 21140,1268,10,1258,0.007886435331230283,-5.063098455810918
ZCTA5 29626,4856,99,4757,0.020387149917627675,-5.0638599056101565
ZCTA5 30568,741,0,741,0,-5.064348000123087
ZCTA5 31562,741,0,741,0,-5.064348000123087
ZCTA5 76640,1220,9,1211,0.007377049180327869,-5.065286600334177
ZCTA5 48312,13507,346,13161,0.02561634707929222,-5.065734699166468
ZCTA5 27356,1121,7,1114,0.006244424620874219,-5.06630927446293
ZCTA5 50833,966,4,962,0.004140786749482402,-5.066625822915482
ZCTA5 07662,1993,26,1967,0.013045659809332665,-5.0667536364878725
ZCTA5 70586,7571,174,7397,0.022982432967903844,-5.067126994674716
ZCTA5 38866,4334,85,4249,0.01961236732810337,-5.067604861851488
ZCTA5 36879,742,0,742,0,-5.06776408685226
ZCTA5 02367,1019,5,1014,0.004906771344455349,-5.067782720022312
ZCTA5 38012,5558,118,5440,0.021230658510255487,-5.067820487523835
ZCTA5 29135,3338,59,3279,0.017675254643499103,-5.069739494797002
ZCTA5 39183,5778,124,5654,0.021460713049498096,-5.069897393764118
ZCTA5 37035,1366,12,1354,0.008784773060029283,-5.070472444757485
ZCTA5 52756,743,0,743,0,-5.07117787241074
ZCTA5 65681,743,0,743,0,-5.07117787241074
ZCTA5 67228,743,0,743,0,-5.07117787241074
ZCTA5 12764,743,0,743,0,-5.07117787241074
ZCTA5 65014,914,3,911,0.0032822757111597373,-5.072709179828224
ZCTA5 72324,914,3,911,0.0032822757111597373,-5.072709179828224
ZCTA5 73064,8069,188,7881,0.0232990457305738,-5.072962369973064
ZCTA5 62232,2581,40,2541,0.015497869043006587,-5.073129453445699
ZCTA5 51025,859,2,857,0.002328288707799767,-5.073205950637549
ZCTA5 27805,1553,16,1537,0.0103026400515132,-5.073761631716706
ZCTA5 03810,744,0,744,0,-5.074589361442669
ZCTA5 97392,2376,35,2341,0.014730639730639731,-5.075466237348541
ZCTA5 50864,915,3,912,0.003278688524590164,-5.076086857295488
ZCTA5 92603,7292,166,7126,0.02276467361492046,-5.0762960928127185
ZCTA5 48179,1415,13,1402,0.009187279151943463,-5.076412724384611
ZCTA5 07631,10613,261,10352,0.02459248091962687,-5.076946964344934
ZCTA5 57107,3959,75,3884,0.018944177822682495,-5.0772137964485
ZCTA5 66204,8879,211,8668,0.023763937380335623,-5.077885855870357
ZCTA5 58790,745,0,745,0,-5.0779985585765886
ZCTA5 77360,2210,31,2179,0.014027149321266969,-5.07887191593023
ZCTA5 03873,2168,30,2138,0.013837638376383764,-5.079450889496258
ZCTA5 58270,861,2,859,0.0023228803716608595,-5.079990988820374
ZCTA5 07013,9959,242,9717,0.024299628476754695,-5.080557568798966
ZCTA5 52755,746,0,746,0,-5.081405468425514
ZCTA5 55332,746,0,746,0,-5.081405468425514
ZCTA5 12056,746,0,746,0,-5.081405468425514
ZCTA5 27929,746,0,746,0,-5.081405468425514
ZCTA5 97016,2420,36,2384,0.01487603305785124,-5.082470248251007
ZCTA5 60555,4939,101,4838,0.02044948370115408,-5.0825913248269865
ZCTA5 77335,1176,8,1168,0.006802721088435374,-5.082635034629745
ZCTA5 95954,5346,112,5234,0.020950243172465393,-5.084248909107761
ZCTA5 05857,1024,5,1019,0.0048828125,-5.0844643560299625
ZCTA5 62351,747,0,747,0,-5.084810095587004
ZCTA5 66603,747,0,747,0,-5.084810095587004
ZCTA5 89448,747,0,747,0,-5.084810095587004
ZCTA5 48015,3539,64,3475,0.018084204577564284,-5.0848548614023725
ZCTA5 72454,2170,30,2140,0.013824884792626729,-5.085097157071608
ZCTA5 10916,1323,11,1312,0.008314436885865457,-5.085165630805781
ZCTA5 55810,3578,65,3513,0.018166573504751257,-5.085396045055974
ZCTA5 48529,3848,72,3776,0.018711018711018712,-5.085964665181463
ZCTA5 42023,918,3,915,0.0032679738562091504,-5.086206858986411
ZCTA5 30510,2380,35,2345,0.014705882352941176,-5.086453423645032
ZCTA5 04694,972,4,968,0.00411522633744856,-5.086767964782912
ZCTA5 74048,2463,37,2426,0.015022330491270807,-5.087048791763076
ZCTA5 87901,3109,53,3056,0.01704728208427147,-5.0874695160302785
ZCTA5 40372,748,0,748,0,-5.088212444643238
ZCTA5 08740,748,0,748,0,-5.088212444643238
ZCTA5 37877,3385,60,3325,0.01772525849335303,-5.089127643486245
ZCTA5 88415,1128,7,1121,0.0062056737588652485,-5.08934042551191
ZCTA5 43430,1694,19,1675,0.011216056670602124,-5.090018245563496
ZCTA5 88330,973,4,969,0.0041109969167523125,-5.0901176117904265
ZCTA5 68739,1228,9,1219,0.007328990228013029,-5.091232582968017
ZCTA5 27970,1228,9,1219,0.007328990228013029,-5.091232582968017
ZCTA5 37350,749,0,749,0,-5.0916125201610845
ZCTA5 31312,6657,148,6509,0.022232236743277754,-5.091821588405161
ZCTA5 75930,750,0,750,0,-5.095010326692176
ZCTA5 05440,750,0,750,0,-5.095010326692176
ZCTA5 68791,751,0,751,0,-5.098405868772975
ZCTA5 01341,751,0,751,0,-5.098405868772975
ZCTA5 94973,751,0,751,0,-5.098405868772975
ZCTA5 13166,2217,31,2186,0.013982859720342805,-5.098506075226496
ZCTA5 33131,9417,226,9191,0.023999150472549646,-5.102529302477514
ZCTA5 31707,10905,269,10636,0.02466758367721229,-5.102700570127532
ZCTA5 24586,2303,33,2270,0.014329135909683021,-5.104040786061568
ZCTA5 42039,753,0,753,0,-5.10519017765414
ZCTA5 11772,17066,451,16615,0.026426813547404195,-5.1053545163764165
ZCTA5 19330,1920,24,1896,0.0125,-5.106059476599297
ZCTA5 12701,4162,80,4082,0.019221528111484865,-5.106250643800105
ZCTA5 21710,1921,24,1897,0.012493492972410203,-5.108975029483119
ZCTA5 21643,2263,32,2231,0.014140521431727796,-5.109419172417876
ZCTA5 65552,813,1,812,0.0012300123001230013,-5.109648951170928
ZCTA5 35175,2008,26,1982,0.012948207171314742,-5.110069983008086
ZCTA5 64844,1834,22,1812,0.011995637949836423,-5.11051218439086
ZCTA5 01360,1234,9,1225,0.007293354943273906,-5.110616761828942
ZCTA5 88030,8478,199,8279,0.02347251710309035,-5.111116374774176
ZCTA5 55744,8724,206,8518,0.02361302154974782,-5.111757708510631
ZCTA5 02837,1611,17,1594,0.010552451893234015,-5.111878077333417
ZCTA5 45871,755,0,755,0,-5.111965482795625
ZCTA5 02025,3119,53,3066,0.016992625841615903,-5.112619821916202
ZCTA5 02673,3667,67,3600,0.018271066266703027,-5.113066383061163
ZCTA5 54111,926,3,923,0.0032397408207343412,-5.113098686863714
ZCTA5 57366,926,3,923,0.0032397408207343412,-5.113098686863714
ZCTA5 52003,5361,112,5249,0.02089162469688491,-5.115244947033991
ZCTA5 43443,756,0,756,0,-5.115349770145998
ZCTA5 65254,756,0,756,0,-5.115349770145998
ZCTA5 68638,756,0,756,0,-5.115349770145998
ZCTA5 75651,756,0,756,0,-5.115349770145998
ZCTA5 14735,1136,7,1129,0.006161971830985915,-5.1155471476384005
ZCTA5 44413,2921,48,2873,0.01643272851763095,-5.1159617228817105
ZCTA5 32464,1836,22,1814,0.011982570806100218,-5.116411688215478
ZCTA5 17098,981,4,977,0.004077471967380225,-5.116839600412382
ZCTA5 27604,18176,484,17692,0.026628521126760563,-5.117540597130001
ZCTA5 12569,4091,78,4013,0.01906624297237839,-5.117743421783378
ZCTA5 71051,757,0,757,0,-5.118731819950281
ZCTA5 24079,757,0,757,0,-5.118731819950281
ZCTA5 95690,757,0,757,0,-5.118731819950281
ZCTA5 35020,10018,243,9775,0.024256338590537035,-5.119680423509095
ZCTA5 60706,8869,210,8659,0.02367797947908445,-5.120043566718434
ZCTA5 56296,982,4,978,0.004073319755600814,-5.12017050709969
ZCTA5 87144,14223,366,13857,0.025732967728327356,-5.120921816844755
ZCTA5 48069,1035,5,1030,0.004830917874396135,-5.120984981897633
ZCTA5 38661,758,0,758,0,-5.1221116366407236
ZCTA5 42020,758,0,758,0,-5.1221116366407236
ZCTA5 99011,759,0,759,0,-5.125489224634963
ZCTA5 11752,2965,49,2916,0.016526138279932545,-5.1260636686196275
ZCTA5 55783,984,4,980,0.0040650406504065045,-5.126826133644978
ZCTA5 43977,875,2,873,0.002285714285714286,-5.127239029656281
ZCTA5 49448,1478,14,1464,0.009472259810554804,-5.127262748036387
ZCTA5 41144,3866,72,3794,0.018623900672529746,-5.127969507328726
ZCTA5 62924,1140,7,1133,0.0061403508771929825,-5.12860514560639
ZCTA5 34450,5072,104,4968,0.02050473186119874,-5.128688902082534
ZCTA5 44411,760,0,760,0,-5.128864588336088
ZCTA5 45827,760,0,760,0,-5.128864588336088
ZCTA5 47433,1617,17,1600,0.010513296227581941,-5.130144697846467
ZCTA5 62888,876,2,874,0.00228310502283105,-5.130597514110478
ZCTA5 44846,1191,8,1183,0.006717044500419815,-5.1313900945474
ZCTA5 08005,9156,218,8938,0.023809523809523808,-5.132227658217153
ZCTA5 56143,1929,24,1905,0.012441679626749611,-5.132257389018486
ZCTA5 36507,7287,165,7122,0.022643062988884313,-5.132286426361931
ZCTA5 34117,4664,93,4571,0.019939965694682676,-5.132576704065319
ZCTA5 64108,4174,80,4094,0.019166267369429803,-5.133460959596506
ZCTA5 49635,1480,14,1466,0.00945945945945946,-5.133469149709145
ZCTA5 55336,3008,50,2958,0.016622340425531915,-5.133758510865149
ZCTA5 35218,2928,48,2880,0.01639344262295082,-5.133909948196633
ZCTA5 62958,877,2,875,0.002280501710376283,-5.133953837386016
ZCTA5 19341,6859,153,6706,0.022306458667444233,-5.134313160163535
ZCTA5 11552,7074,159,6915,0.022476675148430873,-5.13454608756051
ZCTA5 62097,1091,6,1085,0.005499541704857928,-5.134882110846822
ZCTA5 25976,1142,7,1135,0.006129597197898424,-5.135122889978902
ZCTA5 62531,762,0,762,0,-5.135608660399029
ZCTA5 68769,762,0,762,0,-5.135608660399029
ZCTA5 78950,762,0,762,0,-5.135608660399029
ZCTA5 39897,1339,11,1328,0.008215085884988798,-5.136039938849745
ZCTA5 42743,3677,67,3610,0.018221376121838457,-5.136789746908431
ZCTA5 48892,1710,19,1691,0.011111111111111112,-5.138133394163782
ZCTA5 28660,763,0,763,0,-5.1389773774948955
ZCTA5 37228,763,0,763,0,-5.1389773774948955
ZCTA5 27242,763,0,763,0,-5.1389773774948955
ZCTA5 55360,934,3,931,0.0032119914346895075,-5.139854183058507
ZCTA5 05773,934,3,931,0.0032119914346895075,-5.139854183058507
ZCTA5 20009,27380,763,26617,0.027867056245434625,-5.141307160641451
ZCTA5 03102,13357,340,13017,0.02545481769858501,-5.141344941709432
ZCTA5 22408,9997,242,9755,0.024207262178653596,-5.141599545632288
ZCTA5 35984,764,0,764,0,-5.142343887765881
ZCTA5 53019,764,0,764,0,-5.142343887765881
ZCTA5 54830,1483,14,1469,0.009440323668240054,-5.142767433465025
ZCTA5 39631,1244,9,1235,0.007234726688102894,-5.142782037997305
ZCTA5 66967,935,3,932,0.0032085561497326204,-5.143189134769285
ZCTA5 28450,989,4,985,0.004044489383215369,-5.143429282490046
ZCTA5 11507,2401,35,2366,0.014577259475218658,-5.1438935227143165
ZCTA5 12748,880,2,878,0.0022727272727272726,-5.144009881210746
ZCTA5 32334,765,0,765,0,-5.1457081955433415
ZCTA5 39116,765,0,765,0,-5.1457081955433415
ZCTA5 54896,765,0,765,0,-5.1457081955433415
ZCTA5 03781,765,0,765,0,-5.1457081955433415
ZCTA5 12957,765,0,765,0,-5.1457081955433415
ZCTA5 98377,765,0,765,0,-5.1457081955433415
ZCTA5 28551,5816,124,5692,0.021320495185694635,-5.146008958759115
ZCTA5 77651,5006,102,4904,0.02037554934079105,-5.1460398892046415
ZCTA5 98591,1390,12,1378,0.008633093525179856,-5.146269770933986
ZCTA5 35083,1294,10,1284,0.0077279752704791345,-5.146443125353847
ZCTA5 05843,936,3,933,0.003205128205128205,-5.1465219915920715
ZCTA5 21655,1934,24,1910,0.012409513960703205,-5.1467710757538825
ZCTA5 85379,14073,361,13712,0.025651957649399558,-5.147290438595099
ZCTA5 01223,1043,5,1038,0.004793863854266539,-5.147393017562236
ZCTA5 14801,2021,26,1995,0.012864918357248886,-5.147407362929001
ZCTA5 57025,1196,8,1188,0.006688963210702341,-5.147550640275919
ZCTA5 16157,1343,11,1332,0.008190618019359643,-5.148692190638169
ZCTA5 68920,766,0,766,0,-5.149070305144484
ZCTA5 70114,9655,232,9423,0.02402900051786639,-5.150295067316578
ZCTA5 36477,1624,17,1607,0.010467980295566502,-5.151392550376877
ZCTA5 75098,17370,459,16911,0.026424870466321245,-5.152049286770942
ZCTA5 85646,767,0,767,0,-5.1524302208724295
ZCTA5 15480,767,0,767,0,-5.1524302208724295
ZCTA5 15944,1296,10,1286,0.007716049382716049,-5.152806319679925
ZCTA5 48239,13569,346,13223,0.025499299874714422,-5.153170289682061
ZCTA5 33635,7120,160,6960,0.02247191011235955,-5.153449193730522
ZCTA5 40216,16904,445,16459,0.026325130146710837,-5.154585714828136
ZCTA5 78411,10075,244,9831,0.024218362282878412,-5.1554228090309
ZCTA5 62565,3176,54,3122,0.01700251889168766,-5.156024587555439
ZCTA5 57362,993,4,989,0.004028197381671702,-5.156675099419304
ZCTA5 29010,4374,85,4289,0.019433013260173753,-5.156901529870877
ZCTA5 53901,6113,132,5981,0.0215933256993293,-5.157139219695737
ZCTA5 68779,1046,5,1041,0.004780114722753346,-5.157263359332146
ZCTA5 37353,1894,23,1871,0.012143611404435059,-5.157622898971956
ZCTA5 10707,3956,74,3882,0.01870576339737108,-5.158681649231022
ZCTA5 07644,8927,211,8716,0.02363615996415369,-5.158731167146703
ZCTA5 17407,769,0,769,0,-5.159143487851168
ZCTA5 18617,769,0,769,0,-5.159143487851168
ZCTA5 22967,769,0,769,0,-5.159143487851168
ZCTA5 07424,9556,229,9327,0.023964001674340728,-5.1591572424717675
ZCTA5 28570,8717,205,8512,0.023517265114144776,-5.15942461364577
ZCTA5 71082,1982,25,1957,0.012613521695257316,-5.159740388153097
ZCTA5 62082,994,4,990,0.004024144869215292,-5.159981486369261
ZCTA5 21520,885,2,883,0.0022598870056497176,-5.160727112078107
ZCTA5 17059,3178,54,3124,0.016991818753933293,-5.161002278363076
ZCTA5 75639,1150,7,1143,0.00608695652173913,-5.16111940293838
ZCTA5 77523,6874,153,6721,0.022257782950247308,-5.16236719561629
ZCTA5 52151,770,0,770,0,-5.1624968476383515
ZCTA5 23420,1048,5,1043,0.004770992366412214,-5.163833760547163
ZCTA5 40057,1443,13,1430,0.009009009009009009,-5.164052209145365
ZCTA5 72112,3455,61,3394,0.017655571635311142,-5.164257786098572
ZCTA5 48027,1251,9,1242,0.007194244604316547,-5.165193578127827
ZCTA5 25517,771,0,771,0,-5.165848030625244
ZCTA5 70669,3728,68,3660,0.018240343347639486,-5.165850432634847
ZCTA5 49090,6045,130,5915,0.021505376344086023,-5.166402589554253
ZCTA5 95467,2284,32,2252,0.014010507880910683,-5.167625528437086
ZCTA5 04274,2368,34,2334,0.014358108108108109,-5.167727616514764
ZCTA5 18853,1675,18,1657,0.010746268656716417,-5.168316118734623
ZCTA5 57442,772,0,772,0,-5.169197041045496
ZCTA5 14886,2982,49,2933,0.01643192488262911,-5.169348732469726
ZCTA5 03585,1050,5,1045,0.004761904761904762,-5.170396331939258
ZCTA5 37062,4076,77,3999,0.018891069676153092,-5.170546434160463
ZCTA5 87506,5682,120,5562,0.021119324181626188,-5.17071119255815
ZCTA5 05667,888,2,886,0.0022522522522522522,-5.17073192292176
ZCTA5 46044,1153,7,1146,0.006071118820468344,-5.170837593173921
ZCTA5 56367,2411,35,2376,0.014516798009124844,-5.17110412104453
ZCTA5 47165,2453,36,2417,0.014675907052588666,-5.172126909075118
ZCTA5 11976,773,0,773,0,-5.172543883119051
ZCTA5 16421,998,4,994,0.004008016032064128,-5.173186872796569
ZCTA5 29054,3459,61,3398,0.017635154668979473,-5.1739241035362165
ZCTA5 19061,7702,176,7526,0.022851207478576992,-5.17482158422732
ZCTA5 19141,12666,319,12347,0.02518553608084636,-5.1751247298908005
ZCTA5 80014,17923,475,17448,0.0265022596663505,-5.175801578959725
ZCTA5 16878,774,0,774,0,-5.17588856105221
ZCTA5 95245,774,0,774,0,-5.17588856105221
ZCTA5 02642,2371,34,2337,0.01433994095318431,-5.175919498487408
ZCTA5 44680,1812,21,1791,0.011589403973509934,-5.1759331010621
ZCTA5 39846,775,0,775,0,-5.17923107903769
ZCTA5 12575,775,0,775,0,-5.17923107903769
ZCTA5 53044,946,3,943,0.003171247357293869,-5.179736183496423
ZCTA5 07838,1206,8,1198,0.006633499170812604,-5.17973715578894
ZCTA5 73105,2744,43,2701,0.01567055393586006,-5.1805660163519995
ZCTA5 98684,10715,262,10453,0.024451703219785348,-5.182324343543814
ZCTA5 69140,776,0,776,0,-5.182571441254689
ZCTA5 53076,1354,11,1343,0.00812407680945347,-5.183351103618521
ZCTA5 16630,1903,23,1880,0.01208617971623752,-5.183795158625745
ZCTA5 48363,2077,27,2050,0.012999518536350506,-5.184121411397411
ZCTA5 45162,1002,4,998,0.003992015968063872,-5.186360171827936
ZCTA5 35462,1771,20,1751,0.01129305477131564,-5.186395058892433
ZCTA5 78641,20060,539,19521,0.026869391824526422,-5.1865073110032
ZCTA5 39423,1055,5,1050,0.004739336492890996,-5.186768680561434
ZCTA5 46214,9782,235,9547,0.024023717031281946,-5.186963409371502
ZCTA5 56209,893,2,891,0.0022396416573348264,-5.187364407079191
ZCTA5 27306,2706,42,2664,0.015521064301552107,-5.187814914097449
ZCTA5 42717,2747,43,2704,0.015653440116490717,-5.18838533383837
ZCTA5 77478,9295,221,9074,0.023776223776223775,-5.188891740302762
ZCTA5 53910,1498,14,1484,0.009345794392523364,-5.189056895651069
ZCTA5 13327,778,0,778,0,-5.189245715032803
ZCTA5 56265,3230,55,3175,0.017027863777089782,-5.191662131077962
ZCTA5 08202,779,0,779,0,-5.1925796348852575
ZCTA5 28785,3151,53,3098,0.01682005712472231,-5.192650166945269
ZCTA5 17264,950,3,947,0.003157894736842105,-5.192964162066109
ZCTA5 12790,1592,16,1576,0.010050251256281407,-5.1930766528152175
ZCTA5 25320,2585,39,2546,0.015087040618955513,-5.193218344477716
ZCTA5 60411,19502,522,18980,0.026766485488667828,-5.193781242737843
ZCTA5 93453,1309,10,1299,0.007639419404125287,-5.194003513619357
ZCTA5 07506,6963,155,6808,0.022260519890851645,-5.19440910573227
ZCTA5 67864,780,0,780,0,-5.195911415552032
ZCTA5 72386,780,0,780,0,-5.195911415552032
ZCTA5 14481,780,0,780,0,-5.195911415552032
ZCTA5 56304,6928,154,6774,0.022228637413394918,-5.1960953469462465
ZCTA5 46938,1212,8,1204,0.006600660066006601,-5.198963871780321
ZCTA5 61957,781,0,781,0,-5.199241061145628
ZCTA5 17344,1548,15,1533,0.009689922480620155,-5.1996503771240405
ZCTA5 15063,4808,96,4712,0.019966722129783693,-5.200890509664342
ZCTA5 30263,22025,598,21427,0.027150964812712827,-5.202211658405759
ZCTA5 07021,782,0,782,0,-5.2025685757653894
ZCTA5 15928,782,0,782,0,-5.2025685757653894
ZCTA5 82401,3155,53,3102,0.016798732171156894,-5.202606172287196
ZCTA5 49328,1456,13,1443,0.008928571428571428,-5.204330343354152
ZCTA5 72635,1456,13,1443,0.008928571428571428,-5.204330343354152
ZCTA5 04087,783,0,783,0,-5.205893963497558
ZCTA5 15479,783,0,783,0,-5.205893963497558
ZCTA5 58220,954,3,951,0.0031446540880503146,-5.206159528380911
ZCTA5 66103,6102,131,5971,0.02146837102589315,-5.206778628403743
ZCTA5 28423,899,2,897,0.002224694104560623,-5.207254362158332
ZCTA5 44215,899,2,897,0.002224694104560623,-5.207254362158332
ZCTA5 67207,11283,278,11005,0.024638837188690952,-5.207365528205911
ZCTA5 47327,1823,21,1802,0.01151947339550192,-5.208224359279766
ZCTA5 52356,955,3,952,0.0031413612565445027,-5.209453301881093
ZCTA5 32669,4662,92,4570,0.019734019734019732,-5.209675364388668
ZCTA5 62558,1314,10,1304,0.0076103500761035,-5.209773827591638
ZCTA5 50144,1114,6,1108,0.005385996409335727,-5.209800874482659
ZCTA5 29431,2467,36,2431,0.014592622618565058,-5.209869776965201
ZCTA5 43011,2878,46,2832,0.015983321751216122,-5.212241215672067
ZCTA5 32358,785,0,785,0,-5.2125383745789255
ZCTA5 35610,785,0,785,0,-5.2125383745789255
ZCTA5 27820,1010,4,1006,0.0039603960396039604,-5.212611407586335
ZCTA5 92656,19252,514,18738,0.026698524828589237,-5.2128233247838685
ZCTA5 32054,3476,61,3415,0.017548906789413118,-5.214900882178808
ZCTA5 44255,3000,49,2951,0.01633333333333333,-5.214957478074318
ZCTA5 35136,786,0,786,0,-5.215857406035628
ZCTA5 13625,786,0,786,0,-5.215857406035628
ZCTA5 24747,1064,5,1059,0.004699248120300752,-5.216117330644579
ZCTA5 35131,1507,14,1493,0.0092899800928998,-5.2166709025131945
ZCTA5 44286,2386,34,2352,0.014249790444258172,-5.21675501500857
ZCTA5 53007,902,2,900,0.0022172949002217295,-5.217171346128741
ZCTA5 54622,902,2,900,0.0022172949002217295,-5.217171346128741
ZCTA5 39571,5263,108,5155,0.020520615618468553,-5.217955731906692
ZCTA5 77077,26605,737,25868,0.027701559857169704,-5.218139824344614
ZCTA5 64735,5669,119,5550,0.020991356500264596,-5.218374424272818
ZCTA5 47006,4591,90,4501,0.01960357220649096,-5.219006043816103
ZCTA5 78727,13242,335,12907,0.0252982933091678,-5.21933070698425
ZCTA5 64477,1508,14,1494,0.009283819628647215,-5.219731813408009
ZCTA5 44905,4742,94,4648,0.01982285955293125,-5.220162938978138
ZCTA5 30126,15174,392,14782,0.025833662844339002,-5.2203735984600605
ZCTA5 28754,3635,65,3570,0.017881705639614855,-5.221255112091668
ZCTA5 75166,1318,10,1308,0.007587253414264037,-5.222360492511792
ZCTA5 35744,788,0,788,0,-5.222489140953221
ZCTA5 45174,788,0,788,0,-5.222489140953221
ZCTA5 04732,788,0,788,0,-5.222489140953221
ZCTA5 22922,788,0,788,0,-5.222489140953221
ZCTA5 26060,788,0,788,0,-5.222489140953221
ZCTA5 11514,1648,17,1631,0.010315533980582525,-5.223733289092102
ZCTA5 31519,1367,11,1356,0.008046817849305048,-5.224060140367103
ZCTA5 48189,5525,115,5410,0.02081447963800905,-5.224785313479025
ZCTA5 30516,789,0,789,0,-5.2258018524445715
ZCTA5 42266,789,0,789,0,-5.2258018524445715
ZCTA5 23123,789,0,789,0,-5.2258018524445715
ZCTA5 10803,3947,73,3874,0.018495059538890298,-5.2264257309852375
ZCTA5 43502,2515,37,2478,0.014711729622266401,-5.227091694844163
ZCTA5 39701,5119,104,5015,0.020316468060168003,-5.227303784307458
ZCTA5 19529,1320,10,1310,0.007575757575757576,-5.228644015152628
ZCTA5 20135,1320,10,1310,0.007575757575757576,-5.228644015152628
ZCTA5 35978,1830,21,1809,0.011475409836065573,-5.22869669440454
ZCTA5 28685,790,0,790,0,-5.229112465290062
ZCTA5 13224,3600,64,3536,0.017777777777777778,-5.230734983598928
ZCTA5 75503,9600,229,9371,0.023854166666666666,-5.230867717924547
ZCTA5 28681,9426,224,9202,0.02376405686399321,-5.23189800650385
ZCTA5 55043,1465,13,1452,0.008873720136518772,-5.232065696512518
ZCTA5 22645,1605,16,1589,0.009968847352024923,-5.232372615665723
ZCTA5 45812,791,0,791,0,-5.232420983473205
ZCTA5 68955,791,0,791,0,-5.232420983473205
ZCTA5 14171,791,0,791,0,-5.232420983473205
ZCTA5 19951,791,0,791,0,-5.232420983473205
ZCTA5 02054,3007,49,2958,0.016295310941137345,-5.232633011367853
ZCTA5 56431,4218,80,4138,0.01896633475580844,-5.232657535770005
ZCTA5 97439,6912,153,6759,0.022135416666666668,-5.233191800262178
ZCTA5 95946,3950,73,3877,0.01848101265822785,-5.233321129745276
ZCTA5 03249,3048,50,2998,0.016404199475065617,-5.234754059798671
ZCTA5 67467,1070,5,1065,0.004672897196261682,-5.2355972325647855
ZCTA5 47987,1652,17,1635,0.010290556900726392,-5.235714525574724
ZCTA5 35135,792,0,792,0,-5.235727410964928
ZCTA5 61256,792,0,792,0,-5.235727410964928
ZCTA5 66013,792,0,792,0,-5.235727410964928
ZCTA5 01611,792,0,792,0,-5.235727410964928
ZCTA5 04553,792,0,792,0,-5.235727410964928
ZCTA5 13402,792,0,792,0,-5.235727410964928
ZCTA5 30559,1965,24,1941,0.012213740458015267,-5.236117000784234
ZCTA5 28382,2847,45,2802,0.015806111696522657,-5.236676712480904
ZCTA5 65550,1224,8,1216,0.006535947712418301,-5.237228367754878
ZCTA5 32907,14883,383,14500,0.0257340589934825,-5.237649074643781
ZCTA5 10913,1607,16,1591,0.009956440572495333,-5.2383975056765895
ZCTA5 06063,1174,7,1167,0.00596252129471891,-5.238406963396922
ZCTA5 99111,1744,19,1725,0.010894495412844037,-5.239269591271718
ZCTA5 27831,1372,11,1361,0.008017492711370262,-5.239645900113649
ZCTA5 04062,6555,143,6412,0.02181540808543097,-5.240337285158227
ZCTA5 75182,1834,21,1813,0.011450381679389313,-5.24036862111937
ZCTA5 68059,1225,8,1217,0.006530612244897959,-5.240405814875159
ZCTA5 53549,4069,76,3993,0.01867780781518801,-5.241756616158489
ZCTA5 91750,11856,294,11562,0.02479757085020243,-5.24183723201997
ZCTA5 55054,794,0,794,0,-5.242334009695215
ZCTA5 29907,5089,103,4986,0.020239732756926705,-5.242406016628223
ZCTA5 26444,1373,11,1362,0.008011653313911144,-5.242758323566001
ZCTA5 35094,5571,116,5455,0.02082211452162987,-5.24332139417894
ZCTA5 87116,1226,8,1218,0.0065252854812398045,-5.243581541900165
ZCTA5 74017,11238,276,10962,0.024559530165509876,-5.243724940936798
ZCTA5 32744,1516,14,1502,0.009234828496042216,-5.24416686157794
ZCTA5 29172,3645,65,3580,0.01783264746227709,-5.244903225701608
ZCTA5 21631,1020,4,1016,0.00392156862745098,-5.245248925319878
ZCTA5 29129,1125,6,1119,0.005333333333333333,-5.245282361783408
ZCTA5 35752,966,3,963,0.003105590062111801,-5.245552288863035
ZCTA5 20762,795,0,795,0,-5.2456341888132
ZCTA5 25275,795,0,795,0,-5.2456341888132
ZCTA5 75969,1374,11,1363,0.008005822416302766,-5.245869175990815
ZCTA5 76904,14077,359,13718,0.025502592882006108,-5.246574109930042
ZCTA5 55042,3292,56,3236,0.01701093560145808,-5.246653749402835
ZCTA5 31501,6123,131,5992,0.02139474113996407,-5.247770992171355
ZCTA5 32577,1747,19,1728,0.010875787063537493,-5.248122463583409
ZCTA5 38469,1564,15,1549,0.00959079283887468,-5.248254310127147
ZCTA5 51046,796,0,796,0,-5.2489322929987114
ZCTA5 94502,5018,101,4917,0.020127540852929456,-5.249904146495724
ZCTA5 32759,1228,8,1220,0.006514657980456026,-5.249927846144516
ZCTA5 71103,2482,36,2446,0.014504431909750202,-5.2501180207300795
ZCTA5 43942,1127,6,1121,0.005323868677905945,-5.251709737621413
ZCTA5 12966,1075,5,1070,0.004651162790697674,-5.251778597677395
ZCTA5 93271,1075,5,1070,0.004651162790697674,-5.251778597677395
ZCTA5 28582,797,0,797,0,-5.252228326160574
ZCTA5 85629,8384,194,8190,0.023139312977099237,-5.252370283683253
ZCTA5 08735,2015,25,1990,0.01240694789081886,-5.254084994659904
ZCTA5 31637,1128,6,1122,0.005319148936170213,-5.25492069971952
ZCTA5 42027,798,0,798,0,-5.255522292195354
ZCTA5 04441,798,0,798,0,-5.255522292195354
ZCTA5 15148,1230,8,1222,0.0065040650406504065,-5.256267301384476
ZCTA5 17777,3017,49,2968,0.016241299303944315,-5.257824802908497
ZCTA5 68832,799,0,799,0,-5.258814194987413
ZCTA5 35565,5321,109,5212,0.02048487126479985,-5.261128724518175
ZCTA5 32346,800,0,800,0,-5.262104038408963
ZCTA5 44214,800,0,800,0,-5.262104038408963
ZCTA5 48846,6240,134,6106,0.021474358974358974,-5.2626960298275245
ZCTA5 46075,2445,35,2410,0.014314928425357873,-5.26294829907764
ZCTA5 30311,14361,367,13994,0.025555323445442518,-5.264092698643029
ZCTA5 30634,801,0,801,0,-5.265391826320118
ZCTA5 83316,3964,73,3891,0.018415741675075682,-5.265440529918562
ZCTA5 76527,1233,8,1225,0.006488240064882401,-5.26576368782244
ZCTA5 76033,9831,235,9596,0.023903977214932356,-5.265962261174947
ZCTA5 29334,4914,98,4816,0.019943019943019943,-5.267148845209486
ZCTA5 98275,8287,191,8096,0.023048147701218775,-5.268049907115518
ZCTA5 26149,802,0,802,0,-5.268677562568952
ZCTA5 77856,2064,26,2038,0.012596899224806201,-5.269593628786477
ZCTA5 45325,974,3,971,0.003080082135523614,-5.271655301329554
ZCTA5 62458,803,0,803,0,-5.271961250991542
ZCTA5 16920,803,0,803,0,-5.271961250991542
ZCTA5 92835,8502,197,8305,0.02317101858386262,-5.272945463584784
ZCTA5 21773,1978,24,1954,0.012133468149646108,-5.2732626637144175
ZCTA5 69337,2780,43,2737,0.015467625899280576,-5.273940041834321
ZCTA5 97380,1082,5,1077,0.0046210720887245845,-5.274354055427295
ZCTA5 28615,804,0,804,0,-5.275242895412031
ZCTA5 37892,804,0,804,0,-5.275242895412031
ZCTA5 54960,1186,7,1179,0.005902192242833052,-5.276664985343116
ZCTA5 34105,7688,174,7514,0.02263267429760666,-5.276674568346365
ZCTA5 55319,1891,22,1869,0.011634056054997356,-5.276761985037371
ZCTA5 12305,2196,29,2167,0.013205828779599272,-5.276797983207096
ZCTA5 17529,1384,11,1373,0.007947976878612716,-5.276891773637844
ZCTA5 05257,976,3,973,0.0030737704918032786,-5.278161458140856
ZCTA5 27928,805,0,805,0,-5.278522499642671
ZCTA5 33782,9455,224,9231,0.023691168693812797,-5.279354086432093
ZCTA5 81226,2493,36,2457,0.01444043321299639,-5.279509510489738
ZCTA5 50261,921,2,919,0.0021715526601520088,-5.279552906109034
ZCTA5 24574,1481,13,1468,0.008777852802160702,-5.281075997728709
ZCTA5 36319,806,0,806,0,-5.2818000674838785
ZCTA5 13156,806,0,806,0,-5.2818000674838785
ZCTA5 19973,9527,226,9301,0.02372205311220741,-5.282653037260789
ZCTA5 18232,1668,17,1651,0.010191846522781775,-5.283427379659175
ZCTA5 38345,807,0,807,0,-5.285075602724288
ZCTA5 38368,807,0,807,0,-5.285075602724288
ZCTA5 62044,807,0,807,0,-5.285075602724288
ZCTA5 27950,807,0,807,0,-5.285075602724288
ZCTA5 75410,2113,27,2086,0.012778040700425935,-5.285472310045534
ZCTA5 44836,923,2,921,0.0021668472372697724,-5.286077202818894
ZCTA5 95321,1669,17,1652,0.01018573996405033,-5.286398259360648
ZCTA5 13634,1530,14,1516,0.009150326797385621,-5.28670692353241
ZCTA5 03576,1339,10,1329,0.0074682598954443615,-5.2880151861590114
ZCTA5 55128,11612,286,11326,0.02462969342059938,-5.288220080169956
ZCTA5 82443,2158,28,2130,0.012974976830398516,-5.290581302192664
ZCTA5 58356,809,0,809,0,-5.291620590498634
ZCTA5 63060,809,0,809,0,-5.291620590498634
ZCTA5 67203,12610,315,12295,0.02498017446471055,-5.291916563955055
ZCTA5 07014,1807,20,1787,0.011068068622025456,-5.29202916753024
ZCTA5 87068,1852,21,1831,0.011339092872570195,-5.292655847215124
ZCTA5 23606,11237,275,10962,0.02447272403666459,-5.294664378966109
ZCTA5 32403,810,0,810,0,-5.294890050551372
ZCTA5 48097,2030,25,2005,0.012315270935960592,-5.2965754297471515
ZCTA5 75459,1898,22,1876,0.011591148577449948,-5.29691504981452
ZCTA5 54767,1342,10,1332,0.007451564828614009,-5.297336876522374
ZCTA5 74107,8056,184,7872,0.022840119165839126,-5.297943057106412
ZCTA5 52655,1764,19,1745,0.010770975056689343,-5.298075978848405
ZCTA5 37219,811,0,811,0,-5.29815749304102
ZCTA5 59442,811,0,811,0,-5.29815749304102
ZCTA5 81527,811,0,811,0,-5.29815749304102
ZCTA5 03774,811,0,811,0,-5.29815749304102
ZCTA5 27860,811,0,811,0,-5.29815749304102
ZCTA5 50201,3353,57,3296,0.016999701759618253,-5.298657769244524
ZCTA5 14807,1193,7,1186,0.00586756077116513,-5.2988660531163045
ZCTA5 95947,812,0,812,0,-5.301422921698052
ZCTA5 04953,1392,11,1381,0.007902298850574713,-5.301598349852738
ZCTA5 27401,7094,157,6937,0.022131378629828023,-5.303533154658436
ZCTA5 54129,1245,8,1237,0.00642570281124498,-5.303596986216856
ZCTA5 50669,984,3,981,0.003048780487804878,-5.304108523696209
ZCTA5 16858,1393,11,1382,0.007896625987078248,-5.304679763827259
ZCTA5 50630,813,0,813,0,-5.3046863402414575
ZCTA5 43135,1721,18,1703,0.010459035444509006,-5.305068992625569
ZCTA5 48065,4174,78,4096,0.018687110685194058,-5.305614881345254
ZCTA5 47338,1092,5,1087,0.004578754578754579,-5.306447855534575
ZCTA5 33548,2545,37,2508,0.014538310412573674,-5.306827170898927
ZCTA5 14111,1296,9,1287,0.006944444444444444,-5.307282188508189
ZCTA5 02827,814,0,814,0,-5.307947752378795
ZCTA5 60098,12313,306,12007,0.024851782668724114,-5.308454341418717
ZCTA5 43137,930,2,928,0.002150537634408602,-5.308850028223633
ZCTA5 50240,1145,6,1139,0.005240174672489083,-5.30923198569439
ZCTA5 55357,1145,6,1139,0.005240174672489083,-5.30923198569439
ZCTA5 46048,815,0,815,0,-5.311207161806241
ZCTA5 78645,4634,90,4544,0.019421665947345707,-5.312253534971393
ZCTA5 03865,3039,49,2990,0.016123724909509706,-5.31300472938437
ZCTA5 54817,1041,4,1037,0.0038424591738712775,-5.3131634382762085
ZCTA5 50647,816,0,816,0,-5.314464572208635
ZCTA5 69334,816,0,816,0,-5.314464572208635
ZCTA5 53959,5310,108,5202,0.020338983050847456,-5.314807277780151
ZCTA5 01564,2755,42,2713,0.015245009074410164,-5.315153061345942
ZCTA5 17545,8208,188,8020,0.02290448343079922,-5.31526160953602
ZCTA5 60551,1540,14,1526,0.00909090909090909,-5.316922601769563
ZCTA5 58552,817,0,817,0,-5.31771998725953
ZCTA5 83805,3202,53,3149,0.01655215490318551,-5.318808269070433
ZCTA5 30506,15383,396,14987,0.0257427029838133,-5.318940615128646
ZCTA5 45409,2920,46,2874,0.015753424657534248,-5.319221482720106
ZCTA5 32709,818,0,818,0,-5.320973410621248
ZCTA5 20675,818,0,818,0,-5.320973410621248
ZCTA5 50109,1200,7,1193,0.005833333333333334,-5.320982709683968
ZCTA5 47977,934,2,932,0.0021413276231263384,-5.32181995709849
ZCTA5 14204,4066,75,3991,0.018445646827348745,-5.32214975608365
ZCTA5 46356,6308,135,6173,0.02140139505389981,-5.323520075629426
ZCTA5 30710,2593,38,2555,0.014654839953721558,-5.323639164144423
ZCTA5 30079,1201,7,1194,0.005828476269775187,-5.324135394353192
ZCTA5 34269,1863,21,1842,0.011272141706924315,-5.324420945582393
ZCTA5 44272,1952,23,1929,0.0117827868852459,-5.324652549917976
ZCTA5 17082,1252,8,1244,0.006389776357827476,-5.32555515074681
ZCTA5 22625,1302,9,1293,0.0069124423963133645,-5.325975024356343
ZCTA5 84317,820,0,820,0,-5.327474296870507
ZCTA5 21911,3875,70,3805,0.01806451612903226,-5.327581377837661
ZCTA5 28501,7896,179,7717,0.022669706180344477,-5.329279162643869
ZCTA5 38221,1353,10,1343,0.007390983000739098,-5.331395337769928
ZCTA5 50265,13391,337,13054,0.02516615637368382,-5.3336469707616985
ZCTA5 69022,822,0,822,0,-5.333967260032021
ZCTA5 23883,822,0,822,0,-5.333967260032021
ZCTA5 45850,1255,8,1247,0.006374501992031873,-5.334940970820703
ZCTA5 80917,12880,322,12558,0.025,-5.335758091571812
ZCTA5 65633,1452,12,1440,0.008264462809917356,-5.3379062597400395
ZCTA5 43061,1594,15,1579,0.009410288582183186,-5.338427100090925
ZCTA5 46126,2001,24,1977,0.01199400299850075,-5.338526400209917
ZCTA5 56164,2389,33,2356,0.01381331100879029,-5.338674645169187
ZCTA5 55080,995,3,992,0.003015075376884422,-5.339585567259102
ZCTA5 32565,2089,26,2063,0.01244614648157013,-5.33972883028296
ZCTA5 28455,824,0,824,0,-5.340452329004642
ZCTA5 50636,824,0,824,0,-5.340452329004642
ZCTA5 32134,3050,49,3001,0.016065573770491802,-5.340471133182257
ZCTA5 44626,1155,6,1149,0.005194805194805195,-5.34094068364476
ZCTA5 61537,1155,6,1149,0.005194805194805195,-5.34094068364476
ZCTA5 33156,10991,267,10724,0.024292603038849968,-5.3414021014451505
ZCTA5 28163,1958,23,1935,0.01174668028600613,-5.341714623317963
ZCTA5 37145,825,0,825,0,-5.343691912153049
ZCTA5 45657,825,0,825,0,-5.343691912153049
ZCTA5 10577,825,0,825,0,-5.343691912153049
ZCTA5 48160,4497,86,4411,0.01912386035134534,-5.344198374480722
ZCTA5 29448,826,0,826,0,-5.346929532511973
ZCTA5 02630,826,0,826,0,-5.346929532511973
ZCTA5 12185,826,0,826,0,-5.346929532511973
ZCTA5 14543,1259,8,1251,0.006354249404289118,-5.3474323908889305
ZCTA5 32567,1309,9,1300,0.006875477463712758,-5.347710399576923
ZCTA5 97477,15811,408,15403,0.0258048194295111,-5.34899124346279
ZCTA5 96825,10406,250,10156,0.02402460119162022,-5.3493442427495195
ZCTA5 10918,3885,70,3815,0.018018018018018018,-5.350568609387572
ZCTA5 32310,5662,117,5545,0.02066407629812787,-5.352103464128482
ZCTA5 43103,3847,69,3778,0.017936054068105018,-5.352608177289567
ZCTA5 35481,1457,12,1445,0.008236101578586136,-5.353109269485649
ZCTA5 13843,828,0,828,0,-5.3533988991038495
ZCTA5 15438,828,0,828,0,-5.3533988991038495
ZCTA5 21794,828,0,828,0,-5.3533988991038495
ZCTA5 25621,828,0,828,0,-5.3533988991038495
ZCTA5 78215,1783,19,1764,0.01065619742007852,-5.353484597088736
ZCTA5 11935,1261,8,1253,0.006344171292624901,-5.353668284676853
ZCTA5 99505,1107,5,1102,0.004516711833785004,-5.35424856747037
ZCTA5 08805,4119,76,4043,0.018451080359310514,-5.354785076335671
ZCTA5 15322,829,0,829,0,-5.356630652431163
ZCTA5 20818,829,0,829,0,-5.356630652431163
ZCTA5 27205,13100,328,12772,0.025038167938931297,-5.356840594036946
ZCTA5 71949,830,0,830,0,-5.359860457157808
ZCTA5 26147,830,0,830,0,-5.359860457157808
ZCTA5 49026,946,2,944,0.0021141649048625794,-5.360544157186804
ZCTA5 62938,1109,5,1104,0.004508566275924256,-5.360591619826001
ZCTA5 75156,6546,141,6405,0.02153987167736022,-5.360712428757659
ZCTA5 39475,4996,99,4897,0.019815852682145717,-5.36089967438446
ZCTA5 14059,4199,78,4121,0.018575851393188854,-5.361573393991263
ZCTA5 61047,831,0,831,0,-5.363088316804292
ZCTA5 62960,4582,88,4494,0.01920558707987778,-5.363703746536275
ZCTA5 38358,4506,86,4420,0.01908566355969818,-5.36380235202028
ZCTA5 67663,1057,4,1053,0.003784295175023652,-5.364355072011074
ZCTA5 07852,1556,14,1542,0.008997429305912597,-5.364977829665579
ZCTA5 36441,1509,13,1496,0.008614976805831677,-5.365950226420724
ZCTA5 36051,832,0,832,0,-5.366314234880539
ZCTA5 47631,832,0,832,0,-5.366314234880539
ZCTA5 20677,832,0,832,0,-5.366314234880539
ZCTA5 66052,1004,3,1001,0.00298804780876494,-5.368442606048119
ZCTA5 46516,11666,286,11380,0.024515686610663466,-5.368980494605958
ZCTA5 03244,3021,48,2973,0.015888778550148957,-5.369060583042239
ZCTA5 35171,1316,9,1307,0.006838905775075988,-5.369367982288524
ZCTA5 38374,833,0,833,0,-5.369538214885923
ZCTA5 68767,1366,10,1356,0.007320644216691069,-5.371404044118143
ZCTA5 33542,9792,232,9560,0.02369281045751634,-5.3717116212261
ZCTA5 03048,1415,11,1404,0.0077738515901060075,-5.372087940572031
ZCTA5 52132,834,0,834,0,-5.372760260309323
ZCTA5 59323,834,0,834,0,-5.372760260309323
ZCTA5 12816,1969,23,1946,0.011681056373793804,-5.372892200310751
ZCTA5 52159,1006,3,1003,0.002982107355864811,-5.3748348081726105
ZCTA5 47136,1653,16,1637,0.009679370840895343,-5.375487798866546
ZCTA5 42553,2102,26,2076,0.012369172216936251,-5.375943518772347
ZCTA5 07439,835,0,835,0,-5.375980374629162
ZCTA5 12057,835,0,835,0,-5.375980374629162
ZCTA5 24571,835,0,835,0,-5.375980374629162
ZCTA5 81652,1791,19,1772,0.01060859854829704,-5.376683526593141
ZCTA5 47368,1218,7,1211,0.005747126436781609,-5.377472805286598
ZCTA5 68763,2015,24,1991,0.011910669975186104,-5.37797196205111
ZCTA5 12198,2984,47,2937,0.015750670241286863,-5.378035104339996
ZCTA5 54484,1971,23,1948,0.011669203450025367,-5.378546637624243
ZCTA5 12075,1115,5,1110,0.004484304932735426,-5.37957842241536
ZCTA5 29307,8103,184,7919,0.02270763914599531,-5.3796938758482975
ZCTA5 43844,1466,12,1454,0.008185538881309686,-5.380383246592613
ZCTA5 61846,2060,25,2035,0.012135922330097087,-5.380837509680981
ZCTA5 43466,837,0,837,0,-5.382414823819834
ZCTA5 72029,837,0,837,0,-5.382414823819834
ZCTA5 04786,837,0,837,0,-5.382414823819834
ZCTA5 46065,1220,7,1213,0.005737704918032787,-5.383716050992084
ZCTA5 30314,7282,161,7121,0.02210931062894809,-5.383821333676251
ZCTA5 06782,838,0,838,0,-5.385629165595632
ZCTA5 53521,1468,12,1456,0.008174386920980926,-5.386428276414396
ZCTA5 41522,2193,28,2165,0.012767897856817145,-5.387240486653652
ZCTA5 61616,2659,39,2620,0.014667168108311396,-5.387429864420385
ZCTA5 71901,11402,278,11124,0.024381687423259076,-5.387454395928945
ZCTA5 67654,1322,9,1313,0.00680786686838124,-5.387870297011118
ZCTA5 02451,7500,167,7333,0.022266666666666667,-5.388030396001577
ZCTA5 24472,839,0,839,0,-5.388841590077881
ZCTA5 68152,2366,32,2334,0.013524936601859678,-5.390919416082273
ZCTA5 02891,9102,212,8890,0.023291584267194024,-5.391867065521189
ZCTA5 87935,840,0,840,0,-5.392052100693381
ZCTA5 02804,840,0,840,0,-5.392052100693381
ZCTA5 21851,2785,42,2743,0.015080789946140035,-5.392208556216423
ZCTA5 24064,1887,21,1866,0.011128775834658187,-5.393240365087205
ZCTA5 11771,3669,64,3605,0.01744344508040338,-5.393245025304332
ZCTA5 13204,7897,178,7719,0.022540205141192857,-5.393614776294865
ZCTA5 28127,2827,43,2784,0.015210470463388751,-5.394371492214267
ZCTA5 23868,2065,25,2040,0.012106537530266344,-5.394789540173275
ZCTA5 54110,2021,24,1997,0.011875309252845126,-5.394813225309958
ZCTA5 43145,841,0,841,0,-5.395260700858736
ZCTA5 82513,841,0,841,0,-5.395260700858736
ZCTA5 01034,841,0,841,0,-5.395260700858736
ZCTA5 69033,1120,5,1115,0.004464285714285714,-5.3953525632006425
ZCTA5 43920,9210,215,8995,0.023344191096634093,-5.3956854072372815
ZCTA5 13439,1519,13,1506,0.008558262014483212,-5.395993136950126
ZCTA5 00923,10087,240,9847,0.023793000892237532,-5.396067935748772
ZCTA5 55934,1224,7,1217,0.005718954248366013,-5.396182725411121
ZCTA5 86301,9843,233,9610,0.0236716448237326,-5.397360009172638
ZCTA5 05676,2022,24,1998,0.011869436201780416,-5.397616396580948
ZCTA5 29038,842,0,842,0,-5.398467393980397
ZCTA5 68729,842,0,842,0,-5.398467393980397
ZCTA5 28773,1326,9,1317,0.006787330316742082,-5.400173976635885
ZCTA5 31303,843,0,843,0,-5.4016721834547035
ZCTA5 04928,843,0,843,0,-5.4016721834547035
ZCTA5 15333,843,0,843,0,-5.4016721834547035
ZCTA5 20688,843,0,843,0,-5.4016721834547035
ZCTA5 16115,1226,7,1219,0.005709624796084829,-5.4024061938166055
ZCTA5 73089,4256,79,4177,0.01856203007518797,-5.402855832545586
ZCTA5 86001,17469,456,17013,0.02610338313584063,-5.403008968617358
ZCTA5 20640,3634,63,3571,0.017336268574573474,-5.403389098497699
ZCTA5 14210,6057,127,5930,0.020967475648010565,-5.4043339212813155
ZCTA5 43125,5541,113,5428,0.020393430788666306,-5.4066420620269096
ZCTA5 01612,1570,14,1556,0.008917197452229299,-5.406738373182176
ZCTA5 32257,15517,398,15119,0.02564928787781143,-5.406768700417182
ZCTA5 17582,845,0,845,0,-5.408076064996304
ZCTA5 89148,17641,461,17180,0.026132305424862536,-5.408180101094174
ZCTA5 71957,1329,9,1320,0.006772009029345372,-5.409385458504033
ZCTA5 45505,8263,188,8075,0.022752027108798256,-5.4101086740779465
ZCTA5 47403,14400,365,14035,0.025347222222222222,-5.410109056513608
ZCTA5 11360,8583,197,8386,0.02295234766398695,-5.410665079515017
ZCTA5 24328,846,0,846,0,-5.4112751638060965
ZCTA5 74434,3320,55,3265,0.016566265060240965,-5.411404587335295
ZCTA5 04254,1428,11,1417,0.007703081232492998,-5.411581272853226
ZCTA5 38462,3912,70,3842,0.01789366053169734,-5.412383946292925
ZCTA5 31542,1018,3,1015,0.0029469548133595285,-5.413033705522599
ZCTA5 17350,4946,97,4849,0.019611807521229277,-5.413808759789028
ZCTA5 67642,847,0,847,0,-5.414472372453617
ZCTA5 49034,1073,4,1069,0.003727865796831314,-5.415082597353142
ZCTA5 32666,2670,39,2631,0.014606741573033709,-5.415925843024865
ZCTA5 92545,14948,381,14567,0.02548835964677549,-5.416128763648646
ZCTA5 29712,848,0,848,0,-5.417667694285273
ZCTA5 30576,848,0,848,0,-5.417667694285273
ZCTA5 93110,6358,135,6223,0.021233092167348224,-5.4192069833769825
ZCTA5 36571,5249,105,5144,0.020003810249571347,-5.419233901782643
ZCTA5 43518,1020,3,1017,0.0029411764705882353,-5.419374699924013
ZCTA5 39153,1382,10,1372,0.00723589001447178,-5.42029196126284
ZCTA5 31558,8198,186,8012,0.022688460600146378,-5.420794678992985
ZCTA5 46745,849,0,849,0,-5.42086113263761
ZCTA5 18656,849,0,849,0,-5.42086113263761
ZCTA5 13214,2879,44,2835,0.01528308440430705,-5.422090353817295
ZCTA5 62548,1021,3,1018,0.002938295788442703,-5.422542489120968
ZCTA5 08049,2075,25,2050,0.012048192771084338,-5.4226161955692005
ZCTA5 37037,2673,39,2634,0.014590347923681257,-5.423681086889804
ZCTA5 20623,850,0,850,0,-5.4240526908373505
ZCTA5 26679,850,0,850,0,-5.4240526908373505
ZCTA5 01550,6943,151,6792,0.02174852369292813,-5.424192220017324
ZCTA5 75570,3205,52,3153,0.016224648985959437,-5.424408258194856
ZCTA5 49617,1284,8,1276,0.006230529595015576,-5.424917332668845
ZCTA5 16438,3165,51,3114,0.016113744075829384,-5.425150024524564
ZCTA5 66025,2674,39,2635,0.014584891548242334,-5.426264613579336
ZCTA5 36067,10351,247,10104,0.02386242875084533,-5.426944109998222
ZCTA5 24330,1234,7,1227,0.005672609400324149,-5.427234734030928
ZCTA5 36081,6180,130,6050,0.021035598705501618,-5.429149424787313
ZCTA5 34235,6473,138,6335,0.02131932643287502,-5.429414179659104
ZCTA5 32724,14210,359,13851,0.025263898662913443,-5.429535583596649
ZCTA5 50310,13186,329,12857,0.024950705293493098,-5.430247810668
ZCTA5 07640,1625,15,1610,0.009230769230769232,-5.430331809956511
ZCTA5 07065,11188,271,10917,0.024222381122631392,-5.430364394392202
ZCTA5 04346,852,0,852,0,-5.430430180037075
ZCTA5 35210,5961,124,5837,0.020801878879382653,-5.43243586961346
ZCTA5 49067,1719,17,1702,0.009889470622454915,-5.433309589030668
ZCTA5 30292,1765,18,1747,0.010198300283286119,-5.433373619217016
ZCTA5 33579,10390,248,10142,0.02386910490856593,-5.433373783386457
ZCTA5 24435,853,0,853,0,-5.433616117641759
ZCTA5 55353,1337,9,1328,0.006731488406881077,-5.433881678396367
ZCTA5 95383,1811,19,1792,0.010491441192711209,-5.434347049610784
ZCTA5 06277,1484,12,1472,0.008086253369272238,-5.434583401238342
ZCTA5 87552,1532,13,1519,0.008485639686684074,-5.434841587841275
ZCTA5 17009,854,0,854,0,-5.4368001883033275
ZCTA5 99109,2124,26,2098,0.01224105461393597,-5.436839122515551
ZCTA5 46539,970,2,968,0.002061855670103093,-5.437176691882209
ZCTA5 35049,1288,8,1280,0.006211180124223602,-5.4372225923668545
ZCTA5 20740,9517,223,9294,0.023431753703898286,-5.4373721478793815
ZCTA5 28444,913,1,912,0.001095290251916758,-5.437422489527793
ZCTA5 47946,855,0,855,0,-5.439982395299998
ZCTA5 60157,855,0,855,0,-5.439982395299998
ZCTA5 99216,11160,270,10890,0.024193548387096774,-5.440503641037958
ZCTA5 19362,2082,25,2057,0.012007684918347743,-5.442033883594387
ZCTA5 20751,856,0,856,0,-5.4431627419004025
ZCTA5 33810,17503,456,17047,0.02605267668399703,-5.445570701658392
ZCTA5 23124,1677,16,1661,0.009540846750149075,-5.445917453032529
ZCTA5 20678,4353,81,4272,0.018607856650585803,-5.447264012435915
ZCTA5 01432,3415,57,3358,0.016691068814055635,-5.447721829756204
ZCTA5 70542,1440,11,1429,0.007638888888888889,-5.447817956933781
ZCTA5 28789,2303,30,2273,0.013026487190620929,-5.451686943157652
ZCTA5 29058,1679,16,1663,0.009529481834425254,-5.451753633231613
ZCTA5 42325,859,0,859,0,-5.452692651867433
ZCTA5 45684,859,0,859,0,-5.452692651867433
ZCTA5 27962,3055,48,3007,0.015711947626841243,-5.453542665148158
ZCTA5 19057,6193,130,6063,0.020991441950589374,-5.454181309796979
ZCTA5 71360,12654,313,12341,0.02473526157736684,-5.454351611399513
ZCTA5 26070,3853,68,3785,0.017648585517778353,-5.4560129518096545
ZCTA5 15681,1865,20,1845,0.010723860589812333,-5.458953927476411
ZCTA5 57225,861,0,861,0,-5.459036682694732
ZCTA5 75851,861,0,861,0,-5.459036682694732
ZCTA5 67211,8006,180,7826,0.022483137646764927,-5.459106628290813
ZCTA5 65336,2306,30,2276,0.013009540329575022,-5.459762265548207
ZCTA5 17329,862,0,862,0,-5.462205935027121
ZCTA5 56442,1088,4,1084,0.003676470588235294,-5.4622288775394825
ZCTA5 17554,3018,47,2971,0.015573227302849569,-5.4627975216201214
ZCTA5 54114,2478,34,2444,0.013720742534301856,-5.46283481275704
ZCTA5 78154,13825,347,13478,0.025099457504520795,-5.463001899618239
ZCTA5 36069,863,0,863,0,-5.465373349578627
ZCTA5 60184,863,0,863,0,-5.465373349578627
ZCTA5 54603,6529,139,6390,0.021289630877622912,-5.466193155584731
ZCTA5 72447,864,0,864,0,-5.468538929542616
ZCTA5 16327,1196,6,1190,0.005016722408026756,-5.469159165934556
ZCTA5 24251,3344,55,3289,0.01644736842105263,-5.469164079680847
ZCTA5 85541,9784,230,9554,0.02350776778413737,-5.471304068648626
ZCTA5 36310,2566,36,2530,0.014029618082618862,-5.471976918335874
ZCTA5 23888,1037,3,1034,0.0028929604628736743,-5.472984165798232
ZCTA5 80106,1870,20,1850,0.0106951871657754,-5.473162126268498
ZCTA5 48881,2354,31,2323,0.013169073916737469,-5.473248220810509
ZCTA5 17866,3426,57,3369,0.016637478108581436,-5.4739325681163
ZCTA5 71765,866,0,866,0,-5.474864598435353
ZCTA5 18037,3064,48,3016,0.015665796344647518,-5.47577643660064
ZCTA5 16641,1038,3,1035,0.002890173410404624,-5.476121736598711
ZCTA5 28643,1498,12,1486,0.00801068090787717,-5.476424122038125
ZCTA5 98199,9717,228,9489,0.023464032108675516,-5.4765137317238315
ZCTA5 29568,5947,123,5824,0.02068269715823104,-5.477164682133024
ZCTA5 49088,1450,11,1439,0.007586206896551724,-5.477857286119405
ZCTA5 51028,867,0,867,0,-5.478024693704794
ZCTA5 20860,867,0,867,0,-5.478024693704794
ZCTA5 62233,2484,34,2450,0.013687600644122383,-5.4786301994197375
ZCTA5 37167,21274,568,20706,0.026699257309391745,-5.479142132438689
ZCTA5 30577,7659,170,7489,0.022196109152630893,-5.47918336562675
ZCTA5 15323,1781,18,1763,0.010106681639528355,-5.479447252999188
ZCTA5 71429,1252,7,1245,0.005591054313099041,-5.482722013014732
ZCTA5 01585,1874,20,1854,0.010672358591248666,-5.484508395688596
ZCTA5 35621,1253,7,1246,0.00558659217877095,-5.485789539183507
ZCTA5 66002,4715,90,4625,0.019088016967126194,-5.485887320583301
ZCTA5 38080,1149,5,1144,0.004351610095735422,-5.485996644534415
ZCTA5 80422,1965,22,1943,0.011195928753180661,-5.487023473790975
ZCTA5 49247,2273,29,2244,0.012758468983721953,-5.4871227026599785
ZCTA5 28125,870,0,870,0,-5.487494060657916
ZCTA5 31565,870,0,870,0,-5.487494060657916
ZCTA5 61284,870,0,870,0,-5.487494060657916
ZCTA5 71467,1645,15,1630,0.00911854103343465,-5.48896030188691
ZCTA5 27330,14322,361,13961,0.025205976818880045,-5.489439260771045
ZCTA5 48096,1598,14,1584,0.008760951188986232,-5.489472770192532
ZCTA5 35824,3750,65,3685,0.017333333333333333,-5.489951359790403
ZCTA5 43944,871,0,871,0,-5.490646887152251
ZCTA5 45724,871,0,871,0,-5.490646887152251
ZCTA5 25840,3473,58,3415,0.016700259141952202,-5.490776879102609
ZCTA5 46181,1739,17,1722,0.0097757331799885,-5.491202023456158
ZCTA5 55046,1831,19,1812,0.010376843255051884,-5.491542030569562
ZCTA5 37403,1356,9,1347,0.00663716814159292,-5.49167084806681
ZCTA5 28638,4756,91,4665,0.019133725820016823,-5.492157277358112
ZCTA5 83849,872,0,872,0,-5.493797904276558
ZCTA5 01376,2319,30,2289,0.0129366106080207,-5.494660965004251
ZCTA5 04032,3395,56,3339,0.016494845360824743,-5.495328037294094
ZCTA5 27127,15313,390,14923,0.02546855612877947,-5.495483533805908
ZCTA5 15419,1505,12,1493,0.007973421926910298,-5.497242858379255
ZCTA5 33972,4453,83,4370,0.018639119694587918,-5.497876139375475
ZCTA5 31744,1153,5,1148,0.004336513443191674,-5.498388261058509
ZCTA5 99207,12030,294,11736,0.024438902743142144,-5.4989325091484345
ZCTA5 55121,3675,63,3612,0.017142857142857144,-5.498988981653878
ZCTA5 71071,990,2,988,0.00202020202020202,-5.500232492802776
ZCTA5 08551,1789,18,1771,0.010061486864169928,-5.502370485071362
ZCTA5 50601,1101,4,1097,0.0036330608537693005,-5.502774988920966
ZCTA5 56264,875,0,875,0,-5.5032401305003855
ZCTA5 03830,875,0,875,0,-5.5032401305003855
ZCTA5 95521,8567,195,8372,0.02276176024279211,-5.503720203983275
ZCTA5 36420,4109,74,4035,0.018009247992212218,-5.505783992316871
ZCTA5 11509,876,0,876,0,-5.506383941171257
ZCTA5 55358,2017,23,1994,0.011403073872087258,-5.507415489638737
ZCTA5 56098,877,0,877,0,-5.509525957941164
ZCTA5 22601,11032,265,10767,0.024021029731689632,-5.509982499378861
ZCTA5 04915,3955,70,3885,0.017699115044247787,-5.510087569205433
ZCTA5 53520,2707,39,2668,0.014407092722571112,-5.511089046471505
ZCTA5 61483,878,0,878,0,-5.512666183877481
ZCTA5 29306,6700,143,6557,0.02134328358208955,-5.51288997822485
ZCTA5 35117,2019,23,1996,0.011391778107974244,-5.512967895908773
ZCTA5 40486,937,1,936,0.0010672358591248667,-5.513201237187156
ZCTA5 64865,2283,29,2254,0.012702584318878668,-5.514029072443139
ZCTA5 20685,2283,29,2254,0.012702584318878668,-5.514029072443139
ZCTA5 06331,1839,19,1820,0.010331702011963024,-5.514291104368152
ZCTA5 81611,4268,78,4190,0.018275538894095594,-5.514551911014167
ZCTA5 49229,1211,6,1205,0.00495458298926507,-5.515374346080562
ZCTA5 16433,2020,23,1997,0.011386138613861386,-5.515742543899901
ZCTA5 42081,938,1,937,0.0010660980810234541,-5.516336181581865
ZCTA5 19977,8575,195,8380,0.022740524781341108,-5.517224917130611
ZCTA5 35054,1655,15,1640,0.00906344410876133,-5.518083713575748
ZCTA5 31313,15839,405,15434,0.025569796072984406,-5.51821491447605
ZCTA5 00757,7465,164,7301,0.021969189551239117,-5.518376329024607
ZCTA5 84340,1212,6,1206,0.0049504950495049506,-5.518442516222359
ZCTA5 45135,1795,18,1777,0.010027855153203343,-5.519513763902654
ZCTA5 37345,881,0,881,0,-5.5220761472278435
ZCTA5 72619,881,0,881,0,-5.5220761472278435
ZCTA5 13076,881,0,881,0,-5.5220761472278435
ZCTA5 16346,1416,10,1406,0.007062146892655367,-5.522920127664976
ZCTA5 27583,2795,41,2754,0.014669051878354204,-5.522933552803899
ZCTA5 76066,1053,3,1050,0.002849002849002849,-5.522976745734
ZCTA5 17967,1053,3,1050,0.002849002849002849,-5.522976745734
ZCTA5 14812,1214,6,1208,0.004942339373970346,-5.524574083921515
ZCTA5 98253,882,0,882,0,-5.52520924032941
ZCTA5 94534,12979,321,12658,0.02473225980429925,-5.525852972313223
ZCTA5 38477,1162,5,1157,0.004302925989672977,-5.526173121948498
ZCTA5 46996,2713,39,2674,0.014375230372281608,-5.526422501780591
ZCTA5 28124,2374,31,2343,0.013058129738837404,-5.526511203964872
ZCTA5 08089,1563,13,1550,0.008317338451695458,-5.526555580070801
ZCTA5 71833,883,0,883,0,-5.528340557803968
ZCTA5 80447,883,0,883,0,-5.528340557803968
ZCTA5 05045,883,0,883,0,-5.528340557803968
ZCTA5 66112,5265,104,5161,0.019753086419753086,-5.528658514575583
ZCTA5 46783,2504,34,2470,0.013578274760383386,-5.531064747777753
ZCTA5 13495,884,0,884,0,-5.53147010266702
ZCTA5 43605,10278,243,10035,0.023642732049036778,-5.531636428681223
ZCTA5 80517,4813,92,4721,0.01911489715354249,-5.532234873365223
ZCTA5 85053,11221,270,10951,0.02406202655734783,-5.532829847432255
ZCTA5 75792,1111,4,1107,0.0036003600360036,-5.533769878612065
ZCTA5 50651,1370,9,1361,0.006569343065693431,-5.533908293352283
ZCTA5 53065,885,0,885,0,-5.534597877925541
ZCTA5 12918,885,0,885,0,-5.534597877925541
ZCTA5 94511,885,0,885,0,-5.534597877925541
ZCTA5 29388,5903,121,5782,0.02049805183804845,-5.535758033592445
ZCTA5 29672,5382,107,5275,0.019881085098476404,-5.537530084045861
ZCTA5 50169,1002,2,1000,0.001996007984031936,-5.537725805803435
ZCTA5 31308,2676,38,2638,0.014200298953662182,-5.538932217077819
ZCTA5 32327,9616,224,9392,0.02329450915141431,-5.540423684326925
ZCTA5 37306,887,0,887,0,-5.540848131614464
ZCTA5 10984,887,0,887,0,-5.540848131614464
ZCTA5 15469,887,0,887,0,-5.540848131614464
ZCTA5 24162,887,0,887,0,-5.540848131614464
ZCTA5 10524,1422,10,1412,0.007032348804500703,-5.540857728519649
ZCTA5 04443,1059,3,1056,0.0028328611898017,-5.5416105579627954
ZCTA5 23234,15824,404,15420,0.025530839231547017,-5.542853756212912
ZCTA5 32304,16535,425,16110,0.025703054127608104,-5.54286016281044
ZCTA5 98831,1220,6,1214,0.004918032786885246,-5.542930776321036
ZCTA5 63020,7875,175,7700,0.022222222222222223,-5.543021616881434
ZCTA5 60504,13163,326,12837,0.024766390640431513,-5.543107962560913
ZCTA5 95619,2030,23,2007,0.011330049261083743,-5.543432246262992
ZCTA5 28399,888,0,888,0,-5.543970616016494
ZCTA5 06039,888,0,888,0,-5.543970616016494
ZCTA5 68104,14193,356,13837,0.025082787289508912,-5.546277078690364
ZCTA5 52214,1424,10,1414,0.007022471910112359,-5.546825593862583
ZCTA5 44675,889,0,889,0,-5.54709134275731
ZCTA5 02808,889,0,889,0,-5.54709134275731
ZCTA5 29649,10498,249,10249,0.023718803581634598,-5.547180190776465
ZCTA5 44807,890,0,890,0,-5.550210314801764
ZCTA5 08061,890,0,890,0,-5.550210314801764
ZCTA5 89045,890,0,890,0,-5.550210314801764
ZCTA5 56058,2297,29,2268,0.012625163256421419,-5.551544942316424
ZCTA5 38049,1475,11,1464,0.007457627118644068,-5.55234036164983
ZCTA5 24128,891,0,891,0,-5.55332753510638
ZCTA5 38230,1620,14,1606,0.008641975308641974,-5.553761476697408
ZCTA5 38107,6686,142,6544,0.02123840861501645,-5.554816225540216
ZCTA5 24136,1377,9,1368,0.006535947712418301,-5.554919540193042
ZCTA5 18635,1525,12,1513,0.007868852459016393,-5.556358097276665
ZCTA5 14139,892,0,892,0,-5.5564430066193875
ZCTA5 87701,7379,161,7218,0.021818674617156798,-5.558399304198203
ZCTA5 32189,2557,35,2522,0.01368791552600704,-5.558461949122344
ZCTA5 40008,1328,8,1320,0.006024096385542169,-5.558919875285683
ZCTA5 29664,893,0,893,0,-5.559556732280758
ZCTA5 58257,893,0,893,0,-5.559556732280758
ZCTA5 61373,893,0,893,0,-5.559556732280758
ZCTA5 23881,893,0,893,0,-5.559556732280758
ZCTA5 15851,2768,40,2728,0.014450867052023121,-5.560029495867885
ZCTA5 27522,4559,85,4474,0.018644439570081158,-5.560929942815267
ZCTA5 01529,1226,6,1220,0.004893964110929853,-5.561230845733046
ZCTA5 70526,6763,144,6619,0.02129232589087683,-5.5620527954922965
ZCTA5 41553,894,0,894,0,-5.562668715022233
ZCTA5 37046,1764,17,1747,0.00963718820861678,-5.562891753982573
ZCTA5 24651,2126,25,2101,0.011759172154280339,-5.562960512324706
ZCTA5 18660,1430,10,1420,0.006993006993006993,-5.564695394802849
ZCTA5 57769,1528,12,1516,0.007853403141361256,-5.565179095531633
ZCTA5 11964,895,0,895,0,-5.565778957767358
ZCTA5 25413,3304,53,3251,0.016041162227602906,-5.566201699293214
ZCTA5 51201,2560,35,2525,0.013671875,-5.566235104029951
ZCTA5 21673,1431,10,1421,0.0069881201956673656,-5.567668786016651
ZCTA5 11702,4982,96,4886,0.019269369731031716,-5.567890214099154
ZCTA5 39740,2039,23,2016,0.011280039234919078,-5.5682652946651565
ZCTA5 24614,3061,47,3014,0.015354459327017315,-5.568886271144721
ZCTA5 98611,3626,61,3565,0.016822945394373966,-5.569335079630343
ZCTA5 42303,15777,402,15375,0.0254801293021487,-5.5700376361992685
ZCTA5 02635,1481,11,1470,0.007427413909520594,-5.570087823589102
ZCTA5 62890,1123,4,1119,0.003561887800534283,-5.570744650028008
ZCTA5 98388,2562,35,2527,0.01366120218579235,-5.5714132096031825
ZCTA5 32204,3825,66,3759,0.017254901960784313,-5.57155453596457
ZCTA5 85208,14861,375,14486,0.025233833523988964,-5.57289616294387
ZCTA5 55055,1433,10,1423,0.006978367062107467,-5.573611377402906
ZCTA5 03886,898,0,898,0,-5.575099275137824
ZCTA5 72642,1070,3,1067,0.002803738317757009,-5.57561472023556
ZCTA5 01503,1125,4,1121,0.0035555555555555557,-5.576884163623415
ZCTA5 04736,4102,73,4029,0.017796196977084348,-5.57697524426036
ZCTA5 29356,3550,59,3491,0.016619718309859154,-5.577997902143092
ZCTA5 35671,899,0,899,0,-5.578202586970206
ZCTA5 10709,3710,63,3647,0.016981132075471698,-5.579893274813611
ZCTA5 59425,1335,8,1327,0.00599250936329588,-5.579969575863058
ZCTA5 50670,900,0,900,0,-5.581304173302142
ZCTA5 71302,5292,104,5188,0.019652305366591082,-5.583587489830429
ZCTA5 77377,11950,290,11660,0.024267782426778243,-5.584645568172643
ZCTA5 22844,2045,23,2022,0.011246943765281174,-5.5847748884264306
ZCTA5 15683,3553,59,3494,0.016605685336335493,-5.5850059916426975
ZCTA5 66064,2266,28,2238,0.01235657546337158,-5.585057839767897
ZCTA5 28390,8437,190,8247,0.022519853028327604,-5.585370448784326
ZCTA5 27263,8794,200,8594,0.02274277916761428,-5.586058263712327
ZCTA5 49220,1018,2,1016,0.0019646365422396855,-5.587330443127765
ZCTA5 45813,1487,11,1476,0.007397444519166106,-5.5877863396521175
ZCTA5 06330,1287,7,1280,0.005439005439005439,-5.589163686299767
ZCTA5 29643,903,0,903,0,-5.590598608005792
ZCTA5 28806,17788,461,17327,0.02591634809984259,-5.590841129788307
ZCTA5 54153,3070,47,3023,0.01530944625407166,-5.5909369508843945
ZCTA5 70757,1236,6,1230,0.0048543689320388345,-5.591606485607232
ZCTA5 43570,1288,7,1281,0.005434782608695652,-5.592177457286806
ZCTA5 53508,2181,26,2155,0.01192113709307657,-5.59239430251047
ZCTA5 72952,1020,2,1018,0.00196078431372549,-5.59350047452815
ZCTA5 53014,3275,52,3223,0.01587786259541985,-5.593690071250722
ZCTA5 17965,904,0,904,0,-5.593693321006712
ZCTA5 37148,8335,187,8148,0.022435512897420518,-5.59432567214872
ZCTA5 04002,2948,44,2904,0.014925373134328358,-5.5946892202752965
ZCTA5 25425,4919,94,4825,0.01910957511689368,-5.594898967959584
ZCTA5 49615,1682,15,1667,0.0089179548156956,-5.596095525892972
ZCTA5 58203,7509,164,7345,0.021840458116926354,-5.596650855497566
ZCTA5 12921,905,0,905,0,-5.5967863228029255
ZCTA5 27871,1730,16,1714,0.009248554913294798,-5.598913339538473
ZCTA5 78383,1588,13,1575,0.00818639798488665,-5.599596196953153
ZCTA5 16731,1022,2,1020,0.0019569471624266144,-5.599663790706758
ZCTA5 77420,906,0,906,0,-5.599877616229903
ZCTA5 64862,1239,6,1233,0.004842615012106538,-5.600689117212564
ZCTA5 06380,1239,6,1233,0.004842615012106538,-5.600689117212564
ZCTA5 12859,907,0,907,0,-5.602967204115289
ZCTA5 10604,3760,64,3696,0.01702127659574468,-5.603678428289185
ZCTA5 50665,1240,6,1234,0.004838709677419355,-5.603713598924874
ZCTA5 07035,3641,61,3580,0.01675363911013458,-5.604099368610985
ZCTA5 45874,908,0,908,0,-5.606055089278939
ZCTA5 67860,908,0,908,0,-5.606055089278939
ZCTA5 36769,967,1,966,0.001034126163391934,-5.606489912096511
ZCTA5 24630,2703,38,2665,0.014058453570107288,-5.607816226030253
ZCTA5 92677,25667,697,24970,0.027155491487123543,-5.611844340241351
ZCTA5 44634,910,0,910,0,-5.612225762681675
ZCTA5 49051,910,0,910,0,-5.612225762681675
ZCTA5 13452,1828,18,1810,0.009846827133479213,-5.613061626619446
ZCTA5 14485,1593,13,1580,0.008160703075957313,-5.61410794755856
ZCTA5 71968,1496,11,1485,0.007352941176470588,-5.614243158036887
ZCTA5 01984,1397,9,1388,0.006442376521116679,-5.614564130396251
ZCTA5 54440,1191,5,1186,0.0041981528127623844,-5.614814443778094
ZCTA5 40121,2451,32,2419,0.013055895552835577,-5.616036517023337
ZCTA5 08225,2832,41,2791,0.014477401129943503,-5.616087374455893
ZCTA5 62321,1689,15,1674,0.008880994671403197,-5.616175282935793
ZCTA5 16668,1448,10,1438,0.006906077348066298,-5.618004088911287
ZCTA5 07756,1967,21,1946,0.010676156583629894,-5.618012285795908
ZCTA5 77482,912,0,912,0,-5.618389658842246
ZCTA5 27845,912,0,912,0,-5.618389658842246
ZCTA5 14739,1193,5,1188,0.004191114836546521,-5.620878694359267
ZCTA5 14136,1877,19,1858,0.010122535961640916,-5.621366697355631
ZCTA5 36003,913,0,913,0,-5.621469072424422
ZCTA5 26711,1085,3,1082,0.0027649769585253456,-5.621660421142928
ZCTA5 12871,1691,15,1676,0.008870490833826138,-5.621901502355849
ZCTA5 13116,1400,9,1391,0.0064285714285714285,-5.623461962716609
ZCTA5 34484,1548,12,1536,0.007751937984496124,-5.623682661773592
ZCTA5 14012,914,0,914,0,-5.624546800042035
ZCTA5 12183,1247,6,1241,0.0048115477145148355,-5.6248423284165074
ZCTA5 46161,1141,4,1137,0.0035056967572304996,-5.625767857260987
ZCTA5 36091,1451,10,1441,0.006891798759476223,-5.62684553206999
ZCTA5 63037,1196,5,1191,0.004180602006688963,-5.629963428763874
ZCTA5 97067,916,0,916,0,-5.630697208440593
ZCTA5 67333,1088,3,1085,0.0027573529411764708,-5.6308254338363035
ZCTA5 98595,1249,6,1243,0.004803843074459567,-5.630865467782211
ZCTA5 53821,3372,54,3318,0.01601423487544484,-5.631884911481711
ZCTA5 31201,3291,52,3239,0.015800668489820723,-5.631964382807619
ZCTA5 94028,2543,34,2509,0.013370035391270154,-5.632369871474551
ZCTA5 08069,4746,89,4657,0.018752633796881586,-5.632381664657163
ZCTA5 38257,1881,19,1862,0.010101010101010102,-5.632545046431386
ZCTA5 57430,917,0,917,0,-5.633769894731191
ZCTA5 10920,2964,44,2920,0.014844804318488529,-5.634244232812265
ZCTA5 99224,8610,194,8416,0.022531939605110338,-5.636106767482765
ZCTA5 28584,4901,93,4808,0.01897571924097123,-5.636765557871067
ZCTA5 55940,1090,3,1087,0.0027522935779816515,-5.636927355684861
ZCTA5 68526,2416,31,2385,0.01283112582781457,-5.637233904541454
ZCTA5 55349,1601,13,1588,0.008119925046845722,-5.637260950380483
ZCTA5 35582,1649,14,1635,0.008489993935718617,-5.637571882212818
ZCTA5 12074,1145,4,1141,0.0034934497816593887,-5.637924943594838
ZCTA5 32401,9323,214,9109,0.02295398476885123,-5.638209796407298
ZCTA5 20755,2715,38,2677,0.013996316758747698,-5.63825558536843
ZCTA5 30757,919,0,919,0,-5.63991024521287
ZCTA5 16314,2155,25,2130,0.01160092807424594,-5.641625259650229
ZCTA5 64056,5883,119,5764,0.020227774944756076,-5.641656855626152
ZCTA5 17516,1792,17,1775,0.009486607142857142,-5.642316747061709
ZCTA5 53172,8614,194,8420,0.022521476665892732,-5.642816133008803
ZCTA5 46113,5510,109,5401,0.019782214156079853,-5.643806487292926
ZCTA5 35956,3256,51,3205,0.015663390663390665,-5.645497969106296
ZCTA5 97303,14608,366,14242,0.025054764512595838,-5.645613954656102
ZCTA5 48460,921,0,921,0,-5.646043917765314
ZCTA5 14818,921,0,921,0,-5.646043917765314
ZCTA5 02770,1840,18,1822,0.009782608695652175,-5.646774154259966
ZCTA5 47923,1408,9,1399,0.006392045454545455,-5.647128062585998
ZCTA5 54736,1700,15,1685,0.008823529411764706,-5.647610202846601
ZCTA5 57501,7211,155,7056,0.02149493828872556,-5.647640671460066
ZCTA5 56063,1202,5,1197,0.004159733777038269,-5.648091215428939
ZCTA5 12827,1409,9,1400,0.0063875088715401,-5.650080073432336
ZCTA5 30648,1203,5,1198,0.004156275976724855,-5.651107136539797
ZCTA5 16049,1256,6,1250,0.004777070063694267,-5.651899079942813
ZCTA5 30666,3421,55,3366,0.01607717041800643,-5.652186172110909
ZCTA5 31078,1150,4,1146,0.0034782608695652175,-5.653085847359738
ZCTA5 46933,2594,35,2559,0.013492675404780262,-5.653832201914407
ZCTA5 98340,1360,8,1352,0.0058823529411764705,-5.654565506637852
ZCTA5 98577,2637,36,2601,0.013651877133105802,-5.655036751676892
ZCTA5 35053,924,0,924,0,-5.655231953001671
ZCTA5 15468,924,0,924,0,-5.655231953001671
ZCTA5 49401,6631,139,6492,0.020962147489066506,-5.657026043333435
ZCTA5 64058,2467,32,2435,0.012971220105391163,-5.657725949148953
ZCTA5 66007,2510,33,2477,0.013147410358565738,-5.657731503181489
ZCTA5 55955,925,0,925,0,-5.658291315926558
ZCTA5 99037,5967,121,5846,0.020278196748784984,-5.660131044824966
ZCTA5 98367,10536,248,10288,0.023538344722854973,-5.6602207527590975
ZCTA5 13363,926,0,926,0,-5.661349025588221
ZCTA5 08052,8482,190,8292,0.02240037726951191,-5.661437482022503
ZCTA5 41006,1610,13,1597,0.008074534161490683,-5.663212128978586
ZCTA5 73018,7836,172,7664,0.021949974476773864,-5.663300558859343
ZCTA5 64061,1312,7,1305,0.005335365853658537,-5.6640638076500265
ZCTA5 43526,2340,29,2311,0.012393162393162393,-5.6656775934073424
ZCTA5 14546,1893,19,1874,0.010036978341257264,-5.665976075275161
ZCTA5 23146,1208,5,1203,0.0041390728476821195,-5.666163834679038
ZCTA5 71411,1313,7,1306,0.005331302361005331,-5.6670407897422255
ZCTA5 27856,6231,128,6103,0.020542449045097094,-5.667986713747211
ZCTA5 99328,1612,13,1599,0.008064516129032258,-5.668965365194094
ZCTA5 14435,1209,5,1204,0.0041356492969396195,-5.669170608502825
ZCTA5 02760,10226,239,9987,0.023371797379229415,-5.669988831001298
ZCTA5 47115,1045,2,1043,0.0019138755980861245,-5.6700661799177965
ZCTA5 98260,2643,36,2607,0.01362088535754824,-5.670327084320194
ZCTA5 01257,929,0,929,0,-5.6705122617313055
ZCTA5 12094,929,0,929,0,-5.6705122617313055
ZCTA5 11980,1803,17,1786,0.009428729894620078,-5.673274495895752
ZCTA5 47920,930,0,930,0,-5.673563385041529
ZCTA5 59834,930,0,930,0,-5.673563385041529
ZCTA5 49544,4028,70,3958,0.01737835153922542,-5.673918785013357
ZCTA5 29554,3268,51,3217,0.015605875152998777,-5.674176408366985
ZCTA5 08804,1047,2,1045,0.0019102196752626551,-5.676147346965424
ZCTA5 08829,1468,10,1458,0.006811989100817439,-5.676716966176153
ZCTA5 49779,1989,21,1968,0.010558069381598794,-5.678629953899675
ZCTA5 38075,1265,6,1259,0.0047430830039525695,-5.678834936219053
ZCTA5 40447,3392,54,3338,0.015919811320754717,-5.679144521103015
ZCTA5 62914,1048,2,1046,0.0019083969465648854,-5.679185517134113
ZCTA5 02188,6348,131,6217,0.020636420919974797,-5.679316350447233
ZCTA5 17860,932,0,932,0,-5.679660714458347
ZCTA5 78101,2214,26,2188,0.011743450767841012,-5.681038779886851
ZCTA5 62801,8422,188,8234,0.022322488720018997,-5.681128660630099
ZCTA5 00909,2346,29,2317,0.0123614663256607,-5.681474168109282
ZCTA5 52076,933,0,933,0,-5.682706925840914
ZCTA5 62451,933,0,933,0,-5.682706925840914
ZCTA5 15942,933,0,933,0,-5.682706925840914
ZCTA5 51537,2943,43,2900,0.014610941216445803,-5.6848031175732
ZCTA5 78254,17020,436,16584,0.02561692126909518,-5.686053642461248
ZCTA5 43035,8783,198,8585,0.02254355003984971,-5.686396985048984
ZCTA5 52591,1268,6,1262,0.00473186119873817,-5.687786957003331
ZCTA5 43946,935,0,935,0,-5.688794455091333
ZCTA5 51001,935,0,935,0,-5.688794455091333
ZCTA5 49968,935,0,935,0,-5.688794455091333
ZCTA5 30805,994,1,993,0.001006036217303823,-5.68914660629589
ZCTA5 49676,1473,10,1463,0.006788866259334691,-5.691311392854574
ZCTA5 30477,1052,2,1050,0.0019011406844106464,-5.6913221676185435
ZCTA5 50458,936,0,936,0,-5.6918357781928925
ZCTA5 22843,936,0,936,0,-5.6918357781928925
ZCTA5 77904,10416,244,10172,0.023425499231950846,-5.691941701694894
ZCTA5 38965,3519,57,3462,0.01619778346121057,-5.692783111997834
ZCTA5 49684,16619,424,16195,0.025512967085865576,-5.693197160651391
ZCTA5 35971,1949,20,1929,0.01026167265264238,-5.694007939152073
ZCTA5 49670,937,0,937,0,-5.694875477089512
ZCTA5 62281,937,0,937,0,-5.694875477089512
ZCTA5 61833,937,0,937,0,-5.694875477089512
ZCTA5 53590,15704,397,15307,0.025280183392766175,-5.696478051755959
ZCTA5 53919,1054,2,1052,0.0018975332068311196,-5.697380909847439
ZCTA5 35203,1574,12,1562,0.007623888182973317,-5.698965002413848
ZCTA5 44081,2569,34,2535,0.013234721681588166,-5.699230285736944
ZCTA5 31063,1905,19,1886,0.009973753280839895,-5.699252590082947
ZCTA5 12524,5950,120,5830,0.020168067226890758,-5.699304114601406
ZCTA5 15956,1111,3,1108,0.0027002700270027003,-5.700612159269187
ZCTA5 63935,3683,61,3622,0.01656258484930763,-5.7008085152315475
ZCTA5 23936,2397,30,2367,0.012515644555694618,-5.700919442788995
ZCTA5 97455,939,0,939,0,-5.700950012658688
ZCTA5 00676,13310,327,12983,0.024567993989481594,-5.701261539983768
ZCTA5 53190,6434,133,6301,0.020671433012123097,-5.702039541937725
ZCTA5 98010,2043,22,2021,0.010768477728830151,-5.7023108240845755
ZCTA5 55327,1325,7,1318,0.005283018867924529,-5.7026524379374
ZCTA5 50171,1112,3,1109,0.002697841726618705,-5.703627430843836
ZCTA5 26035,940,0,940,0,-5.703984854509336
ZCTA5 05673,1167,4,1163,0.003427592116538132,-5.704342081726153
ZCTA5 22520,2614,35,2579,0.013389441469013007,-5.704938206629191
ZCTA5 41004,1673,14,1659,0.008368200836820083,-5.706152517975714
ZCTA5 22974,1577,12,1565,0.007609384908053266,-5.7075963635120095
ZCTA5 56273,1954,20,1934,0.01023541453428864,-5.7077619092649154
ZCTA5 32905,9508,218,9290,0.022928060580563736,-5.707933279412323
ZCTA5 45368,1862,18,1844,0.00966702470461869,-5.708168172311785
ZCTA5 66073,1058,2,1056,0.001890359168241966,-5.7094793278561005
ZCTA5 15219,5355,104,5251,0.01942110177404295,-5.710813497391507
ZCTA5 12138,1430,9,1421,0.006293706293706294,-5.711755586773081
ZCTA5 54658,1115,3,1112,0.0026905829596412557,-5.712663908630069
ZCTA5 29009,943,0,943,0,-5.7130797072496975
ZCTA5 53002,943,0,943,0,-5.7130797072496975
ZCTA5 15486,943,0,943,0,-5.7130797072496975
ZCTA5 26180,943,0,943,0,-5.7130797072496975
ZCTA5 28543,1956,20,1936,0.010224948875255624,-5.7132562609079285
ZCTA5 24590,2913,42,2871,0.014418125643666324,-5.713627301310164
ZCTA5 20018,7938,174,7764,0.021919879062736205,-5.714951959960804
ZCTA5 67026,1724,15,1709,0.008700696055684454,-5.715698703694886
ZCTA5 04537,944,0,944,0,-5.7161081091094745
ZCTA5 84117,10256,239,10017,0.02330343213728549,-5.716802132668384
ZCTA5 40906,4517,82,4435,0.01815364179765331,-5.718694131523248
ZCTA5 28435,945,0,945,0,-5.719134907367187
ZCTA5 22514,945,0,945,0,-5.719134907367187
ZCTA5 45219,6147,125,6022,0.02033512282414186,-5.720048016766758
ZCTA5 65560,5849,117,5732,0.02000341938792956,-5.720750940026212
ZCTA5 71742,2050,22,2028,0.010731707317073172,-5.721329936724844
ZCTA5 46130,946,0,946,0,-5.722160104567566
ZCTA5 37756,1227,5,1222,0.004074979625101874,-5.723035305458228
ZCTA5 43450,1435,9,1426,0.0062717770034843206,-5.726352158959704
ZCTA5 72137,948,0,948,0,-5.728205705941634
ZCTA5 03224,948,0,948,0,-5.728205705941634
ZCTA5 18077,948,0,948,0,-5.728205705941634
ZCTA5 70817,12501,303,12198,0.02423806095512359,-5.730425475019567
ZCTA5 48014,1585,12,1573,0.007570977917981073,-5.730558459655149
ZCTA5 13030,1585,12,1573,0.007570977917981073,-5.730558459655149
ZCTA5 45744,1121,3,1118,0.0026761819803746653,-5.730695060192907
ZCTA5 78205,949,0,949,0,-5.731226115171263
ZCTA5 21132,949,0,949,0,-5.731226115171263
ZCTA5 27874,1682,14,1668,0.008323424494649227,-5.73169254787964
ZCTA5 55720,6561,136,6425,0.02072854747751867,-5.732313196518464
ZCTA5 32962,9025,204,8821,0.02260387811634349,-5.732332190810036
ZCTA5 79329,1122,3,1119,0.00267379679144385,-5.733694860402302
ZCTA5 25825,950,0,950,0,-5.734244933455484
ZCTA5 98038,12053,290,11763,0.024060399900439726,-5.735275985797901
ZCTA5 95228,1731,15,1716,0.008665511265164644,-5.735431537281482
ZCTA5 38233,1123,3,1120,0.0026714158504007124,-5.73669312632295
ZCTA5 42058,951,0,951,0,-5.7372621633056555
ZCTA5 54562,951,0,951,0,-5.7372621633056555
ZCTA5 48819,1010,1,1009,9.900990099009901e-4,-5.737568388192566
ZCTA5 18069,2923,42,2881,0.014368799178925761,-5.7382565774859415
ZCTA5 46747,1068,2,1066,0.0018726591760299626,-5.739615069434125
ZCTA5 07931,1068,2,1066,0.0018726591760299626,-5.739615069434125
ZCTA5 23069,1068,2,1066,0.0018726591760299626,-5.739615069434125
ZCTA5 27830,1966,20,1946,0.01017293997965412,-5.740666347099376
ZCTA5 76539,3132,47,3085,0.015006385696040868,-5.741430395514212
ZCTA5 20181,2756,38,2718,0.013788098693759071,-5.74145698938364
ZCTA5 32465,2237,26,2211,0.0116227089852481,-5.742229138078687
ZCTA5 17501,1828,17,1811,0.009299781181619256,-5.743131001075124
ZCTA5 37847,953,0,953,0,-5.74329186771631
ZCTA5 78234,953,0,953,0,-5.74329186771631
ZCTA5 62664,1339,7,1332,0.005227781926811053,-5.743940928086811
ZCTA5 54843,5220,100,5120,0.019157088122605363,-5.744446823565209
ZCTA5 11944,1829,17,1812,0.009294696555494806,-5.745910950579371
ZCTA5 72127,954,0,954,0,-5.746304347266605
ZCTA5 01537,954,0,954,0,-5.746304347266605
ZCTA5 54937,7376,158,7218,0.021420824295010847,-5.747286655770106
ZCTA5 61046,1071,2,1069,0.0018674136321195146,-5.7486253328000005
ZCTA5 30520,1736,15,1721,0.008640552995391706,-5.749491962554342
ZCTA5 80920,13793,340,13453,0.024650184876386573,-5.750104398226861
ZCTA5 19301,2632,35,2597,0.013297872340425532,-5.750671538707934
ZCTA5 49332,1183,4,1179,0.0033812341504649195,-5.752180340023933
ZCTA5 35073,956,0,956,0,-5.75232457348268
ZCTA5 02725,956,0,956,0,-5.75232457348268
ZCTA5 25535,956,0,956,0,-5.75232457348268
ZCTA5 90401,4649,85,4564,0.018283501828350184,-5.7524109075729655
ZCTA5 07205,7271,155,7116,0.021317562921193783,-5.755199079790134
ZCTA5 49078,3667,60,3607,0.01636214889555495,-5.755910586682889
ZCTA5 38478,6943,146,6797,0.02102837390177157,-5.757894803559915
ZCTA5 49065,2549,33,2516,0.012946253432718713,-5.757995052270797
ZCTA5 29720,17179,439,16740,0.025554456021887186,-5.758081621592542
ZCTA5 49451,2109,23,2086,0.010905642484589853,-5.75865620847361
ZCTA5 48835,1075,2,1073,0.0018604651162790699,-5.760617339256858
ZCTA5 99169,1075,2,1073,0.0018604651162790699,-5.760617339256858
ZCTA5 66524,959,0,959,0,-5.761343117677431
ZCTA5 05677,959,0,959,0,-5.761343117677431
ZCTA5 28470,5115,97,5018,0.018963831867057673,-5.7632421107886085
ZCTA5 61063,1741,15,1726,0.00861573808156232,-5.7635238559312825
ZCTA5 03046,960,0,960,0,-5.76434616355124
ZCTA5 36106,6245,127,6118,0.02033626901521217,-5.764960609294998
ZCTA5 36266,1975,20,1955,0.010126582278481013,-5.765248159293874
ZCTA5 08029,1883,18,1865,0.009559214020180564,-5.766283414843838
ZCTA5 55750,961,0,961,0,-5.767347645745545
ZCTA5 72422,1930,19,1911,0.009844559585492229,-5.7680907189292006
ZCTA5 76544,3793,63,3730,0.016609543896651726,-5.769231817311427
ZCTA5 98862,1078,2,1076,0.0018552875695732839,-5.769595168360525
ZCTA5 54171,1348,7,1341,0.0051928783382789315,-5.770338889978885
ZCTA5 97753,962,0,962,0,-5.770347566700423
ZCTA5 28753,4151,72,4079,0.017345218019754277,-5.771768985617244
ZCTA5 53570,1079,2,1077,0.0018535681186283596,-5.772584709495853
ZCTA5 12850,1190,4,1186,0.0033613445378151263,-5.772989125278086
ZCTA5 21776,1978,20,1958,0.010111223458038422,-5.773423859886899
ZCTA5 37185,3351,52,3299,0.015517755893763056,-5.774147911707996
ZCTA5 03086,1649,13,1636,0.007883565797453002,-5.774518975725386
ZCTA5 97355,11592,276,11316,0.023809523809523808,-5.774736962543842
ZCTA5 20117,1136,3,1133,0.002640845070422535,-5.775532007570598
ZCTA5 72366,964,0,964,0,-5.7763427346205045
ZCTA5 24248,964,0,964,0,-5.7763427346205045
ZCTA5 30828,1841,17,1824,0.009234111895708854,-5.779185638906019
ZCTA5 30621,1888,18,1870,0.009533898305084746,-5.780051276371771
ZCTA5 06359,2117,23,2094,0.01086443079829948,-5.780112866961887
ZCTA5 33884,11945,286,11659,0.0239430724152365,-5.780833823101946
ZCTA5 23508,6254,127,6127,0.02030700351774864,-5.7819837850037406
ZCTA5 15563,1247,5,1242,0.00400962309542903,-5.78232396540848
ZCTA5 84074,15497,389,15108,0.02510163257404659,-5.782418495380056
ZCTA5 07646,5806,115,5691,0.019807096107475025,-5.782874020150121
ZCTA5 13036,3639,59,3580,0.01621324539708711,-5.783846074246919
ZCTA5 40741,9021,203,8818,0.022503048442523002,-5.784318991028752
ZCTA5 28659,8627,192,8435,0.022255708821142924,-5.784348788615019
ZCTA5 20198,967,0,967,0,-5.785323837843435
ZCTA5 23867,967,0,967,0,-5.785323837843435
ZCTA5 75956,3109,46,3063,0.014795754261820521,-5.785622866054594
ZCTA5 46366,2209,25,2184,0.011317338162064282,-5.785994652809426
ZCTA5 54555,2298,27,2271,0.01174934725848564,-5.786233969718895
ZCTA5 11732,1456,9,1447,0.006181318681318681,-5.787295302709761
ZCTA5 48165,2859,40,2819,0.013990905911157748,-5.787455583812046
ZCTA5 37302,1797,16,1781,0.008903728436282694,-5.787591861932134
ZCTA5 97106,1605,12,1593,0.007476635514018692,-5.787618847943367
ZCTA5 32909,10760,252,10508,0.02342007434944238,-5.788298961984767
ZCTA5 49920,1891,18,1873,0.009518773135906928,-5.788299364357843
ZCTA5 40011,968,0,968,0,-5.788314442249859
ZCTA5 51579,968,0,968,0,-5.788314442249859
ZCTA5 24441,2604,34,2570,0.013056835637480798,-5.788402759204588
ZCTA5 08107,5280,101,5179,0.019128787878787877,-5.788802457439448
ZCTA5 53511,19164,497,18667,0.02593404299728658,-5.789432384977947
ZCTA5 49329,3028,44,2984,0.01453104359313078,-5.790763046730068
ZCTA5 28617,969,0,969,0,-5.7913035023211386
ZCTA5 55368,969,0,969,0,-5.7913035023211386
ZCTA5 61281,969,0,969,0,-5.7913035023211386
ZCTA5 29702,3723,61,3662,0.016384636046199302,-5.792063948318231
ZCTA5 08016,12197,293,11904,0.02402230056571288,-5.7928341284342135
ZCTA5 49233,1086,2,1084,0.001841620626151013,-5.793468776402016
ZCTA5 50583,1251,5,1246,0.003996802557953637,-5.794112242973408
ZCTA5 93908,4514,81,4433,0.0179441736818786,-5.7950587247473075
ZCTA5 07849,3523,56,3467,0.015895543570820323,-5.795781050461892
ZCTA5 67546,971,0,971,0,-5.797276999012095
ZCTA5 27869,971,0,971,0,-5.797276999012095
ZCTA5 89147,19644,511,19133,0.026013031969049073,-5.799921317444427
ZCTA5 60464,3847,64,3783,0.016636340005198855,-5.800911603963469
ZCTA5 78266,2304,27,2277,0.01171875,-5.801950333511071
ZCTA5 20711,2436,30,2406,0.012315270935960592,-5.802107680800268
ZCTA5 68023,973,0,973,0,-5.803244346962506
ZCTA5 22620,973,0,973,0,-5.803244346962506
ZCTA5 23885,973,0,973,0,-5.803244346962506
ZCTA5 37321,7079,149,6930,0.021048170645571407,-5.804751541166048
ZCTA5 07933,1201,4,1197,0.0033305578684429643,-5.805542945681937
ZCTA5 74127,6675,138,6537,0.020674157303370785,-5.806611422980112
ZCTA5 50436,2394,29,2365,0.01211361737677527,-5.806741550538656
ZCTA5 76444,1513,10,1503,0.006609385327164574,-5.806892948719211
ZCTA5 37918,17456,446,17010,0.025549954170485792,-5.807626312696663
ZCTA5 23228,14866,370,14496,0.0248890084757164,-5.807641399371175
ZCTA5 34102,5555,108,5447,0.01944194419441944,-5.807841633577902
ZCTA5 34981,1805,16,1789,0.00886426592797784,-5.809784002401844
ZCTA5 68347,976,0,976,0,-5.812183881422601
ZCTA5 00778,14733,366,14367,0.024842190999796374,-5.813205897400934
ZCTA5 08850,2913,41,2872,0.014074836937864744,-5.816664230037051
ZCTA5 98597,8467,187,8280,0.022085744655722217,-5.817431426132383
ZCTA5 27581,1312,6,1306,0.004573170731707317,-5.817594861078014
ZCTA5 05250,1517,10,1507,0.0065919578114700065,-5.818338658704653
ZCTA5 71770,1416,8,1408,0.005649717514124294,-5.818490920322322
ZCTA5 18834,1416,8,1408,0.005649717514124294,-5.818490920322322
ZCTA5 71665,2266,26,2240,0.01147396293027361,-5.818706443573333
ZCTA5 13903,7817,169,7648,0.021619547140846872,-5.818895230615897
ZCTA5 23075,3775,62,3713,0.01642384105960265,-5.818977598180531
ZCTA5 90402,4874,90,4784,0.018465326220763235,-5.819374974350525
ZCTA5 38229,1206,4,1202,0.003316749585406302,-5.820281918644871
ZCTA5 56085,2222,25,2197,0.011251125112511251,-5.82035217668314
ZCTA5 22902,10358,240,10118,0.023170496234794363,-5.820398800748344
ZCTA5 29546,979,0,979,0,-5.821109687369333
ZCTA5 61025,1950,19,1931,0.009743589743589744,-5.822695629507357
ZCTA5 58421,1207,4,1203,0.0033140016570008283,-5.823225382416283
ZCTA5 28167,980,0,980,0,-5.824081916149866
ZCTA5 06334,980,0,980,0,-5.824081916149866
ZCTA5 21740,22847,606,22241,0.02652427014487679,-5.825184290672982
ZCTA5 08853,1858,17,1841,0.00914962325080732,-5.82605991314454
ZCTA5 16651,1315,6,1309,0.0045627376425855515,-5.826346243996895
ZCTA5 45629,981,0,981,0,-5.827052628873597
ZCTA5 45130,1668,13,1655,0.0077937649880095924,-5.828086920329638
ZCTA5 21155,982,0,982,0,-5.830021827858064
ZCTA5 03581,1471,9,1462,0.006118286879673691,-5.830473868318083
ZCTA5 69357,1571,11,1560,0.007001909611712286,-5.830627971096866
ZCTA5 14132,2315,27,2288,0.011663066954643628,-5.830683138025967
ZCTA5 06798,4139,71,4068,0.017153901908673594,-5.831868490285172
ZCTA5 62501,1099,2,1097,0.0018198362147406734,-5.832057210208512
ZCTA5 64454,983,0,983,0,-5.832989515414912
ZCTA5 12170,1954,19,1935,0.009723643807574206,-5.833567768311628
ZCTA5 48234,12643,305,12338,0.024124021197500595,-5.834188810960928
ZCTA5 44643,1318,6,1312,0.004552352048558422,-5.835085256899295
ZCTA5 90305,5946,118,5828,0.01984527413387151,-5.8358083749874945
ZCTA5 30290,2921,41,2880,0.014036288942143102,-5.836231859680886
ZCTA5 27357,3089,45,3044,0.014567821301392036,-5.837433282410739
ZCTA5 01519,2450,30,2420,0.012244897959183673,-5.838127520689931
ZCTA5 49267,1524,10,1514,0.006561679790026247,-5.838320488557198
ZCTA5 00782,5495,106,5389,0.019290263876251136,-5.838919239596388
ZCTA5 50574,985,0,985,0,-5.838920365462942
ZCTA5 85630,985,0,985,0,-5.838920365462942
ZCTA5 62239,1956,19,1937,0.009713701431492843,-5.838997785581194
ZCTA5 22033,15096,376,14720,0.02490726020137785,-5.839924648271275
ZCTA5 29477,2538,32,2506,0.01260835303388495,-5.8402243343521025
ZCTA5 14512,1910,18,1892,0.009424083769633508,-5.840319339023171
ZCTA5 61277,1320,6,1314,0.004545454545454545,-5.840904418151422
ZCTA5 64503,4923,91,4832,0.018484663822872234,-5.841008538813921
ZCTA5 30104,1624,12,1612,0.007389162561576354,-5.841378328425144
ZCTA5 70068,11812,281,11531,0.023789366745682355,-5.841460571874362
ZCTA5 04785,986,0,986,0,-5.841883532548102
ZCTA5 46506,3503,55,3448,0.015700827861832713,-5.843395474394659
ZCTA5 67025,1321,6,1315,0.004542013626040878,-5.843811950143349
ZCTA5 55964,1722,14,1708,0.008130081300813009,-5.844063250532288
ZCTA5 15035,987,0,987,0,-5.844845197393639
ZCTA5 22151,5498,106,5392,0.019279738086576938,-5.844853208150124
ZCTA5 65548,2276,26,2250,0.011423550087873463,-5.844906365276046
ZCTA5 47834,7760,167,7593,0.02152061855670103,-5.846104919489217
ZCTA5 97530,3051,44,3007,0.014421501147164863,-5.846362677609717
ZCTA5 46755,6252,126,6126,0.02015355086372361,-5.848534829035291
ZCTA5 37769,2188,24,2164,0.010968921389396709,-5.849059408897396
ZCTA5 92036,1105,2,1103,0.0018099547511312218,-5.849782316728706
ZCTA5 76856,1478,9,1469,0.006089309878213802,-5.850525225367422
ZCTA5 00959,17966,460,17506,0.0256039185127463,-5.851629284606828
ZCTA5 48223,9847,225,9622,0.022849598862597745,-5.8520964566089555
ZCTA5 33559,6663,137,6526,0.020561308719795886,-5.852616087979772
ZCTA5 39157,10662,248,10414,0.023260176327143126,-5.853696838413138
ZCTA5 13080,1325,6,1319,0.004528301886792453,-5.85542846364014
ZCTA5 28339,2887,40,2847,0.013855213023900243,-5.856272234479062
ZCTA5 17931,2146,23,2123,0.010717614165890028,-5.8573907844573085
ZCTA5 61064,1531,10,1521,0.006531678641410843,-5.858241471041351
ZCTA5 12754,2414,29,2385,0.012013256006628004,-5.858368448997536
ZCTA5 46390,1219,4,1215,0.003281378178835111,-5.858435308144046
ZCTA5 45390,1273,5,1268,0.003927729772191673,-5.858542798070515
ZCTA5 92124,10947,256,10691,0.023385402393349776,-5.858554119499086
ZCTA5 14009,2370,28,2342,0.01181434599156118,-5.858583677011891
ZCTA5 18810,2370,28,2342,0.01181434599156118,-5.858583677011891
ZCTA5 42539,3953,66,3887,0.016696180116367317,-5.85936476070804
ZCTA5 47918,2502,31,2471,0.012390087929656275,-5.859370689107715
ZCTA5 36518,992,0,992,0,-5.859631067711472
ZCTA5 19043,992,0,992,0,-5.859631067711472
ZCTA5 27409,8240,180,8060,0.021844660194174758,-5.8606205586870725
ZCTA5 30141,8421,185,8236,0.02196888730554566,-5.861242239190215
ZCTA5 84318,1274,5,1269,0.003924646781789639,-5.861455379414345
ZCTA5 17049,1109,2,1107,0.0018034265103697023,-5.861569590182744
ZCTA5 02322,1582,11,1571,0.00695322376738306,-5.861773972761465
ZCTA5 34773,994,0,994,0,-5.865534979604766
ZCTA5 45647,994,0,994,0,-5.865534979604766
ZCTA5 39120,11339,267,11072,0.02354705000440956,-5.866801936177343
ZCTA5 65355,4548,81,4467,0.017810026385224276,-5.867152441882205
ZCTA5 03841,2592,33,2559,0.01273148148148148,-5.867166434657201
ZCTA5 22936,1920,18,1902,0.009375,-5.8675487381263425
ZCTA5 71346,995,0,995,0,-5.86848470821948
ZCTA5 10998,995,0,995,0,-5.86848470821948
ZCTA5 04345,4666,84,4582,0.018002571795970854,-5.869635750505905
ZCTA5 60637,19232,497,18735,0.02584234608985025,-5.870412683178226
ZCTA5 46041,8535,188,8347,0.022026947861745753,-5.870952892044438
ZCTA5 39206,10002,229,9773,0.022895420915816835,-5.872490267919942
ZCTA5 35178,1331,6,1325,0.004507888805409466,-5.872812592168366
ZCTA5 71836,1224,4,1220,0.0032679738562091504,-5.87304579837985
ZCTA5 44681,2464,30,2434,0.012175324675324676,-5.873989640739309
ZCTA5 53021,1969,19,1950,0.009649568308786187,-5.874195173686382
ZCTA5 30905,997,0,997,0,-5.874379721969246
ZCTA5 12413,997,0,997,0,-5.874379721969246
ZCTA5 57732,1056,1,1055,9.46969696969697e-4,-5.874565275118617
ZCTA5 97004,1685,13,1672,0.00771513353115727,-5.875660906146312
ZCTA5 95470,2016,20,1996,0.00992063492063492,-5.876206442234709
ZCTA5 48703,1487,9,1478,0.00605245460659045,-5.876214499162782
ZCTA5 03902,998,0,998,0,-5.877325011561151
ZCTA5 04538,998,0,998,0,-5.877325011561151
ZCTA5 10958,998,0,998,0,-5.877325011561151
ZCTA5 27009,998,0,998,0,-5.877325011561151
ZCTA5 14048,6118,122,5996,0.019941157240928407,-5.877905786024365
ZCTA5 21782,1538,10,1528,0.006501950585175552,-5.878102125345793
ZCTA5 49931,3148,46,3102,0.014612452350698857,-5.878991463478219
ZCTA5 11724,999,0,999,0,-5.880268825926336
ZCTA5 25823,999,0,999,0,-5.880268825926336
ZCTA5 04097,1386,7,1379,0.005050505050505051,-5.8805826300560975
ZCTA5 49841,2897,40,2857,0.013807386952019331,-5.8807213086769865
ZCTA5 28658,10363,239,10124,0.02306281964682042,-5.882760943664404
ZCTA5 80642,1387,7,1380,0.005046863734679163,-5.883457823304919
ZCTA5 24256,1439,8,1431,0.005559416261292564,-5.884604931546765
ZCTA5 64098,1282,5,1277,0.0039001560062402497,-5.8847064092593
ZCTA5 43331,2247,25,2222,0.011125945705384957,-5.886002104676378
ZCTA5 57706,1001,0,1001,0,-5.886152037829017
ZCTA5 65039,1001,0,1001,0,-5.886152037829017
ZCTA5 13617,3399,52,3347,0.015298617240364814,-5.886404514952738
ZCTA5 28746,1118,2,1116,0.0017889087656529517,-5.888005576296618
ZCTA5 89704,1834,16,1818,0.008724100327153763,-5.889650804761923
ZCTA5 53020,1592,11,1581,0.006909547738693468,-5.8899624602907386
ZCTA5 72150,4715,85,4630,0.018027571580063628,-5.890828835344503
ZCTA5 24283,1003,0,1003,0,-5.8920293753270006
ZCTA5 04042,2022,20,2002,0.009891196834817012,-5.892305749206763
ZCTA5 77450,24841,664,24177,0.026730002817921983,-5.8937446038301555
ZCTA5 21651,1120,2,1118,0.0017857142857142857,-5.89386430346403
ZCTA5 34224,7459,158,7301,0.021182464137283818,-5.894014451123321
ZCTA5 74301,4365,76,4289,0.01741122565864834,-5.8944256790364316
ZCTA5 02048,8477,186,8291,0.02194172466674531,-5.894606426762562
ZCTA5 27019,1643,12,1631,0.007303712720632989,-5.894711225146785
ZCTA5 20190,8658,191,8467,0.022060522060522062,-5.8957323350095825
ZCTA5 18419,1741,14,1727,0.0080413555427915,-5.896803480812413
ZCTA5 49028,2517,31,2486,0.012316249503377036,-5.897509450619028
ZCTA5 29584,1005,0,1005,0,-5.897900855982058
ZCTA5 29628,1005,0,1005,0,-5.897900855982058
ZCTA5 40243,4563,81,4482,0.01775147928994083,-5.898813329570374
ZCTA5 22482,1495,9,1486,0.006020066889632107,-5.898964279743
ZCTA5 62837,4011,67,3944,0.01670406382448267,-5.899417062944346
ZCTA5 55063,3609,57,3552,0.015793848711554447,-5.900069670133113
ZCTA5 15748,2820,38,2782,0.01347517730496454,-5.900149477719842
ZCTA5 92861,1979,19,1960,0.009600808489135927,-5.901155779143034
ZCTA5 01469,2735,36,2699,0.01316270566727605,-5.901425106474453
ZCTA5 34637,2118,22,2096,0.010387157695939566,-5.903627763062324
ZCTA5 18372,1007,0,1007,0,-5.903766497268627
ZCTA5 30535,2693,35,2658,0.012996658002227999,-5.9038569102859775
ZCTA5 98546,1342,6,1336,0.004470938897168405,-5.904558013555052
ZCTA5 18235,7721,165,7556,0.02137028882269136,-5.904854782620306
ZCTA5 21160,1008,0,1008,0,-5.906697133585764
ZCTA5 08065,2950,41,2909,0.013898305084745762,-5.9068092479161995
ZCTA5 01583,2074,21,2053,0.010125361620057859,-5.908286633381193
ZCTA5 49756,1697,13,1684,0.0076605774896876845,-5.909044206760327
ZCTA5 36116,17198,436,16762,0.025351785091289686,-5.909071481483867
ZCTA5 14525,1010,0,1010,0,-5.912554048394643
ZCTA5 20733,1010,0,1010,0,-5.912554048394643
ZCTA5 42459,1699,13,1686,0.007651559741024131,-5.914592317806779
ZCTA5 31055,2213,24,2189,0.010845006778129237,-5.914797323053229
ZCTA5 30179,6586,134,6452,0.02034618888551473,-5.915785881082838
ZCTA5 06615,7362,155,7207,0.021054061396359684,-5.916833138481664
ZCTA5 46807,6587,134,6453,0.020343100045544255,-5.917629109466394
ZCTA5 73112,14743,364,14379,0.024689683239503494,-5.918157261396279
ZCTA5 42210,1845,16,1829,0.008672086720867209,-5.919711411610005
ZCTA5 60425,3040,43,2997,0.014144736842105264,-5.920675360936583
ZCTA5 30620,4259,73,4186,0.017140173749706503,-5.9207870032623084
ZCTA5 12466,1013,0,1013,0,-5.921328558364608
ZCTA5 12404,1348,6,1342,0.004451038575667656,-5.921805951869008
ZCTA5 56482,2873,39,2834,0.013574660633484163,-5.92568219080728
ZCTA5 75949,2873,39,2834,0.013574660633484163,-5.92568219080728
ZCTA5 18218,1015,0,1015,0,-5.927171015196195
ZCTA5 01119,4966,91,4875,0.01832460732984293,-5.929187130877672
ZCTA5 44814,1016,0,1016,0,-5.930090085067906
ZCTA5 64136,1016,0,1016,0,-5.930090085067906
ZCTA5 75417,1016,0,1016,0,-5.930090085067906
ZCTA5 81230,4105,69,4036,0.016808769792935444,-5.930837703202938
ZCTA5 22202,13719,334,13385,0.024345797798673373,-5.932925952225529
ZCTA5 74437,3866,63,3803,0.016295913088463527,-5.9329303078541304
ZCTA5 38488,1017,0,1017,0,-5.933007718742618
ZCTA5 47143,1017,0,1017,0,-5.933007718742618
ZCTA5 19135,11945,283,11662,0.02369192130598577,-5.933481895661886
ZCTA5 53556,1190,3,1187,0.0025210084033613447,-5.93419826729506
ZCTA5 03905,1018,0,1018,0,-5.935923918338095
ZCTA5 27959,1300,5,1295,0.0038461538461538464,-5.936702640840765
ZCTA5 60021,2085,21,2064,0.010071942446043165,-5.937498781489077
ZCTA5 16056,2132,22,2110,0.010318949343339587,-5.940621505425919
ZCTA5 27013,2402,28,2374,0.011656952539550375,-5.940900610329732
ZCTA5 52175,1510,9,1501,0.005960264900662252,-5.941407001207921
ZCTA5 61028,1020,0,1020,0,-5.941752023736423
ZCTA5 68002,1020,0,1020,0,-5.941752023736423
ZCTA5 08243,1020,0,1020,0,-5.941752023736423
ZCTA5 55374,5088,94,4994,0.018474842767295597,-5.94198166721119
ZCTA5 77659,1709,13,1696,0.0076067875950848445,-5.942265882038356
ZCTA5 53191,1248,4,1244,0.003205128205128205,-5.942691714472023
ZCTA5 48618,2133,22,2111,0.010314111579934365,-5.943257065476026
ZCTA5 92610,4857,88,4769,0.018118179946469012,-5.943759991608172
ZCTA5 27239,3669,58,3611,0.015808122104115564,-5.9441041425232966
ZCTA5 10548,1356,6,1350,0.004424778761061947,-5.944729634391325
ZCTA5 59044,4741,85,4656,0.017928707023834634,-5.94490480264825
ZCTA5 38827,1303,5,1298,0.003837298541826554,-5.945326354621416
ZCTA5 39520,7781,166,7615,0.021334018763655056,-5.9455459147364484
ZCTA5 85003,3912,64,3848,0.016359918200409,-5.945860054932138
ZCTA5 62441,2839,38,2801,0.013384994716449454,-5.946714474578531
ZCTA5 45645,1022,0,1022,0,-5.94757441810134
ZCTA5 69301,4272,73,4199,0.01708801498127341,-5.948774896942572
ZCTA5 04428,1139,2,1137,0.001755926251097454,-5.949237368476655
ZCTA5 42726,1856,16,1840,0.008620689655172414,-5.949645776631957
ZCTA5 14867,2361,27,2334,0.011435832274459974,-5.949729684614231
ZCTA5 41222,1023,0,1023,0,-5.950483478885752
ZCTA5 55389,1023,0,1023,0,-5.950483478885752
ZCTA5 12308,4977,91,4886,0.01828410689170183,-5.951639628668339
ZCTA5 31825,1024,0,1024,0,-5.95339111818895
ZCTA5 63822,1024,0,1024,0,-5.95339111818895
ZCTA5 72718,1024,0,1024,0,-5.95339111818895
ZCTA5 75765,2928,40,2888,0.01366120218579235,-5.956091254423332
ZCTA5 56515,1360,6,1354,0.004411764705882353,-5.956160195159503
ZCTA5 15774,1025,0,1025,0,-5.956297338092675
ZCTA5 15061,5364,101,5263,0.018829231916480237,-5.956675260689837
ZCTA5 43357,1616,11,1605,0.006806930693069307,-5.957133611416777
ZCTA5 43138,7201,150,7051,0.02083044021663658,-5.957306877039968
ZCTA5 94127,7532,159,7373,0.021109930961232076,-5.957793107549061
ZCTA5 27569,3098,44,3054,0.014202711426726921,-5.958943713152909
ZCTA5 42164,6236,124,6112,0.019884541372674792,-5.959182724371608
ZCTA5 12958,1026,0,1026,0,-5.959202140673589
ZCTA5 12817,1026,0,1026,0,-5.959202140673589
ZCTA5 89460,5557,106,5451,0.019075040489472738,-5.9609892370409
ZCTA5 28227,19815,512,19303,0.025839010850365884,-5.961337295643891
ZCTA5 38610,1027,0,1027,0,-5.962105528003298
ZCTA5 16748,1027,0,1027,0,-5.962105528003298
ZCTA5 23109,1027,0,1027,0,-5.962105528003298
ZCTA5 95465,1027,0,1027,0,-5.962105528003298
ZCTA5 01506,1467,8,1459,0.0054533060668029995,-5.964181703934701
ZCTA5 29405,10203,233,9970,0.022836420660590023,-5.964345659162787
ZCTA5 35091,1028,0,1028,0,-5.965007502148366
ZCTA5 16611,1028,0,1028,0,-5.965007502148366
ZCTA5 43609,8736,192,8544,0.02197802197802198,-5.965112024469256
ZCTA5 68959,1619,11,1608,0.0067943174799258805,-5.965482924419129
ZCTA5 28730,3475,53,3422,0.01525179856115108,-5.967197571194941
ZCTA5 01834,2368,27,2341,0.011402027027027027,-5.967691423066943
ZCTA5 02893,13086,315,12771,0.024071526822558458,-5.968916157126047
ZCTA5 08809,2097,21,2076,0.010014306151645207,-5.969238308512642
ZCTA5 12443,1520,9,1511,0.0059210526315789476,-5.969549791967502
ZCTA5 65259,1030,0,1030,0,-5.970807219125725
ZCTA5 60541,1258,4,1254,0.003179650238473768,-5.971478443802697
ZCTA5 94599,1418,7,1411,0.004936530324400564,-5.971948426119021
ZCTA5 44460,10563,243,10320,0.023004828173814256,-5.972401852761031
ZCTA5 35578,2190,23,2167,0.010502283105022832,-5.973173109173657
ZCTA5 03826,1031,0,1031,0,-5.973704966066091
ZCTA5 55960,1259,4,1255,0.003177124702144559,-5.974349718393093
ZCTA5 59725,3355,50,3305,0.014903129657228018,-5.975572735980821
ZCTA5 39629,2722,35,2687,0.012858192505510653,-5.975734443291807
ZCTA5 98282,6990,144,6846,0.020600858369098713,-5.9761219821270775
ZCTA5 47885,3561,55,3506,0.015445099691098006,-5.976436938239301
ZCTA5 77510,5374,101,5273,0.018794194268701155,-5.976509035636682
ZCTA5 16061,1032,0,1032,0,-5.976601308037996
ZCTA5 37921,10495,241,10254,0.022963315864697475,-5.976796957512821
ZCTA5 31639,4047,67,3980,0.016555473190017298,-5.978400462940811
ZCTA5 39482,3806,61,3745,0.01602732527588019,-5.978858543280754
ZCTA5 60559,10390,238,10152,0.022906641000962465,-5.97894992929358
ZCTA5 54661,1574,10,1564,0.0063532401524777635,-5.979308688241225
ZCTA5 55076,8889,196,8693,0.022049724378445268,-5.979526582523789
ZCTA5 49343,2101,21,2080,0.009995240361732508,-5.9797886588799845
ZCTA5 40484,4484,78,4406,0.017395182872435324,-5.980207388113498
ZCTA5 67068,1772,14,1758,0.007900677200902935,-5.982002980595406
ZCTA5 32564,1034,0,1034,0,-5.982389785237926
ZCTA5 49629,1034,0,1034,0,-5.982389785237926
ZCTA5 24520,1034,0,1034,0,-5.982389785237926
ZCTA5 61568,1474,8,1466,0.005427408412483039,-5.983923569752772
ZCTA5 31793,3276,48,3228,0.014652014652014652,-5.984730017044948
ZCTA5 33411,24028,637,23391,0.02651073747294823,-5.985509738198171
ZCTA5 41039,1152,2,1150,0.001736111111111111,-5.986832042956306
ZCTA5 49022,13134,316,12818,0.024059692401400944,-5.9873956395933705
ZCTA5 98005,7807,166,7641,0.02126296913026771,-5.990382455513577
ZCTA5 47246,1628,11,1617,0.006756756756756757,-5.990468961383005
ZCTA5 98548,1210,3,1207,0.0024793388429752068,-5.991918432958887
ZCTA5 46932,1373,6,1367,0.004369992716678805,-5.9931670625047255
ZCTA5 61250,1038,0,1038,0,-5.99394996951712
ZCTA5 75568,1038,0,1038,0,-5.99394996951712
ZCTA5 73173,1038,0,1038,0,-5.99394996951712
ZCTA5 24271,1038,0,1038,0,-5.99394996951712
ZCTA5 19130,13278,320,12958,0.024100015062509413,-5.994289621859706
ZCTA5 76258,2643,33,2610,0.012485811577752554,-5.994842864815413
ZCTA5 72476,2424,28,2396,0.01155115511551155,-5.997012122183958
ZCTA5 12157,1680,12,1668,0.007142857142857143,-5.997380683913371
ZCTA5 29544,1969,18,1951,0.009141696292534281,-5.999520917030291
ZCTA5 48418,1480,8,1472,0.005405405405405406,-6.000797495218819
ZCTA5 74021,7115,147,6968,0.020660576247364722,-6.001307073271307
ZCTA5 07832,1323,5,1318,0.003779289493575208,-6.002514385162008
ZCTA5 00687,9943,225,9718,0.02262898521572966,-6.002889774781876
ZCTA5 29829,4218,71,4147,0.01683262209577999,-6.003298993936965
ZCTA5 56479,2247,24,2223,0.010680907877169559,-6.0033192835842355
ZCTA5 28090,3367,50,3317,0.01485001485001485,-6.003389350970291
ZCTA5 17976,2690,34,2656,0.012639405204460967,-6.003609701183024
ZCTA5 22407,19616,505,19111,0.025744290375203916,-6.005102724476067
ZCTA5 57039,1324,5,1319,0.0037764350453172208,-6.005360083441871
ZCTA5 02881,1042,0,1042,0,-6.005487901214145
ZCTA5 24281,1042,0,1042,0,-6.005487901214145
ZCTA5 37187,2648,33,2615,0.012462235649546828,-6.00725736913245
ZCTA5 48661,4497,78,4419,0.01734489659773182,-6.007623156624006
ZCTA5 49071,3452,52,3400,0.015063731170336037,-6.008865833199078
ZCTA5 31326,7488,157,7331,0.02096688034188034,-6.0092048726994705
ZCTA5 05089,1973,18,1955,0.00912316269640142,-6.010189914481479
ZCTA5 77396,17960,456,17504,0.025389755011135856,-6.0102627013477345
ZCTA5 37322,3370,50,3320,0.01483679525222552,-6.010330992258413
ZCTA5 70056,14122,344,13778,0.024359155926922532,-6.010608142304462
ZCTA5 71417,2020,19,2001,0.009405940594059406,-6.010676731657075
ZCTA5 21755,2020,19,2001,0.009405940594059406,-6.010676731657075
ZCTA5 80651,1535,9,1526,0.005863192182410423,-6.011539128942045
ZCTA5 07627,1686,12,1674,0.0071174377224199285,-6.013885150417703
ZCTA5 06438,1045,0,1045,0,-6.0141268237829735
ZCTA5 29376,2695,34,2661,0.01261595547309833,-6.015956544941138
ZCTA5 04270,2161,22,2139,0.01018047200370199,-6.0166868166825775
ZCTA5 66070,1046,0,1046,0,-6.017003708340613
ZCTA5 85616,2343,26,2317,0.011096884336320957,-6.018245626738139
ZCTA5 49453,1163,2,1161,0.0017196904557179708,-6.018461278788009
ZCTA5 37209,15576,386,15190,0.024781715459681563,-6.019177109106122
ZCTA5 28422,3291,48,3243,0.014585232452142206,-6.019720981737869
ZCTA5 75204,17390,439,16951,0.025244393329499713,-6.020720676566053
ZCTA5 85704,14821,364,14457,0.024559746305917278,-6.021762032172983
ZCTA5 47331,9275,206,9069,0.022210242587601077,-6.022006287439159
ZCTA5 22853,1689,12,1677,0.007104795737122558,-6.022122508170302
ZCTA5 17241,4622,81,4541,0.01752488100389442,-6.022498115556128
ZCTA5 42754,6157,121,6036,0.019652428130583075,-6.022601412146486
ZCTA5 52301,1539,9,1530,0.005847953216374269,-6.022691246124715
ZCTA5 37061,1640,11,1629,0.006707317073170732,-6.023640566490958
ZCTA5 59011,1331,5,1326,0.003756574004507889,-6.025243880254567
ZCTA5 61764,5168,95,5073,0.01838235294117647,-6.025489032827612
ZCTA5 27525,5591,106,5485,0.01895904131640136,-6.027432370087758
ZCTA5 27048,3127,44,3083,0.014070994563479372,-6.02773002308309
ZCTA5 75709,1885,16,1869,0.008488063660477453,-6.027969148432556
ZCTA5 57030,1109,1,1108,9.017132551848512e-4,-6.028562246968325
ZCTA5 20769,2120,21,2099,0.00990566037735849,-6.029703641209403
ZCTA5 34602,2614,32,2582,0.01224177505738332,-6.031249128646647
ZCTA5 14170,1051,0,1051,0,-6.031367547611294
ZCTA5 00966,5784,111,5673,0.019190871369294607,-6.032532643671308
ZCTA5 22841,1168,2,1166,0.0017123287671232876,-6.032783909161291
ZCTA5 85087,3087,43,3044,0.013929381276320051,-6.032808923371113
ZCTA5 01523,2304,25,2279,0.010850694444444444,-6.033664136753468
ZCTA5 53139,1052,0,1052,0,-6.034236212481036
ZCTA5 24910,1935,17,1918,0.008785529715762274,-6.034624354304771
ZCTA5 31833,2918,39,2879,0.013365318711446196,-6.0347962300948845
ZCTA5 61244,9319,207,9112,0.022212683764352398,-6.034962860851767
ZCTA5 01337,1053,0,1053,0,-6.037103514240607
ZCTA5 71929,1595,10,1585,0.006269592476489028,-6.037641841310124
ZCTA5 37663,6090,119,5971,0.01954022988505747,-6.0384350621752985
ZCTA5 61559,1170,2,1168,0.0017094017094017094,-6.038503539493761
ZCTA5 45856,1889,16,1873,0.008470089994706194,-6.038705742088306
ZCTA5 61434,1336,5,1331,0.0037425149700598802,-6.03940814347836
ZCTA5 28525,1054,0,1054,0,-6.039969454831297
ZCTA5 61748,1054,0,1054,0,-6.039969454831297
ZCTA5 48054,2921,39,2882,0.013351591920575145,-6.042023327337792
ZCTA5 22624,1055,0,1055,0,-6.042834036189797
ZCTA5 42044,1597,10,1587,0.006261740763932373,-6.043170948796038
ZCTA5 55073,1228,3,1225,0.0024429967426710096,-6.04340416202701
ZCTA5 99003,1891,16,1875,0.008461131676361713,-6.044068054018077
ZCTA5 48821,2398,27,2371,0.011259382819015847,-6.044220150994462
ZCTA5 28665,1056,0,1056,0,-6.0456972602482075
ZCTA5 03285,1056,0,1056,0,-6.0456972602482075
ZCTA5 02910,8314,179,8135,0.021529949482800095,-6.0464580815375815
ZCTA5 06339,3135,44,3091,0.014035087719298246,-6.046616104186401
ZCTA5 03827,1173,2,1171,0.0017050298380221654,-6.047072937117853
ZCTA5 58237,2264,24,2240,0.01060070671378092,-6.0472077685204075
ZCTA5 36605,10079,228,9851,0.022621291794820916,-6.048099279271545
ZCTA5 46940,1057,0,1057,0,-6.048559128934054
ZCTA5 25003,1057,0,1057,0,-6.048559128934054
ZCTA5 49419,2752,35,2717,0.012718023255813954,-6.049466576478822
ZCTA5 03253,2752,35,2717,0.012718023255813954,-6.049466576478822
ZCTA5 20794,3716,58,3658,0.015608180839612486,-6.049835359123423
ZCTA5 44429,1174,2,1172,0.0017035775127768314,-6.049926731020372
ZCTA5 52632,5181,95,5086,0.01833622852731133,-6.051525708804934
ZCTA5 49807,1394,6,1388,0.00430416068866571,-6.0524946498272545
ZCTA5 42408,2710,34,2676,0.012546125461254613,-6.052891060070645
ZCTA5 70763,1447,7,1440,0.0048375950241879755,-6.053635535996307
ZCTA5 28373,1059,0,1059,0,-6.054278807875392
ZCTA5 31560,1118,1,1117,8.944543828264759e-4,-6.054324721975187
ZCTA5 12839,5414,101,5313,0.01865533801256003,-6.055528344628432
ZCTA5 92823,1448,7,1441,0.004834254143646409,-6.056433945118176
ZCTA5 43102,1652,11,1641,0.006658595641646489,-6.05665066781835
ZCTA5 17053,2084,20,2064,0.009596928982725527,-6.056666590633077
ZCTA5 50266,13080,313,12767,0.02392966360856269,-6.057774672083668
ZCTA5 29449,3266,47,3219,0.014390691977954685,-6.058640495139829
ZCTA5 69153,2669,33,2636,0.012364181341326339,-6.059201766796951
ZCTA5 07028,2449,28,2421,0.011433238056349531,-6.060309435456856
ZCTA5 53188,14471,353,14118,0.024393614815838575,-6.06137331058106
ZCTA5 63343,1604,10,1594,0.006234413965087282,-6.062487047124086
ZCTA5 36553,1062,0,1062,0,-6.062848208920085
ZCTA5 23923,1062,0,1062,0,-6.062848208920085
ZCTA5 07407,6890,140,6750,0.020319303338171262,-6.063188220912699
ZCTA5 77657,7666,161,7505,0.0210018262457605,-6.0631934286814335
ZCTA5 56278,1235,3,1232,0.0024291497975708503,-6.063310513381438
ZCTA5 63834,2179,22,2157,0.010096374483708122,-6.063523846957795
ZCTA5 64093,10446,238,10208,0.022783840704575915,-6.064838073704578
ZCTA5 53954,2845,37,2808,0.013005272407732865,-6.0656293414719364
ZCTA5 30110,4878,87,4791,0.01783517835178352,-6.06651456128509
ZCTA5 56093,4917,88,4829,0.017897091722595078,-6.066574056642563
ZCTA5 29670,3724,58,3666,0.015574650912996778,-6.0677229676238476
ZCTA5 53038,1606,10,1596,0.0062266500622665,-6.067995753556439
ZCTA5 52726,1852,15,1837,0.008099352051835854,-6.067998911814965
ZCTA5 72542,1706,12,1694,0.007033997655334115,-6.068615351436697
ZCTA5 18424,2042,19,2023,0.00930460333006856,-6.068785469562216
ZCTA5 49251,2273,24,2249,0.010558732952045754,-6.070344079428187
ZCTA5 37031,1607,10,1597,0.006222775357809583,-6.070748416851152
ZCTA5 33844,11760,275,11485,0.0233843537414966,-6.072839127449295
ZCTA5 51104,8512,184,8328,0.021616541353383457,-6.073605472763455
ZCTA5 48650,3062,42,3020,0.013716525146962769,-6.073832579344009
ZCTA5 45831,1239,3,1236,0.002421307506053269,-6.074656819924415
ZCTA5 28609,2275,24,2251,0.01054945054945055,-6.075476271667927
ZCTA5 11766,4252,71,4181,0.01669802445907808,-6.076254501035996
ZCTA5 06384,1067,0,1067,0,-6.077103691117955
ZCTA5 49913,2764,35,2729,0.012662807525325614,-6.0787848732125935
ZCTA5 57064,2046,19,2027,0.009286412512218964,-6.0793023359685074
ZCTA5 28601,20524,530,19994,0.025823426232703176,-6.079467443212768
ZCTA5 45806,4373,74,4299,0.01692202149554082,-6.0797296576530115
ZCTA5 49073,1952,17,1935,0.008709016393442622,-6.079874303534367
ZCTA5 24521,3853,61,3792,0.015831819361536464,-6.083148881263272
ZCTA5 60053,8336,179,8157,0.021473128598848368,-6.083302957635691
ZCTA5 70435,6453,128,6325,0.019835735316906866,-6.083782825906726
ZCTA5 48906,10245,232,10013,0.022645192776964373,-6.0842481481757265
ZCTA5 77355,9386,208,9178,0.0221606648199446,-6.084644776947228
ZCTA5 21727,1810,14,1796,0.0077348066298342545,-6.085047727969893
ZCTA5 17520,1954,17,1937,0.008700102354145343,-6.085179486405052
ZCTA5 20850,19753,507,19246,0.025666987293069408,-6.086455751547188
ZCTA5 21045,15008,368,14640,0.024520255863539446,-6.086535920037756
ZCTA5 28626,1071,0,1071,0,-6.088484045076794
ZCTA5 80927,1071,0,1071,0,-6.088484045076794
ZCTA5 79935,6155,120,6035,0.01949634443541836,-6.089721217245887
ZCTA5 14821,1354,5,1349,0.003692762186115214,-6.090137644666277
ZCTA5 75571,1072,0,1072,0,-6.0913258114135935
ZCTA5 59105,12230,288,11942,0.023548650858544563,-6.091960747825736
ZCTA5 13037,3364,49,3315,0.014565992865636148,-6.092324287699224
ZCTA5 18847,2282,24,2258,0.010517090271691499,-6.093412707804217
ZCTA5 29569,6496,129,6367,0.019858374384236453,-6.0938718546593265
ZCTA5 00715,1073,0,1073,0,-6.094166252608495
ZCTA5 23922,1073,0,1073,0,-6.094166252608495
ZCTA5 11560,2328,25,2303,0.010738831615120275,-6.095023201724144
ZCTA5 05491,2463,28,2435,0.011368250101502234,-6.095543098456811
ZCTA5 03598,1514,8,1506,0.005284015852047556,-6.095601000710912
ZCTA5 32541,8088,172,7916,0.02126607319485658,-6.095683943216655
ZCTA5 17356,8417,181,8236,0.02150409884757039,-6.096985832109704
ZCTA5 45810,2553,30,2523,0.011750881316098707,-6.098396952288446
ZCTA5 75024,17726,447,17279,0.02521719508067246,-6.098744608069262
ZCTA5 48095,2054,19,2035,0.009250243427458617,-6.100291912653455
ZCTA5 23875,4184,69,4115,0.016491395793499043,-6.101799008522802
ZCTA5 01970,18206,461,17745,0.02532132264088762,-6.102633309495715
ZCTA5 65452,1076,0,1076,0,-6.102679643840784
ZCTA5 66861,1249,3,1246,0.0024019215372297837,-6.102931968676608
ZCTA5 55434,11359,263,11096,0.023153446606215336,-6.105261464339337
ZCTA5 29160,3328,48,3280,0.014423076923076924,-6.1054875532016215
ZCTA5 34428,4025,65,3960,0.016149068322981366,-6.105514070300466
ZCTA5 50643,1077,0,1077,0,-6.105514802945569
ZCTA5 52656,1077,0,1077,0,-6.105514802945569
ZCTA5 38941,1413,6,1407,0.004246284501061571,-6.105700897405078
ZCTA5 67056,1078,0,1078,0,-6.10834864612575
ZCTA5 45414,8969,196,8773,0.021853049392351432,-6.109955844359885
ZCTA5 14203,1079,0,1079,0,-6.111181175211963
ZCTA5 38857,1415,6,1409,0.004240282685512367,-6.111275981040584
ZCTA5 42256,1771,13,1758,0.007340485601355167,-6.111416728596609
ZCTA5 98251,1722,12,1710,0.006968641114982578,-6.112089031050408
ZCTA5 46723,3121,43,3078,0.013777635373277796,-6.113084474691447
ZCTA5 72348,1080,0,1080,0,-6.114012392030611
ZCTA5 12525,1080,0,1080,0,-6.114012392030611
ZCTA5 19094,1521,8,1513,0.005259697567389875,-6.114950547791754
ZCTA5 49246,1363,5,1358,0.003668378576669112,-6.115350818565018
ZCTA5 87015,4980,89,4891,0.0178714859437751,-6.115363763463738
ZCTA5 28636,1918,16,1902,0.008342022940563087,-6.116073092804547
ZCTA5 47124,1573,9,1564,0.00572155117609663,-6.116734550262708
ZCTA5 37412,8720,189,8531,0.021674311926605506,-6.117364707769027
ZCTA5 25271,3828,60,3768,0.01567398119122257,-6.117689326461659
ZCTA5 92127,15584,384,15200,0.024640657084188913,-6.118649452160767
ZCTA5 45830,2292,24,2268,0.010471204188481676,-6.118965779636809
ZCTA5 63730,1255,3,1252,0.002390438247011952,-6.1198354759903
ZCTA5 37134,1084,0,1084,0,-6.125324173009872
ZCTA5 05033,1084,0,1084,0,-6.125324173009872
ZCTA5 80905,7407,153,7254,0.020656136087484813,-6.125340971024186
ZCTA5 01543,2956,39,2917,0.013193504736129905,-6.125912151066579
ZCTA5 44201,2520,29,2491,0.011507936507936509,-6.126676980428712
ZCTA5 29369,5258,96,5162,0.018257892734880182,-6.127917571942819
ZCTA5 21053,1085,0,1085,0,-6.128148855739218
ZCTA5 23505,11763,274,11489,0.023293377539743264,-6.1284855746987095
ZCTA5 68701,12642,299,12343,0.023651320993513684,-6.129525681678706
ZCTA5 77830,1086,0,1086,0,-6.130972237071105
ZCTA5 18614,1086,0,1086,0,-6.130972237071105
ZCTA5 48428,1876,15,1861,0.007995735607675906,-6.132147751594076
ZCTA5 89015,14974,366,14608,0.02444236676906638,-6.132641622525556
ZCTA5 27949,3256,46,3210,0.014127764127764128,-6.132791845150541
ZCTA5 30554,2743,34,2709,0.012395187750637988,-6.1335945739937445
ZCTA5 56087,1260,3,1257,0.002380952380952381,-6.133886780545332
ZCTA5 19475,4240,70,4170,0.01650943396226415,-6.135965614863675
ZCTA5 29384,1731,12,1719,0.006932409012131715,-6.136423684797834
ZCTA5 55003,1088,0,1088,0,-6.136615102726769
ZCTA5 48763,2021,18,2003,0.008906481939633844,-6.137030812452834
ZCTA5 32609,6894,139,6755,0.02016246011024079,-6.1373689690073725
ZCTA5 52172,2701,33,2668,0.012217697149203998,-6.137753588868815
ZCTA5 28071,1089,0,1089,0,-6.139434590632355
ZCTA5 31807,1089,0,1089,0,-6.139434590632355
ZCTA5 13606,1089,0,1089,0,-6.139434590632355
ZCTA5 17364,1478,7,1471,0.004736129905277402,-6.139830216299836
ZCTA5 47905,17008,425,16583,0.02498824082784572,-6.140001429596248
ZCTA5 53588,1782,13,1769,0.007295173961840628,-6.1410040899676455
ZCTA5 95608,25109,665,24444,0.02648452746027321,-6.141766548313966
ZCTA5 08514,1880,15,1865,0.007978723404255319,-6.142783807418248
ZCTA5 26415,1207,2,1205,0.0016570008285004142,-6.143365063452628
ZCTA5 08859,8299,177,8122,0.02132787082781058,-6.143376755318609
ZCTA5 48850,1684,11,1673,0.006532066508313539,-6.143904554648494
ZCTA5 97007,25312,671,24641,0.026509165613147916,-6.144744997286862
ZCTA5 10306,20007,513,19494,0.02564102564102564,-6.1458844774642305
ZCTA5 39044,1374,5,1369,0.00363901018922853,-6.146031913666673
ZCTA5 10595,2303,24,2279,0.010421189752496743,-6.146979257349819
ZCTA5 75044,15054,368,14686,0.02444533014481201,-6.146979931487891
ZCTA5 30529,4085,66,4019,0.016156670746634027,-6.148150507631051
ZCTA5 44103,7198,147,7051,0.020422339538760766,-6.148612649666542
ZCTA5 48226,4045,65,3980,0.016069221260815822,-6.148905335883386
ZCTA5 73114,7716,161,7555,0.02086573354069466,-6.149414767701072
ZCTA5 03261,1636,10,1626,0.006112469437652812,-6.150091541400523
ZCTA5 45064,1093,0,1093,0,-6.150699617702711
ZCTA5 17018,1786,13,1773,0.007278835386338186,-6.151732370712586
ZCTA5 59808,7938,167,7771,0.021038044847568656,-6.151875697473402
ZCTA5 30326,3680,56,3624,0.015217391304347827,-6.15229390532059
ZCTA5 35576,1377,5,1372,0.0036310820624546117,-6.154373962581741
ZCTA5 48422,2576,30,2546,0.011645962732919254,-6.155419031088195
ZCTA5 28159,1095,0,1095,0,-6.156324401336066
ZCTA5 24620,1095,0,1095,0,-6.156324401336066
ZCTA5 62293,1739,12,1727,0.006900517538815411,-6.157983245406769
ZCTA5 45320,6002,115,5887,0.019160279906697768,-6.15834467581357
ZCTA5 02114,7426,153,7273,0.02060328575276057,-6.158519390245714
ZCTA5 97449,1096,0,1096,0,-6.1591348668562755
ZCTA5 13480,1379,5,1374,0.0036258158085569255,-6.159929292855006
ZCTA5 46552,2578,30,2548,0.011636927851047323,-6.160359191132741
ZCTA5 61085,1486,7,1479,0.004710632570659489,-6.1618903534374185
ZCTA5 64020,1486,7,1479,0.004710632570659489,-6.1618903534374185
ZCTA5 27846,1270,3,1267,0.002362204724409449,-6.161894951447407
ZCTA5 45054,1097,0,1097,0,-6.161944050522001
ZCTA5 52322,1097,0,1097,0,-6.161944050522001
ZCTA5 17532,1097,0,1097,0,-6.161944050522001
ZCTA5 49087,2355,25,2330,0.010615711252653927,-6.163492958718169
ZCTA5 42025,8165,173,7992,0.021187997550520515,-6.163864987734243
ZCTA5 48883,2712,33,2679,0.012168141592920354,-6.16459069299398
ZCTA5 60429,5816,110,5706,0.01891334250343879,-6.166899039349813
ZCTA5 31404,11719,272,11447,0.023210171516340986,-6.167104308578751
ZCTA5 06442,1099,0,1099,0,-6.167558579295464
ZCTA5 98631,1693,11,1682,0.006497341996455995,-6.168246094103121
ZCTA5 64137,4175,68,4107,0.0162874251497006,-6.168525251927062
ZCTA5 29615,16998,424,16574,0.02494411107189081,-6.170191975942326
ZCTA5 12106,1100,0,1100,0,-6.170363927895977
ZCTA5 08361,6425,126,6299,0.01961089494163424,-6.170794032876418
ZCTA5 60552,1744,12,1732,0.006880733944954129,-6.171424191127062
ZCTA5 30344,13128,312,12816,0.02376599634369287,-6.173165255064861
ZCTA5 37409,1101,0,1101,0,-6.173168001627583
ZCTA5 40402,1101,0,1101,0,-6.173168001627583
ZCTA5 13044,1101,0,1101,0,-6.173168001627583
ZCTA5 95677,9153,200,8953,0.021850759313886157,-6.173529278753007
ZCTA5 49868,1695,11,1684,0.006489675516224189,-6.173643671299825
ZCTA5 46613,3566,53,3513,0.014862591138530567,-6.174075606554105
ZCTA5 37916,2584,30,2554,0.011609907120743035,-6.1751622622931865
ZCTA5 67218,9551,211,9340,0.022091927546853733,-6.175251574153721
ZCTA5 49746,1491,7,1484,0.004694835680751174,-6.175640358184198
ZCTA5 03242,1795,13,1782,0.0072423398328690805,-6.1758115287288655
ZCTA5 21791,2037,18,2019,0.008836524300441826,-6.178834725422614
ZCTA5 71342,2718,33,2685,0.012141280353200883,-6.179193947463859
ZCTA5 23924,2224,22,2202,0.009892086330935251,-6.179391272885824
ZCTA5 04358,1747,12,1735,0.006868918145392101,-6.179476357836568
ZCTA5 02062,11764,273,11491,0.023206392383543013,-6.1812130156729115
ZCTA5 39661,1104,0,1104,0,-6.181572590954107
ZCTA5 20650,5208,94,5114,0.01804915514592934,-6.182483892283706
ZCTA5 54727,2040,18,2022,0.008823529411764706,-6.18664700819082
ZCTA5 13033,1389,5,1384,0.003599712023038157,-6.187633972478563
ZCTA5 67005,6132,118,6014,0.019243313763861708,-6.1885213183640335
ZCTA5 38251,1107,0,1107,0,-6.189965768738263
ZCTA5 37402,2182,21,2161,0.009624197983501375,-6.190354195860951
ZCTA5 13131,1390,5,1385,0.0035971223021582736,-6.19039787898364
ZCTA5 48214,9849,219,9630,0.022235759975632045,-6.191467491671052
ZCTA5 40385,1108,0,1108,0,-6.1927609667893915
ZCTA5 42050,1108,0,1108,0,-6.1927609667893915
ZCTA5 01022,1108,0,1108,0,-6.1927609667893915
ZCTA5 38472,1225,2,1223,0.0016326530612244899,-6.193742605358163
ZCTA5 10987,1337,4,1333,0.0029917726252804786,-6.194326046787709
ZCTA5 13833,1602,9,1593,0.0056179775280898875,-6.195915296173268
ZCTA5 35118,1110,0,1110,0,-6.198347581337132
ZCTA5 39507,7449,153,7296,0.02053966975432944,-6.1985828131045375
ZCTA5 65781,3200,44,3156,0.01375,-6.198663075443209
ZCTA5 40324,17706,444,17262,0.02507624534056252,-6.199603876665244
ZCTA5 48622,2505,28,2477,0.011177644710578843,-6.200347203710352
ZCTA5 04841,3453,50,3403,0.014480162177816391,-6.200437411702908
ZCTA5 32344,5023,89,4934,0.01771849492335258,-6.202007766338469
ZCTA5 26570,1340,4,1336,0.0029850746268656717,-6.202635175534781
ZCTA5 41256,1112,0,1112,0,-6.203929165161823
ZCTA5 03278,1112,0,1112,0,-6.203929165161823
ZCTA5 07641,1112,0,1112,0,-6.203929165161823
ZCTA5 29436,1707,11,1696,0.006444053895723492,-6.20594089049976
ZCTA5 96067,3330,47,3283,0.014114114114114115,-6.206471573963723
ZCTA5 01083,1113,0,1113,0,-6.206718074794784
ZCTA5 25248,1113,0,1113,0,-6.206718074794784
ZCTA5 16371,1342,4,1338,0.0029806259314456036,-6.208168582071392
ZCTA5 61528,1114,0,1114,0,-6.209505731829473
ZCTA5 65084,2419,26,2393,0.010748243075651096,-6.210432344730401
ZCTA5 08084,2599,30,2569,0.011542901115813775,-6.2120563724870435
ZCTA5 62869,1115,0,1115,0,-6.212292137952132
ZCTA5 24380,1115,0,1115,0,-6.212292137952132
ZCTA5 26408,1115,0,1115,0,-6.212292137952132
ZCTA5 10590,2688,32,2656,0.011904761904761904,-6.213191285311905
ZCTA5 08406,4196,68,4128,0.016205910390848427,-6.213383578768105
ZCTA5 62069,1289,3,1286,0.0023273855702094647,-6.214768718255392
ZCTA5 86323,6864,137,6727,0.01995920745920746,-6.217646426573555
ZCTA5 29438,1117,0,1117,0,-6.2178612041874555
ZCTA5 21738,1117,0,1117,0,-6.2178612041874555
ZCTA5 23149,1117,0,1117,0,-6.2178612041874555
ZCTA5 27288,9974,222,9752,0.02225787046320433,-6.218353625814645
ZCTA5 53805,2005,17,1988,0.008478802992518703,-6.219186698201778
ZCTA5 63461,2240,22,2218,0.009821428571428571,-6.220176640497397
ZCTA5 97133,1611,9,1602,0.00558659217877095,-6.2203006566510775
ZCTA5 36027,6111,117,5994,0.01914580265095729,-6.220306421808701
ZCTA5 52338,1291,3,1288,0.0023237800154918666,-6.22030867807772
ZCTA5 56150,1119,0,1119,0,-6.223425286915323
ZCTA5 42437,2911,37,2874,0.012710408794228788,-6.2240549133580725
ZCTA5 24426,5961,113,5848,0.01895655091427613,-6.22474793881014
ZCTA5 53036,1120,0,1120,0,-6.226205463639621
ZCTA5 70506,17283,431,16852,0.024937800150436847,-6.22631763688069
ZCTA5 07632,1814,13,1801,0.007166482910694598,-6.226377903216376
ZCTA5 54495,3423,49,3374,0.014314928425357873,-6.227204406334347
ZCTA5 79510,2782,34,2748,0.012221423436376708,-6.228012981999144
ZCTA5 55102,9187,200,8987,0.021769892239033417,-6.228089249451323
ZCTA5 55060,11691,270,11421,0.023094688221709007,-6.229172174889795
ZCTA5 98296,9981,222,9759,0.022242260294559665,-6.229208109128719
ZCTA5 66018,2336,24,2312,0.010273972602739725,-6.230432326795781
ZCTA5 75707,5388,98,5290,0.018188567186340016,-6.23150799912626
ZCTA5 45053,1122,0,1122,0,-6.231762096127665
ZCTA5 50849,1122,0,1122,0,-6.231762096127665
ZCTA5 67215,2105,19,2086,0.009026128266033254,-6.232743599723146
ZCTA5 02540,4003,63,3940,0.015738196352735448,-6.233370096034683
ZCTA5 07946,1123,0,1123,0,-6.234538555207776
ZCTA5 21661,1123,0,1123,0,-6.234538555207776
ZCTA5 35116,1718,11,1707,0.006402793946449359,-6.235414990769338
ZCTA5 63459,1513,7,1506,0.004626569729015202,-6.23580173012162
ZCTA5 07082,1617,9,1608,0.0055658627087198514,-6.2365089233371975
ZCTA5 11563,8062,169,7893,0.020962540312577525,-6.237440331851229
ZCTA5 74023,4167,67,4100,0.016078713702903768,-6.237536490173036
ZCTA5 37854,5119,91,5028,0.017776909552647,-6.23775170566221
ZCTA5 46204,3760,57,3703,0.015159574468085106,-6.238522787118972
ZCTA5 16673,2201,21,2180,0.009541117673784643,-6.238922974246632
ZCTA5 07054,11166,255,10911,0.022837184309511014,-6.239020849704556
ZCTA5 45832,1125,0,1125,0,-6.240087767303428
ZCTA5 50115,1125,0,1125,0,-6.240087767303428
ZCTA5 53049,1125,0,1125,0,-6.240087767303428
ZCTA5 61883,1670,10,1660,0.005988023952095809,-6.24195110803544
ZCTA5 49953,1244,2,1242,0.001607717041800643,-6.246481922559406
ZCTA5 34984,5512,101,5411,0.01832365747460087,-6.247031110756046
ZCTA5 45858,1128,0,1128,0,-6.248402344965173
ZCTA5 08515,1723,11,1712,0.006384213580963436,-6.248771091829181
ZCTA5 18403,3008,39,2969,0.012965425531914893,-6.24912326488175
ZCTA5 28351,1873,14,1859,0.007474639615589963,-6.25265776931481
ZCTA5 54467,5823,109,5714,0.01871887343293835,-6.253134384351038
ZCTA5 64060,4931,86,4845,0.017440681403366458,-6.253436662131535
ZCTA5 77702,1130,0,1130,0,-6.253939255528779
ZCTA5 24983,1130,0,1130,0,-6.253939255528779
ZCTA5 18011,2066,18,2048,0.008712487899322363,-6.254015038354608
ZCTA5 62707,3096,41,3055,0.013242894056847546,-6.254017035228882
ZCTA5 77625,3393,48,3345,0.014146772767462422,-6.254327141740814
ZCTA5 16102,2437,26,2411,0.010668855149774312,-6.255290139897678
ZCTA5 53534,4893,85,4808,0.017371755569180462,-6.256106702603999
ZCTA5 30646,2617,30,2587,0.01146350783339702,-6.25611729186537
ZCTA5 46106,2301,23,2278,0.009995654063450673,-6.257825655282729
ZCTA5 08825,1625,9,1616,0.005538461538461538,-6.258059940428322
ZCTA5 37871,3729,56,3673,0.015017430946634486,-6.2610232576378415
ZCTA5 84741,2163,20,2143,0.009246417013407305,-6.261051986273179
ZCTA5 65041,2394,25,2369,0.010442773600668337,-6.261374665001353
ZCTA5 18840,4817,83,4734,0.017230641478098403,-6.2617959484982215
ZCTA5 54893,1778,12,1766,0.006749156355455568,-6.262145011274194
ZCTA5 70092,2303,23,2280,0.00998697351280938,-6.26286130971518
ZCTA5 24368,2164,20,2144,0.009242144177449169,-6.263604497290837
ZCTA5 52645,1417,5,1412,0.0035285815102328866,-6.264579480193173
ZCTA5 38635,5714,106,5608,0.01855092754637732,-6.264931755074515
ZCTA5 31044,1134,0,1134,0,-6.264998396360455
ZCTA5 18091,2304,23,2281,0.009982638888888888,-6.265377939995865
ZCTA5 20008,15767,386,15381,0.024481512018773386,-6.2655995633806745
ZCTA5 32413,6288,121,6167,0.01924300254452926,-6.266883130267906
ZCTA5 24550,3187,43,3144,0.01349231251961092,-6.266959036605843
ZCTA5 04217,1308,3,1305,0.0022935779816513763,-6.267203914165005
ZCTA5 75248,16389,404,15985,0.024650680334370616,-6.267554920254728
ZCTA5 12834,2443,26,2417,0.010642652476463364,-6.270188092236008
ZCTA5 44270,3358,47,3311,0.01399642644431209,-6.270436000906014
ZCTA5 38313,1136,0,1136,0,-6.270520652519746
ZCTA5 02575,1136,0,1136,0,-6.270520652519746
ZCTA5 60646,10904,247,10657,0.022652237710931767,-6.2727894388270125
ZCTA5 54848,2624,30,2594,0.011432926829268292,-6.273190270898956
ZCTA5 66032,2026,17,2009,0.00839091806515301,-6.273669880179109
ZCTA5 61554,17390,433,16957,0.02489936745255894,-6.273746360053357
ZCTA5 19106,6519,127,6392,0.019481515569872678,-6.273862877401774
ZCTA5 90815,14459,348,14111,0.024068054498928005,-6.276562270131808
ZCTA5 56441,1581,8,1573,0.005060088551549652,-6.278532110589185
ZCTA5 20662,1139,0,1139,0,-6.278794930127362
ZCTA5 34287,11122,253,10869,0.02274770724689804,-6.2791928550176825
ZCTA5 23602,16192,398,15794,0.0245800395256917,-6.279760604957426
ZCTA5 97210,6523,127,6396,0.019469569216618122,-6.281153023395777
ZCTA5 44040,1140,0,1140,0,-6.2815506006265585
ZCTA5 01827,1140,0,1140,0,-6.2815506006265585
ZCTA5 68787,2448,26,2422,0.010620915032679739,-6.282582344945245
ZCTA5 60096,2628,30,2598,0.01141552511415525,-6.282930829769742
ZCTA5 16423,1786,12,1774,0.006718924972004479,-6.283322229240396
ZCTA5 17841,1736,11,1725,0.006336405529953917,-6.283377649840175
ZCTA5 45623,1141,0,1141,0,-6.284305062763159
ZCTA5 80220,15989,392,15597,0.024516855338044905,-6.284702195223606
ZCTA5 30034,16265,400,15865,0.02459268367660621,-6.2849328448370185
ZCTA5 24649,1142,0,1142,0,-6.287058318125376
ZCTA5 33578,18564,467,18097,0.025156216332686922,-6.287443359808895
ZCTA5 45381,2079,18,2061,0.008658008658008658,-6.287474479422213
ZCTA5 03079,11413,261,11152,0.022868658547270656,-6.28895023077677
ZCTA5 07848,1739,11,1728,0.0063254744105807935,-6.291339489796892
ZCTA5 01922,1144,0,1144,0,-6.292561214862122
ZCTA5 18518,3702,55,3647,0.014856834143706105,-6.292655288765598
ZCTA5 74401,6416,124,6292,0.019326683291770574,-6.293071580194838
ZCTA5 43314,1145,0,1145,0,-6.295310859395736
ZCTA5 54941,1145,0,1145,0,-6.295310859395736
ZCTA5 08097,1145,0,1145,0,-6.295310859395736
ZCTA5 68507,6190,118,6072,0.019063004846526656,-6.296610418615482
ZCTA5 54024,2130,19,2111,0.00892018779342723,-6.2968362508716
ZCTA5 43469,1146,0,1146,0,-6.298059303473147
ZCTA5 63135,8282,174,8108,0.02100941801497223,-6.298248260670615
ZCTA5 75833,1263,2,1261,0.001583531274742676,-6.29878335563107
ZCTA5 33953,2986,38,2948,0.012726054922973878,-6.298969748667711
ZCTA5 81008,4317,70,4247,0.016214964095436647,-6.299026385648911
ZCTA5 93536,21529,554,20975,0.025732732593246318,-6.300538859770142
ZCTA5 79068,1264,2,1262,0.0015822784810126582,-6.301524136791216
ZCTA5 45680,4877,84,4793,0.017223703096165676,-6.303367987607791
ZCTA5 62675,2592,29,2563,0.011188271604938271,-6.304090172169799
ZCTA5 08852,6612,129,6483,0.019509981851179675,-6.305583414713806
ZCTA5 48458,7919,164,7755,0.02070968556635939,-6.307006723990497
ZCTA5 56751,2228,21,2207,0.009425493716337522,-6.307423928233996
ZCTA5 30346,3033,39,2994,0.012858555885262116,-6.307768875671421
ZCTA5 22958,1150,0,1150,0,-6.309041106588217
ZCTA5 04071,2135,19,2116,0.008899297423887589,-6.309590518473292
ZCTA5 26164,3034,39,2995,0.012854317732366513,-6.3101068641548785
ZCTA5 80033,11747,270,11477,0.022984591810675067,-6.310432242808065
ZCTA5 27937,1645,9,1636,0.00547112462006079,-6.311641262554276
ZCTA5 61753,1151,0,1151,0,-6.31178357188035
ZCTA5 45252,1896,14,1882,0.007383966244725738,-6.312887662444418
ZCTA5 49234,1152,0,1152,0,-6.314524846090754
ZCTA5 66542,1152,0,1152,0,-6.314524846090754
ZCTA5 72390,3165,42,3123,0.013270142180094787,-6.314799238853271
ZCTA5 10965,5431,98,5333,0.0180445590130731,-6.315343250438244
ZCTA5 02747,6919,137,6782,0.019800549212313917,-6.315898954430902
ZCTA5 45206,6010,113,5897,0.018801996672212978,-6.316911359200226
ZCTA5 24230,3337,46,3291,0.013784836679652383,-6.318771384382727
ZCTA5 73554,1327,3,1324,0.002260738507912585,-6.31921113766008
ZCTA5 33332,3210,43,3167,0.01339563862928349,-6.319991782266591
ZCTA5 50423,1154,0,1154,0,-6.320003827465222
ZCTA5 36603,2733,32,2701,0.011708744968898645,-6.321970261987987
ZCTA5 95742,3507,50,3457,0.014257199885942401,-6.322160458436122
ZCTA5 32124,1598,8,1590,0.0050062578222778474,-6.324164307203454
ZCTA5 94566,16434,404,16030,0.024583181209687235,-6.324274382900843
ZCTA5 76002,9646,211,9435,0.02187435206303131,-6.324722616066198
ZCTA5 98686,7597,155,7442,0.020402790575227064,-6.3262050784123005
ZCTA5 55001,1157,0,1157,0,-6.3282134050687215
ZCTA5 13685,1157,0,1157,0,-6.3282134050687215
ZCTA5 38330,1753,11,1742,0.006274957216200799,-6.328375594408442
ZCTA5 68118,3510,50,3460,0.014245014245014245,-6.328878780339221
ZCTA5 95722,1951,15,1936,0.007688364941055869,-6.32902536389527
ZCTA5 43821,1600,8,1592,0.005,-6.329512642172684
ZCTA5 42450,1600,8,1592,0.005,-6.329512642172684
ZCTA5 37010,1652,9,1643,0.005447941888619854,-6.330296048566225
ZCTA5 22728,1158,0,1158,0,-6.330947565233049
ZCTA5 07821,3469,49,3420,0.014125108100317094,-6.33108081105201
ZCTA5 30047,20643,527,20116,0.025529235091798674,-6.332126842635122
ZCTA5 33324,19217,485,18732,0.02523807045844825,-6.333967476715258
ZCTA5 53574,1497,6,1491,0.004008016032064128,-6.335834091207889
ZCTA5 46349,1160,0,1160,0,-6.33641234619464
ZCTA5 47383,1160,0,1160,0,-6.33641234619464
ZCTA5 95661,12084,279,11805,0.023088381330685203,-6.336860996045443
ZCTA5 00961,11446,261,11185,0.02280272584308929,-6.337263252676522
ZCTA5 35761,4894,84,4810,0.0171638741315897,-6.337620318546923
ZCTA5 15824,2240,21,2219,0.009375,-6.337676984511179
ZCTA5 35541,1444,5,1439,0.0034626038781163434,-6.337924153136546
ZCTA5 07033,2828,34,2794,0.012022630834512023,-6.3380815099826195
ZCTA5 42217,1334,3,1331,0.0022488755622188904,-6.338265850449828
ZCTA5 32608,19357,489,18868,0.025262179056672007,-6.338344535237666
ZCTA5 65725,1161,0,1161,0,-6.339142970043085
ZCTA5 42064,3304,45,3259,0.013619854721549637,-6.340187716762004
ZCTA5 17820,2334,23,2311,0.00985432733504713,-6.340509258261695
ZCTA5 15021,3004,38,2966,0.012649800266311585,-6.341169051360951
ZCTA5 48634,1907,14,1893,0.007341373885684321,-6.341517443210856
ZCTA5 26351,1391,4,1387,0.002875629043853343,-6.342268130620277
ZCTA5 50441,2195,20,2175,0.009111617312072893,-6.342316984491737
ZCTA5 19975,4176,66,4110,0.015804597701149427,-6.342778281744674
ZCTA5 40935,1163,0,1163,0,-6.344600692078601
ZCTA5 06018,1163,0,1163,0,-6.344600692078601
ZCTA5 24656,1163,0,1163,0,-6.344600692078601
ZCTA5 21213,11238,255,10983,0.022690870261612386,-6.345360455170136
ZCTA5 22824,2519,27,2492,0.01071853910281858,-6.345790889626407
ZCTA5 02557,1760,11,1749,0.00625,-6.346820679215005
ZCTA5 71655,5680,104,5576,0.018309859154929577,-6.347301176519319
ZCTA5 13346,1710,10,1700,0.005847953216374269,-6.348473993903948
ZCTA5 77384,7163,143,7020,0.019963702359346643,-6.34950956764171
ZCTA5 89423,4542,75,4467,0.016512549537648614,-6.349560923003923
ZCTA5 28480,1165,0,1165,0,-6.350053723331943
ZCTA5 22567,1165,0,1165,0,-6.350053723331943
ZCTA5 97487,3394,47,3347,0.013847967000589274,-6.35205601056302
ZCTA5 24609,2922,36,2886,0.012320328542094456,-6.353065440172124
ZCTA5 48043,6827,134,6693,0.019627947854108686,-6.3530770373560905
ZCTA5 56444,1395,4,1391,0.002867383512544803,-6.353093240623744
ZCTA5 60940,1283,2,1281,0.001558846453624318,-6.353376143394541
ZCTA5 48341,6828,134,6694,0.01962507322788518,-6.354863275785381
ZCTA5 23062,1167,0,1167,0,-6.355502075877205
ZCTA5 81521,6260,119,6141,0.01900958466453674,-6.355617887099559
ZCTA5 60628,22996,596,22400,0.025917550878413638,-6.355803147075071
ZCTA5 60409,13822,328,13494,0.023730285052814354,-6.357581661283467
ZCTA5 30739,2059,17,2042,0.00825643516270034,-6.358492885223514
ZCTA5 28512,1612,8,1604,0.004962779156327543,-6.361514566726685
ZCTA5 24121,4628,77,4551,0.016637856525496975,-6.36198537218135
ZCTA5 15208,4429,72,4357,0.016256491307292842,-6.364844853832421
ZCTA5 99206,15152,366,14786,0.02415522703273495,-6.365542442794388
ZCTA5 38450,1171,0,1171,0,-6.366384792881645
ZCTA5 43718,1171,0,1171,0,-6.366384792881645
ZCTA5 06093,1171,0,1171,0,-6.366384792881645
ZCTA5 24440,1171,0,1171,0,-6.366384792881645
ZCTA5 55116,11218,254,10964,0.022642182207167055,-6.368389229486546
ZCTA5 62535,1172,0,1172,0,-6.36910256666302
ZCTA5 71744,1172,0,1172,0,-6.36910256666302
ZCTA5 76123,10647,238,10409,0.022353714661406968,-6.369724849389833
ZCTA5 98354,2842,34,2808,0.011963406052076003,-6.371308608311406
ZCTA5 99353,5265,93,5172,0.017663817663817662,-6.371714943759835
ZCTA5 74403,12144,280,11864,0.0230566534914361,-6.372017495560435
ZCTA5 14141,3233,43,3190,0.013300340241261985,-6.37272672156708
ZCTA5 79605,11114,251,10863,0.022584128126687062,-6.372835831683192
ZCTA5 04950,1870,13,1857,0.006951871657754011,-6.373364977254583
ZCTA5 11703,5305,94,5211,0.017719132893496702,-6.373467901758586
ZCTA5 05301,7364,148,7216,0.020097772949483977,-6.373998227655456
ZCTA5 05663,2208,20,2188,0.009057971014492754,-6.375089135596637
ZCTA5 01505,1771,11,1760,0.006211180124223602,-6.375708634226374
ZCTA5 06784,1512,6,1506,0.003968253968253968,-6.376095835476352
ZCTA5 49038,3947,60,3887,0.015201418799087915,-6.3771544086070415
ZCTA5 49283,1175,0,1175,0,-6.377248938656062
ZCTA5 01235,1175,0,1175,0,-6.377248938656062
ZCTA5 02668,1175,0,1175,0,-6.377248938656062
ZCTA5 66617,3363,46,3317,0.01367826345524829,-6.377709368746187
ZCTA5 48471,2256,21,2235,0.009308510638297872,-6.377833710232105
ZCTA5 76179,19425,490,18935,0.025225225225225224,-6.378109876676087
ZCTA5 32091,5619,102,5517,0.018152696209289908,-6.378641267305974
ZCTA5 44264,1176,0,1176,0,-6.379962084466386
ZCTA5 24556,1176,0,1176,0,-6.379962084466386
ZCTA5 49690,2802,33,2769,0.011777301927194861,-6.381096861545964
ZCTA5 68847,7031,139,6892,0.01976959180770872,-6.3812480980572275
ZCTA5 54923,3784,56,3728,0.014799154334038054,-6.381696945804465
ZCTA5 59711,3950,60,3890,0.015189873417721518,-6.383612738789832
ZCTA5 29045,9321,201,9120,0.02156420984872868,-6.383776868625406
ZCTA5 17370,2069,17,2052,0.008216529724504592,-6.384009196428891
ZCTA5 29439,1178,0,1178,0,-6.385384917646411
ZCTA5 47355,1178,0,1178,0,-6.385384917646411
ZCTA5 24092,1178,0,1178,0,-6.385384917646411
ZCTA5 54201,2165,19,2146,0.008775981524249422,-6.385674405491395
ZCTA5 57032,2626,29,2597,0.011043412033511044,-6.386583449368839
ZCTA5 08223,1725,10,1715,0.005797101449275362,-6.388002672688602
ZCTA5 16617,1179,0,1179,0,-6.388094607951972
ZCTA5 42301,18273,456,17817,0.024954851420128057,-6.389343503018761
ZCTA5 01756,2023,16,2007,0.007909045971329708,-6.389552654300213
ZCTA5 47635,2262,21,2241,0.009283819628647215,-6.392839768510978
ZCTA5 32208,12336,285,12051,0.023103112840466927,-6.39349549860778
ZCTA5 59873,1465,5,1460,0.0034129692832764505,-6.394408743190014
ZCTA5 25570,2402,24,2378,0.009991673605328892,-6.3947760024083555
ZCTA5 08501,2310,22,2288,0.009523809523809525,-6.396167347821367
ZCTA5 02556,1182,0,1182,0,-6.396216791280723
ZCTA5 07731,12621,293,12328,0.023215276127089773,-6.3968539900694585
ZCTA5 28640,2122,18,2104,0.008482563619227144,-6.397108220526225
ZCTA5 18347,1183,0,1183,0,-6.398921894717911
ZCTA5 22578,1183,0,1183,0,-6.398921894717911
ZCTA5 62806,1467,5,1462,0.0034083162917518746,-6.399763122645246
ZCTA5 04037,1243,1,1242,8.045052292839903e-4,-6.401452004050224
ZCTA5 33946,1184,0,1184,0,-6.401625855072996
ZCTA5 61053,1184,0,1184,0,-6.401625855072996
ZCTA5 68305,1781,11,1770,0.006176305446378439,-6.401868350591849
ZCTA5 47201,17357,429,16928,0.02471625280866509,-6.401951026414839
ZCTA5 49101,1301,2,1299,0.0015372790161414297,-6.402114771542201
ZCTA5 55779,1522,6,1516,0.003942181340341655,-6.402802658109429
ZCTA5 48504,10992,247,10745,0.02247088791848617,-6.403785588480249
ZCTA5 72006,1185,0,1185,0,-6.404328673793832
ZCTA5 45865,1882,13,1869,0.006907545164718385,-6.404475480318607
ZCTA5 77441,3670,53,3617,0.01444141689373297,-6.4053519944460025
ZCTA5 01452,1732,10,1722,0.005773672055427252,-6.406373197447895
ZCTA5 73045,4409,71,4338,0.01610342481288274,-6.406979208874845
ZCTA5 48367,1681,9,1672,0.005353955978584176,-6.407046236024527
ZCTA5 15473,1681,9,1672,0.005353955978584176,-6.407046236024527
ZCTA5 67060,5244,92,5152,0.017543859649122806,-6.407303646568396
ZCTA5 76126,8496,178,8318,0.020951035781544256,-6.4090262249349275
ZCTA5 65453,3462,48,3414,0.01386481802426343,-6.409859465817624
ZCTA5 47111,5906,109,5797,0.018455807653234,-6.409970161174816
ZCTA5 34953,21593,553,21040,0.02561015143796601,-6.410068133884925
ZCTA5 11709,2500,26,2474,0.0104,-6.410385357705125
ZCTA5 27349,2175,19,2156,0.008735632183908045,-6.410869689848456
ZCTA5 55733,1734,10,1724,0.0057670126874279125,-6.411613089079027
ZCTA5 53210,9812,214,9598,0.021810028536485934,-6.4143455107472045
ZCTA5 07416,2129,18,2111,0.008454673555659934,-6.4148073395683065
ZCTA5 62896,5130,89,5041,0.017348927875243666,-6.4149197531718
ZCTA5 48651,2364,23,2341,0.00972927241962775,-6.414941233649639
ZCTA5 95864,9343,201,9142,0.02151343251632238,-6.418600687379554
ZCTA5 65738,7315,146,7169,0.019958988380041013,-6.418766833187191
ZCTA5 44401,1191,0,1191,0,-6.420521692495919
ZCTA5 56220,1191,0,1191,0,-6.420521692495919
ZCTA5 98039,1191,0,1191,0,-6.420521692495919
ZCTA5 80902,2995,37,2958,0.012353923205342237,-6.421710585870867
ZCTA5 54728,2596,28,2568,0.01078582434514638,-6.422983966628596
ZCTA5 21757,1192,0,1192,0,-6.423216560061591
ZCTA5 49256,1583,7,1576,0.004421983575489577,-6.423689429998774
ZCTA5 59917,1840,12,1828,0.006521739130434782,-6.424641402633031
ZCTA5 62449,1366,3,1363,0.0021961932650073207,-6.424664641880447
ZCTA5 30124,1193,0,1193,0,-6.425910297466675
ZCTA5 52228,1193,0,1193,0,-6.425910297466675
ZCTA5 21830,1310,2,1308,0.0015267175572519084,-6.426346540575576
ZCTA5 28463,3385,46,3339,0.013589364844903988,-6.427299360091363
ZCTA5 38326,1194,0,1194,0,-6.428602906131866
ZCTA5 67672,1194,0,1194,0,-6.428602906131866
ZCTA5 03811,2734,31,2703,0.011338697878566204,-6.430728520471187
ZCTA5 27837,2371,23,2348,0.009700548291859975,-6.432209940011252
ZCTA5 50533,1742,10,1732,0.0057405281285878304,-6.432533647835227
ZCTA5 02717,1793,11,1782,0.006134969325153374,-6.433133172094249
ZCTA5 62447,1425,4,1421,0.002807017543859649,-6.433715208004346
ZCTA5 25674,1196,0,1196,0,-6.433984742910467
ZCTA5 23030,1943,14,1929,0.007205352547606794,-6.434437741254255
ZCTA5 33609,8476,177,8299,0.020882491741387448,-6.436571831673402
ZCTA5 17366,2090,17,2073,0.008133971291866028,-6.43731499748566
ZCTA5 29429,1199,0,1199,0,-6.442049067875924
ZCTA5 36560,1316,2,1314,0.001519756838905775,-6.442450804199308
ZCTA5 46787,1537,6,1531,0.003903708523096942,-6.442664478257149
ZCTA5 17814,1947,14,1933,0.007190549563430919,-6.444689949397289
ZCTA5 18250,1200,0,1200,0,-6.444734933770346
ZCTA5 24273,2740,31,2709,0.011313868613138687,-6.445008785153655
ZCTA5 52411,2829,33,2796,0.01166489925768823,-6.445014486359303
ZCTA5 21826,1898,13,1885,0.00684931506849315,-6.445749770795789
ZCTA5 62088,2874,34,2840,0.011830201809324982,-6.446789897976922
ZCTA5 40031,7631,154,7477,0.020180841305202462,-6.448167637259223
ZCTA5 60103,13714,323,13391,0.023552574011958583,-6.448428700207524
ZCTA5 03076,4631,76,4555,0.016411142301878644,-6.449845470236754
ZCTA5 32764,1202,0,1202,0,-6.450103310322825
ZCTA5 90275,15634,378,15256,0.02417807342970449,-6.450110836822314
ZCTA5 46742,1376,3,1373,0.002180232558139535,-6.45143059219303
ZCTA5 77554,3733,54,3679,0.014465577283686044,-6.451886764573783
ZCTA5 55040,4832,81,4751,0.01676324503311258,-6.452218701156816
ZCTA5 14823,1487,5,1482,0.0033624747814391394,-6.453070818184113
ZCTA5 08066,3692,53,3639,0.014355362946912243,-6.453599928399495
ZCTA5 57703,6045,112,5933,0.018527708850289495,-6.453873721057439
ZCTA5 33872,6922,135,6787,0.019503033805258595,-6.454921920818745
ZCTA5 47330,2097,17,2080,0.008106819265617548,-6.4550007395935705
ZCTA5 49911,1204,0,1204,0,-6.455467222526583
ZCTA5 04008,1204,0,1204,0,-6.455467222526583
ZCTA5 72212,4914,83,4831,0.01689051689051689,-6.4571210854958
ZCTA5 63863,2565,27,2538,0.010526315789473684,-6.4576090166022615
ZCTA5 33306,1752,10,1742,0.005707762557077625,-6.4585971949751
ZCTA5 65202,19564,492,19072,0.025148231445512165,-6.460778281938757
ZCTA5 62884,1206,0,1206,0,-6.4608266815008015
ZCTA5 55020,1207,0,1207,0,-6.463504744488972
ZCTA5 07755,2196,19,2177,0.008652094717668488,-6.463514479388754
ZCTA5 65486,1324,2,1322,0.0015105740181268882,-6.463861212501555
ZCTA5 07757,2101,17,2084,0.00809138505473584,-6.465088458969214
ZCTA5 93285,1208,0,1208,0,-6.4661816983185885
ZCTA5 92584,14463,344,14119,0.023784830256516627,-6.466849059534627
ZCTA5 35184,1652,8,1644,0.004842615012106538,-6.4671187389401625
ZCTA5 85361,2054,16,2038,0.007789678675754625,-6.468407478761098
ZCTA5 66749,3189,41,3148,0.012856694888679836,-6.468537001786521
ZCTA5 05091,1493,5,1488,0.003348961821835231,-6.4689803296310435
ZCTA5 72032,12285,282,12003,0.022954822954822957,-6.471669064699371
ZCTA5 43764,3234,42,3192,0.012987012987012988,-6.4728025623242
ZCTA5 08835,3785,55,3730,0.01453104359313078,-6.47426990704111
ZCTA5 90045,15514,374,15140,0.02410725796055176,-6.474360585731961
ZCTA5 84761,1212,0,1212,0,-6.476878449548476
ZCTA5 02108,1810,11,1799,0.0060773480662983425,-6.477191312707518
ZCTA5 48658,2106,17,2089,0.008072174738841406,-6.4776793623529025
ZCTA5 65018,2843,33,2810,0.01160745691171298,-6.4779748819618455
ZCTA5 70058,13666,321,13345,0.023488950680521002,-6.478495702137627
ZCTA5 28669,1213,0,1213,0,-6.479549878183226
ZCTA5 18092,1213,0,1213,0,-6.479549878183226
ZCTA5 48039,3237,42,3195,0.012974976830398516,-6.4796123165407
ZCTA5 11753,4282,67,4215,0.015646893974778142,-6.480162620053681
ZCTA5 17065,1709,9,1700,0.0052662375658279695,-6.480352395725307
ZCTA5 11789,2845,33,2812,0.011599297012302284,-6.482673462331751
ZCTA5 52327,1215,0,1215,0,-6.484889433995145
ZCTA5 13668,1445,4,1441,0.002768166089965398,-6.486919819304657
ZCTA5 28805,9277,198,9079,0.02134310660773957,-6.487121743681247
ZCTA5 03782,1216,0,1216,0,-6.4875575638895615
ZCTA5 55401,6256,117,6139,0.018702046035805626,-6.488860035351243
ZCTA5 61084,1217,0,1217,0,-6.4902245969164625
ZCTA5 48831,1391,3,1388,0.002156721782890007,-6.491375662753417
ZCTA5 47348,3918,58,3860,0.014803471158754467,-6.492206427964486
ZCTA5 25213,2442,24,2418,0.009828009828009828,-6.492778386158533
ZCTA5 20837,1966,14,1952,0.007121057985757884,-6.493194307533514
ZCTA5 48755,1392,3,1389,0.0021551724137931034,-6.494030060018076
ZCTA5 43515,3244,42,3202,0.012946979038224414,-6.495482635410622
ZCTA5 67526,1219,0,1219,0,-6.495555377771561
ZCTA5 55616,3330,44,3286,0.013213213213213212,-6.495581022466948
ZCTA5 85381,9028,191,8837,0.02115640230394329,-6.4981242286259855
ZCTA5 61517,1220,0,1220,0,-6.498219128294756
ZCTA5 64840,1220,0,1220,0,-6.498219128294756
ZCTA5 08752,1220,0,1220,0,-6.498219128294756
ZCTA5 17857,3116,39,3077,0.01251604621309371,-6.499819264503092
ZCTA5 71006,4696,77,4619,0.016396933560477,-6.500367065438939
ZCTA5 11779,12485,287,12198,0.022987585102122548,-6.503778075624962
ZCTA5 06830,9652,208,9444,0.02154993783671778,-6.503933422742019
ZCTA5 53807,1871,12,1859,0.006413682522715126,-6.504528668290329
ZCTA5 28018,1971,14,1957,0.007102993404363267,-6.505905918806581
ZCTA5 53058,1397,3,1394,0.0021474588403722263,-6.507286042161278
ZCTA5 80222,10811,240,10571,0.022199611506798632,-6.507701222291276
ZCTA5 49240,3506,48,3458,0.013690815744438107,-6.50775961163907
ZCTA5 98248,9035,191,8844,0.02114001106806862,-6.509307359873338
ZCTA5 46947,10705,237,10468,0.022139187295656237,-6.510486208056005
ZCTA5 67439,1225,0,1225,0,-6.511521535519164
ZCTA5 48063,1564,6,1558,0.0038363171355498722,-6.513827547464953
ZCTA5 03862,1722,9,1713,0.005226480836236934,-6.514127701827586
ZCTA5 35172,1226,0,1226,0,-6.5141787572316945
ZCTA5 43907,2358,22,2336,0.009329940627650551,-6.514632555640809
ZCTA5 47904,6843,132,6711,0.019289785181937746,-6.516082397496743
ZCTA5 24557,3510,48,3462,0.013675213675213675,-6.516611332691425
ZCTA5 15557,1457,4,1453,0.002745367192862045,-6.51863900630119
ZCTA5 73010,6731,129,6602,0.019165057198038925,-6.519444897240016
ZCTA5 57730,2591,27,2564,0.010420686993438826,-6.520155669422535
ZCTA5 49829,7748,156,7592,0.020134228187919462,-6.520229286971573
ZCTA5 93551,15932,385,15547,0.024165202108963092,-6.520328370191426
ZCTA5 73130,8009,163,7846,0.020352103883131478,-6.520707373827826
ZCTA5 32195,1229,0,1229,0,-6.522143926814638
ZCTA5 15679,1229,0,1229,0,-6.522143926814638
ZCTA5 12061,3766,54,3712,0.014338821030270845,-6.5236002225158405
ZCTA5 48655,2455,24,2431,0.009775967413441956,-6.524377523854517
ZCTA5 50438,1726,9,1717,0.005214368482039398,-6.52448749792187
ZCTA5 06026,2125,17,2108,0.008,-6.525336443958344
ZCTA5 45653,1622,7,1615,0.004315659679408138,-6.526150727690937
ZCTA5 25918,1930,13,1917,0.006735751295336788,-6.527604648305242
ZCTA5 10941,4790,79,4711,0.01649269311064718,-6.528247343974252
ZCTA5 40051,1779,10,1769,0.005621135469364812,-6.528492625803412
ZCTA5 46561,4468,71,4397,0.015890778871978515,-6.528750387281514
ZCTA5 53104,2127,17,2110,0.007992477668077104,-6.530335766646391
ZCTA5 71405,2079,16,2063,0.007696007696007696,-6.531404862764466
ZCTA5 49098,2365,22,2343,0.009302325581395349,-6.531763462972209
ZCTA5 85933,1233,0,1233,0,-6.532749045894865
ZCTA5 52778,1781,10,1771,0.005614823133071308,-6.533642793105088
ZCTA5 13811,1625,7,1618,0.0043076923076923075,-6.533969317252258
ZCTA5 04046,3390,45,3345,0.01327433628318584,-6.5340475018142845
ZCTA5 17110,10252,224,10028,0.02184939523995318,-6.534421292171985
ZCTA5 55375,1572,6,1566,0.003816793893129771,-6.534770388563052
ZCTA5 06232,1235,0,1235,0,-6.538045154625185
ZCTA5 77068,3940,58,3882,0.014720812182741117,-6.539261822914636
ZCTA5 14530,2179,18,2161,0.008260670032124828,-6.5400585394861315
ZCTA5 68788,1935,13,1922,0.006718346253229974,-6.5403123613079375
ZCTA5 42413,1237,0,1237,0,-6.5433369767417195
ZCTA5 07661,3942,58,3884,0.014713343480466767,-6.543529077374249
ZCTA5 07031,6248,116,6132,0.01856594110115237,-6.544538239997152
ZCTA5 29617,10872,241,10631,0.022167034584253127,-6.544924752480316
ZCTA5 26253,1522,5,1517,0.0032851511169513796,-6.545348916108693
ZCTA5 03753,1238,0,1238,0,-6.545981283568894
ZCTA5 35563,1837,11,1826,0.005988023952095809,-6.546613551953052
ZCTA5 39581,4355,68,4287,0.015614236509758898,-6.547151486043336
ZCTA5 45215,12587,289,12298,0.022960197028680386,-6.547379113121837
ZCTA5 96821,6365,119,6246,0.018695993715632363,-6.5478297681384845
ZCTA5 29321,1239,0,1239,0,-6.548624522636265
ZCTA5 40371,1239,0,1239,0,-6.548624522636265
ZCTA5 43080,1736,9,1727,0.005184331797235023,-6.550320493483093
ZCTA5 01541,1240,0,1240,0,-6.551266695236262
ZCTA5 90046,29183,775,28408,0.026556556899564814,-6.552875871710533
ZCTA5 03225,1241,0,1241,0,-6.553907802658705
ZCTA5 82701,2280,20,2260,0.008771929824561403,-6.55415248190188
ZCTA5 81004,10807,239,10568,0.022115295641713703,-6.555241640284984
ZCTA5 37616,2040,15,2025,0.007352941176470588,-6.5560235561966556
ZCTA5 49677,2877,33,2844,0.011470281543274244,-6.557512961148669
ZCTA5 20636,3949,58,3891,0.014687262598126107,-6.558450750038492
ZCTA5 08037,8477,175,8302,0.02064409578860446,-6.559014255125846
ZCTA5 45742,1243,0,1243,0,-6.559186827117235
ZCTA5 08242,1243,0,1243,0,-6.559186827117235
ZCTA5 13438,1360,2,1358,0.0014705882352941176,-6.559349572202804
ZCTA5 82072,7057,137,6920,0.019413348448349157,-6.559461392170673
ZCTA5 01082,4565,73,4492,0.015991237677984667,-6.56149319175586
ZCTA5 39746,1245,0,1245,0,-6.564461606278603
ZCTA5 14172,1245,0,1245,0,-6.564461606278603
ZCTA5 30011,4728,77,4651,0.01628595600676819,-6.564913474207197
ZCTA5 48612,3994,59,3935,0.014772158237356035,-6.565875800439691
ZCTA5 53097,2044,15,2029,0.007338551859099804,-6.566065676220372
ZCTA5 37912,10201,222,9979,0.021762572296833645,-6.566914046729523
ZCTA5 98506,7925,160,7765,0.02018927444794953,-6.567033252901272
ZCTA5 20833,2473,24,2449,0.009704811969268095,-6.567930238029973
ZCTA5 16441,3954,58,3896,0.014668689934243804,-6.569096054862924
ZCTA5 44813,3363,44,3319,0.013083556348498365,-6.569501024864668
ZCTA5 44451,1247,0,1247,0,-6.569732150368344
ZCTA5 02562,1247,0,1247,0,-6.569732150368344
ZCTA5 03608,1247,0,1247,0,-6.569732150368344
ZCTA5 48071,12816,295,12521,0.023018102372034957,-6.570215033176546
ZCTA5 49415,2612,27,2585,0.010336906584992343,-6.570337006704263
ZCTA5 73521,8077,164,7913,0.02030456852791878,-6.572088457782881
ZCTA5 55340,2749,30,2719,0.010913059294288832,-6.572451015707719
ZCTA5 36273,1249,0,1249,0,-6.574998469571005
ZCTA5 66217,2476,24,2452,0.009693053311793215,-6.575166653679165
ZCTA5 62822,1250,0,1250,0,-6.577630048011203
ZCTA5 47250,9079,191,8888,0.02103755920255535,-6.579425883826344
ZCTA5 60970,3151,39,3112,0.012377023167248492,-6.579619892121434
ZCTA5 06515,6613,125,6488,0.018902162407379405,-6.580936336267504
ZCTA5 75654,4616,74,4542,0.016031195840554593,-6.582946382550031
ZCTA5 83313,1426,3,1423,0.0021037868162692847,-6.583651938191627
ZCTA5 18237,1426,3,1423,0.0021037868162692847,-6.583651938191627
ZCTA5 38320,4495,71,4424,0.015795328142380424,-6.584035504363774
ZCTA5 14464,2799,31,2768,0.011075384065737763,-6.584194603753809
ZCTA5 21035,2709,29,2680,0.010705057216685123,-6.584664146331524
ZCTA5 22727,2340,21,2319,0.008974358974358974,-6.585375516153798
ZCTA5 48610,1427,3,1424,0.002102312543798178,-6.586269675320086
ZCTA5 16417,3067,37,3030,0.012063906097163351,-6.587760306146519
ZCTA5 07068,2341,21,2320,0.00897052541648868,-6.587813989404493
ZCTA5 67209,4980,83,4897,0.016666666666666666,-6.5881879959868925
ZCTA5 61546,1646,7,1639,0.00425273390036452,-6.588453013386907
ZCTA5 62278,2528,25,2503,0.009889240506329115,-6.588996687300812
ZCTA5 36567,4981,83,4898,0.016663320618349728,-6.590162696240619
ZCTA5 02779,2342,21,2321,0.008966695132365499,-6.590251721699529
ZCTA5 81615,1255,0,1255,0,-6.590772179092057
ZCTA5 40056,1256,0,1256,0,-6.593397461880533
ZCTA5 16666,1256,0,1256,0,-6.593397461880533
ZCTA5 76710,10653,234,10419,0.02196564348070966,-6.594265692908628
ZCTA5 16345,1486,4,1482,0.0026917900403768506,-6.594678140979784
ZCTA5 40213,6850,131,6719,0.019124087591240877,-6.595679222782399
ZCTA5 08869,2938,34,2904,0.011572498298162015,-6.5958552437209015
ZCTA5 12196,1257,0,1257,0,-6.596021699780214
ZCTA5 89002,11985,271,11714,0.02261159783062161,-6.601120587334823
ZCTA5 64112,4706,76,4630,0.016149596260093498,-6.601642558768076
ZCTA5 64089,4707,76,4631,0.016146165285744637,-6.603652967895179
ZCTA5 54155,2897,33,2864,0.011391094235415948,-6.6039688063055575
ZCTA5 06255,1757,9,1748,0.005122367672168469,-6.604264333745572
ZCTA5 35114,3075,37,3038,0.012032520325203253,-6.606025240934329
ZCTA5 33478,4506,71,4435,0.01575676875277408,-6.606480932500165
ZCTA5 73165,2254,19,2235,0.008429458740017746,-6.607095062555452
ZCTA5 17051,1962,13,1949,0.006625891946992864,-6.6085583987509695
ZCTA5 73065,3251,41,3210,0.012611504152568441,-6.60885999032559
ZCTA5 37879,4385,68,4317,0.015507411630558724,-6.6090019800536925
ZCTA5 13140,1759,9,1750,0.00511654349061967,-6.60938050501119
ZCTA5 67220,5506,96,5410,0.017435524881946968,-6.610117540962967
ZCTA5 54801,2989,35,2954,0.0117096018735363,-6.611172303944581
ZCTA5 32071,1263,0,1263,0,-6.611745254152209
ZCTA5 06089,1263,0,1263,0,-6.611745254152209
ZCTA5 55963,2013,14,1999,0.006954793840039742,-6.611834667117874
ZCTA5 33922,1656,7,1649,0.004227053140096618,-6.6142479081976635
ZCTA5 97019,1264,0,1264,0,-6.6143622125979045
ZCTA5 73117,2493,24,2469,0.009626955475330927,-6.616053490387854
ZCTA5 40729,2015,14,2001,0.006947890818858561,-6.616841635963169
ZCTA5 29693,5980,108,5872,0.018060200668896322,-6.6201311757693775
ZCTA5 35616,1605,6,1599,0.003738317757009346,-6.620488196359835
ZCTA5 52577,6174,113,6061,0.01830255911888565,-6.620755389247166
ZCTA5 07727,2679,28,2651,0.010451661067562523,-6.621039979835753
ZCTA5 97707,2588,26,2562,0.010046367851622875,-6.622277774764802
ZCTA5 52353,3812,54,3758,0.01416579223504722,-6.62273050776179
ZCTA5 32539,9400,199,9201,0.021170212765957448,-6.623204662534804
ZCTA5 30067,20046,502,19544,0.02504240247430909,-6.62320761347858
ZCTA5 59474,1327,1,1326,7.535795026375283e-4,-6.624532844478429
ZCTA5 35673,2726,29,2697,0.010638297872340425,-6.62467622878569
ZCTA5 29653,1765,9,1756,0.0050991501416430595,-6.624706975641489
ZCTA5 37658,1868,11,1857,0.005888650963597431,-6.625505330463768
ZCTA5 28340,3898,56,3842,0.014366341713699333,-6.627387885159213
ZCTA5 24053,1269,0,1269,0,-6.627431504560199
ZCTA5 73160,22705,580,22125,0.025545034133450783,-6.6276153283425945
ZCTA5 60964,1920,12,1908,0.00625,-6.62903799965339
ZCTA5 78945,3941,57,3884,0.01446333417914235,-6.629980615232182
ZCTA5 97053,1270,0,1270,0,-6.630042271454674
ZCTA5 58318,1715,8,1707,0.004664723032069971,-6.630247323145955
ZCTA5 45142,1444,3,1441,0.002077562326869806,-6.630615273021679
ZCTA5 94597,10388,226,10162,0.02175587216018483,-6.630629141134309
ZCTA5 75103,5241,89,5152,0.016981492081663805,-6.6318779670054715
ZCTA5 65775,10099,218,9881,0.021586295672838894,-6.632514008911897
ZCTA5 26719,1271,0,1271,0,-6.632652010690344
ZCTA5 56310,2071,15,2056,0.007242877836793819,-6.633503197451291
ZCTA5 38019,6181,113,6068,0.01828183141886426,-6.63356999717477
ZCTA5 78619,1556,5,1551,0.003213367609254499,-6.633800297607188
ZCTA5 72207,5164,87,5077,0.016847405112316034,-6.6365653675774805
ZCTA5 15213,9993,215,9778,0.021515060542379665,-6.637215386018662
ZCTA5 98065,5085,85,5000,0.01671583087512291,-6.637782951718898
ZCTA5 48145,1273,0,1273,0,-6.637868411033187
ZCTA5 31774,2315,20,2295,0.008639308855291577,-6.639752377245819
ZCTA5 84050,3265,41,3224,0.012557427258805513,-6.640258484312965
ZCTA5 01436,1274,0,1274,0,-6.640475074558375
ZCTA5 26187,2733,29,2704,0.010611050128064398,-6.641098023683361
ZCTA5 93442,4968,82,4886,0.016505636070853463,-6.643364956894795
ZCTA5 53949,2643,27,2616,0.01021566401816118,-6.64387442580585
ZCTA5 55056,5009,83,4926,0.016570173687362747,-6.64532082594912
ZCTA5 43324,1276,0,1276,0,-6.645685334343529
ZCTA5 17324,1615,6,1609,0.0037151702786377707,-6.646253870856924
ZCTA5 31645,1927,12,1915,0.006227296315516347,-6.646653620975553
ZCTA5 13082,1774,9,1765,0.005073280721533258,-6.647635045226484
ZCTA5 95971,2413,22,2391,0.009117281392457521,-6.648264333550247
ZCTA5 05048,1277,0,1277,0,-6.648288933007308
ZCTA5 72501,10001,215,9786,0.021497850214978503,-6.649442967920229
ZCTA5 95662,12055,272,11783,0.022563251762754043,-6.6498893125560645
ZCTA5 47001,4117,61,4056,0.01481661403934904,-6.650348284896419
ZCTA5 06455,1278,0,1278,0,-6.650891512450511
ZCTA5 56055,1617,6,1611,0.0037105751391465678,-6.651395507896221
ZCTA5 48216,2320,20,2300,0.008620689655172414,-6.651906199296794
ZCTA5 98126,10366,225,10141,0.02170557592128111,-6.6520818101559245
ZCTA5 89049,1279,0,1279,0,-6.653493073869173
ZCTA5 32696,4692,75,4617,0.0159846547314578,-6.654646285328672
ZCTA5 31046,1280,0,1280,0,-6.656093618456989
ZCTA5 15026,1280,0,1280,0,-6.656093618456989
ZCTA5 55108,6387,118,6269,0.018475027399405042,-6.657341896279055
ZCTA5 63650,1726,8,1718,0.004634994206257242,-6.658345010864613
ZCTA5 50459,1281,0,1281,0,-6.658693147405327
ZCTA5 56573,2741,29,2712,0.010580080262677856,-6.659827680878026
ZCTA5 57274,1282,0,1282,0,-6.661291661903227
ZCTA5 25601,2180,17,2163,0.007798165137614679,-6.661649313151592
ZCTA5 98022,8466,173,8293,0.020434679896054807,-6.661912161215986
ZCTA5 11020,1883,11,1872,0.005841741901221455,-6.663373439096028
ZCTA5 12148,1728,8,1720,0.004629629629629629,-6.6634417071088174
ZCTA5 31068,1400,2,1398,0.0014285714285714286,-6.6638543589398855
ZCTA5 50622,1283,0,1283,0,-6.663889163137413
ZCTA5 67147,3705,51,3654,0.013765182186234818,-6.664727450423143
ZCTA5 60647,34714,938,33776,0.02702079852509074,-6.665910259837571
ZCTA5 29069,1935,12,1923,0.006201550387596899,-6.66673436305873
ZCTA5 27050,1624,6,1618,0.003694581280788177,-6.669361262083064
ZCTA5 46164,1732,8,1724,0.004618937644341801,-6.673624111411037
ZCTA5 55120,1836,10,1826,0.0054466230936819175,-6.6738399628141005
ZCTA5 63113,4580,72,4508,0.01572052401746725,-6.674148476583395
ZCTA5 62095,4417,68,4349,0.015395064523432193,-6.674596090713394
ZCTA5 55976,3017,35,2982,0.01160092807424594,-6.675261028488168
ZCTA5 45176,3497,46,3451,0.01315413211323992,-6.675895186648011
ZCTA5 43756,2235,18,2217,0.008053691275167786,-6.677980854894066
ZCTA5 55066,7917,158,7759,0.01995705443981306,-6.678623930651465
ZCTA5 98070,4501,70,4431,0.015552099533437015,-6.679175285385396
ZCTA5 62939,1289,0,1289,0,-6.679452958170531
ZCTA5 06751,1289,0,1289,0,-6.679452958170531
ZCTA5 02141,6745,127,6618,0.01882876204595997,-6.679815535518098
ZCTA5 29687,15919,381,15538,0.023933664174885357,-6.680126420000835
ZCTA5 83704,15885,380,15505,0.023921938936103244,-6.681207090964557
ZCTA5 35620,3240,40,3200,0.012345679012345678,-6.681815388856971
ZCTA5 23457,1629,6,1623,0.003683241252302026,-6.682165538934297
ZCTA5 50126,2887,32,2855,0.011084170419120194,-6.6842711011502445
ZCTA5 23920,1291,0,1291,0,-6.6846328371639565
ZCTA5 66739,2092,15,2077,0.007170172084130019,-6.685543556653773
ZCTA5 25411,5349,91,5258,0.01701252570573939,-6.687238160163657
ZCTA5 12944,1632,6,1626,0.003676470588235294,-6.689836804133517
ZCTA5 14532,1632,6,1626,0.003676470588235294,-6.689836804133517
ZCTA5 29944,1578,5,1573,0.0031685678073510772,-6.690429491045751
ZCTA5 32798,1294,0,1294,0,-6.692395138409496
ZCTA5 34420,6561,122,6439,0.018594726413656455,-6.693496380338775
ZCTA5 55981,1740,8,1732,0.004597701149425287,-6.693945179041823
ZCTA5 89519,3719,51,3668,0.013713363807475128,-6.694881077848835
ZCTA5 27207,1295,0,1295,0,-6.694980572208246
ZCTA5 15530,2096,15,2081,0.00715648854961832,-6.695415868374142
ZCTA5 15045,2097,15,2082,0.00715307582260372,-6.697881955134036
ZCTA5 21904,2339,20,2319,0.008550662676357419,-6.697923114131811
ZCTA5 90293,6679,125,6554,0.018715376553376253,-6.698586035794668
ZCTA5 08823,3594,48,3546,0.01335559265442404,-6.700685210015291
ZCTA5 34482,7479,146,7333,0.019521326380532156,-6.700807627047808
ZCTA5 97103,7479,146,7333,0.019521326380532156,-6.700807627047808
ZCTA5 11942,1795,9,1786,0.005013927576601671,-6.7008497405898355
ZCTA5 24134,2049,14,2035,0.006832601268911664,-6.701454366191281
ZCTA5 39574,5038,83,4955,0.01647479158396189,-6.702179359470776
ZCTA5 41301,2483,23,2460,0.009262988320579944,-6.703629673916553
ZCTA5 63456,1848,10,1838,0.005411255411255411,-6.7040695148100795
ZCTA5 46793,1744,8,1736,0.0045871559633027525,-6.704083962472973
ZCTA5 72088,1300,0,1300,0,-6.707892793600674
ZCTA5 26038,1300,0,1300,0,-6.707892793600674
ZCTA5 46347,1798,9,1789,0.005005561735261402,-6.7084197286068035
ZCTA5 35769,4020,58,3962,0.014427860696517412,-6.708609884198254
ZCTA5 95602,7069,135,6934,0.01909746781723016,-6.712730782491351
ZCTA5 56011,3078,36,3042,0.011695906432748537,-6.713102404290705
ZCTA5 04901,11455,254,11201,0.022173723264949805,-6.714134674428225
ZCTA5 11963,2900,32,2868,0.011034482758620689,-6.714183913493034
ZCTA5 28694,3342,42,3300,0.012567324955116697,-6.7149203379232985
ZCTA5 14903,3255,40,3215,0.01228878648233487,-6.715315387077403
ZCTA5 45784,1303,0,1303,0,-6.715628209732597
ZCTA5 08836,1303,0,1303,0,-6.715628209732597
ZCTA5 97471,12424,281,12143,0.022617514488087572,-6.717262443043325
ZCTA5 52208,1304,0,1304,0,-6.718204702522471
ZCTA5 32206,6767,127,6640,0.01876754839663071,-6.718703680715396
ZCTA5 80446,1697,7,1690,0.0041249263406010605,-6.719022679454296
ZCTA5 93953,1750,8,1742,0.004571428571428572,-6.719265116987633
ZCTA5 53120,3900,55,3845,0.014102564102564103,-6.720695865025955
ZCTA5 27503,1305,0,1305,0,-6.720780207582588
ZCTA5 17360,2537,24,2513,0.009459992116673236,-6.720950415694065
ZCTA5 85658,4766,76,4690,0.01594628619387327,-6.721648383674436
ZCTA5 14301,5526,95,5431,0.017191458559536736,-6.723008537364695
ZCTA5 49423,16582,399,16183,0.02406223615969123,-6.725743438122643
ZCTA5 29450,1307,0,1307,0,-6.725928259051791
ZCTA5 44311,2861,31,2830,0.01083537224746592,-6.728110524366321
ZCTA5 44425,6233,113,6120,0.01812931172789989,-6.728378683443828
ZCTA5 37891,1308,0,1308,0,-6.728500807724575
ZCTA5 25880,2725,28,2697,0.010275229357798165,-6.728859661918893
ZCTA5 84414,8952,185,8767,0.020665773011617514,-6.7288676827092795
ZCTA5 21770,1858,10,1848,0.005382131324004306,-6.729165091438166
ZCTA5 50212,1309,0,1309,0,-6.731072373195005
ZCTA5 53108,1309,0,1309,0,-6.731072373195005
ZCTA5 85743,11468,254,11214,0.022148587373561214,-6.7329127406285405
ZCTA5 24370,2727,28,2699,0.010267693436010267,-6.733516992863686
ZCTA5 28571,1310,0,1310,0,-6.733642956589535
ZCTA5 36551,3043,35,3008,0.011501807426881366,-6.734369792705873
ZCTA5 97457,3991,57,3934,0.014282134803307442,-6.735564918535568
ZCTA5 54217,2819,30,2789,0.010642071656615822,-6.735617724153128
ZCTA5 31831,1311,0,1311,0,-6.73621255903246
ZCTA5 05489,1311,0,1311,0,-6.73621255903246
ZCTA5 13317,1541,4,1537,0.0025957170668397143,-6.736584049244917
ZCTA5 83705,11866,265,11601,0.022332715321085453,-6.737208910285153
ZCTA5 00669,9620,203,9417,0.021101871101871103,-6.737538584089708
ZCTA5 02375,3739,51,3688,0.013640010698047607,-6.7378023873135735
ZCTA5 77056,11003,241,10762,0.021903117331636825,-6.738189975824087
ZCTA5 21057,1651,6,1645,0.0036341611144760752,-6.738226542822153
ZCTA5 17066,2308,19,2289,0.008232235701906412,-6.738462346092011
ZCTA5 44402,1312,0,1312,0,-6.7387811816459395
ZCTA5 19137,3045,35,3010,0.011494252873563218,-6.738900776851384
ZCTA5 71047,4243,63,4180,0.014847984916332784,-6.739983790914808
ZCTA5 81211,2912,32,2880,0.01098901098901099,-6.741706840709529
ZCTA5 32812,14144,329,13815,0.023260746606334842,-6.741751110075552
ZCTA5 64429,3741,51,3690,0.0136327185244587,-6.742084535560049
ZCTA5 37387,1314,0,1314,0,-6.743915491862502
ZCTA5 80470,1314,0,1314,0,-6.743915491862502
ZCTA5 52531,2453,22,2431,0.008968609865470852,-6.74409023203633
ZCTA5 07704,1864,10,1854,0.00536480686695279,-6.744181053078452
ZCTA5 13838,1864,10,1854,0.00536480686695279,-6.744181053078452
ZCTA5 73080,3572,47,3525,0.013157894736842105,-6.745853643443107
ZCTA5 57033,1916,11,1905,0.005741127348643006,-6.746000256175889
ZCTA5 48450,2359,20,2339,0.00847816871555744,-6.74607873422819
ZCTA5 70030,1315,0,1315,0,-6.74648118169923
ZCTA5 63334,2687,27,2660,0.010048381094157052,-6.7471713059593155
ZCTA5 94062,10248,220,10028,0.02146760343481655,-6.748082479619829
ZCTA5 85544,1316,0,1316,0,-6.749045896173818
ZCTA5 84098,7015,133,6882,0.01895937277263008,-6.751363737549051
ZCTA5 76050,2218,17,2201,0.007664562669071236,-6.754449890951394
ZCTA5 48023,2021,13,2008,0.006432459178624443,-6.755545468405231
ZCTA5 04862,1549,4,1545,0.0025823111684958036,-6.756981846112365
ZCTA5 01944,2072,14,2058,0.006756756756756757,-6.758160436109173
ZCTA5 66846,1320,0,1320,0,-6.7592950226496145
ZCTA5 36445,1766,8,1758,0.004530011325028313,-6.759591072874788
ZCTA5 30680,14052,326,13726,0.023199544548818674,-6.760135186808885
ZCTA5 64016,1871,10,1861,0.005344735435595938,-6.7616607401558815
ZCTA5 47932,2123,15,2108,0.00706547338671691,-6.7617232321042
ZCTA5 14712,1321,0,1321,0,-6.761854876944244
ZCTA5 38225,2366,20,2346,0.0084530853761623,-6.762865433079999
ZCTA5 28777,3580,47,3533,0.013128491620111732,-6.763187151082942
ZCTA5 31801,1322,0,1322,0,-6.764413762514343
ZCTA5 99686,1322,0,1322,0,-6.764413762514343
ZCTA5 39567,3963,56,3907,0.014130709058793843,-6.7649077783909615
ZCTA5 15834,2025,13,2012,0.006419753086419753,-6.7654072241392615
ZCTA5 62207,3495,45,3450,0.012875536480686695,-6.765578616576098
ZCTA5 16735,2556,24,2532,0.009389671361502348,-6.765841539050828
ZCTA5 75572,1662,6,1656,0.0036101083032490976,-6.766089541444566
ZCTA5 23841,1382,1,1381,7.23589001447178e-4,-6.766622308510849
ZCTA5 28676,1608,5,1603,0.003109452736318408,-6.766910001386115
ZCTA5 35741,1323,0,1323,0,-6.766971680458862
ZCTA5 87042,1323,0,1323,0,-6.766971680458862
ZCTA5 18925,2320,19,2301,0.008189655172413794,-6.767362903170793
ZCTA5 96130,5233,87,5146,0.016625262755589527,-6.770121754873333
ZCTA5 55315,1823,9,1814,0.004936917169500823,-6.771195859498345
ZCTA5 31520,9238,192,9046,0.020783719419787832,-6.772467122876618
ZCTA5 98632,20759,519,20240,0.02500120429693145,-6.772976137297192
ZCTA5 24527,1328,0,1328,0,-6.779746794116005
ZCTA5 55302,2929,32,2897,0.010925230454079891,-6.780552960488221
ZCTA5 20141,2181,16,2165,0.007336084364970197,-6.783184674375237
ZCTA5 28726,1330,0,1330,0,-6.784850104431479
ZCTA5 48722,1330,0,1330,0,-6.784850104431479
ZCTA5 70343,1932,11,1921,0.005693581780538302,-6.785730602021043
ZCTA5 45879,2518,23,2495,0.009134233518665607,-6.7866407974056155
ZCTA5 86404,7643,149,7494,0.019494962710977365,-6.786694534061481
ZCTA5 81224,1331,0,1331,0,-6.787400320685575
ZCTA5 27326,1331,0,1331,0,-6.787400320685575
ZCTA5 73072,17051,411,16640,0.024104158113893614,-6.789752179840606
ZCTA5 91914,4350,65,4285,0.014942528735632184,-6.7897621814188724
ZCTA5 17603,25531,659,24872,0.025811758254670792,-6.790972965233267
ZCTA5 12123,2135,15,2120,0.00702576112412178,-6.791010596507426
ZCTA5 49435,1333,0,1333,0,-6.792497880788793
ZCTA5 21788,4680,73,4607,0.015598290598290598,-6.79311939672277
ZCTA5 51301,5603,96,5507,0.01713367838657862,-6.793738193964322
ZCTA5 20180,2474,22,2452,0.00889248181083266,-6.793954150874229
ZCTA5 64744,3291,40,3251,0.012154360376785172,-6.795234179598369
ZCTA5 33445,13655,314,13341,0.022995239838886853,-6.796722794584846
ZCTA5 47638,1335,0,1335,0,-6.797591618198158
ZCTA5 36561,2982,33,2949,0.011066398390342052,-6.798754729458529
ZCTA5 05851,2570,24,2546,0.00933852140077821,-6.798765859458284
ZCTA5 11804,1729,7,1722,0.004048582995951417,-6.799730014254368
ZCTA5 43793,2237,17,2220,0.007599463567277604,-6.800441095703039
ZCTA5 78247,17408,421,16987,0.024184283088235295,-6.801672860666597
ZCTA5 43344,2189,16,2173,0.007309273640931932,-6.802589599768729
ZCTA5 74953,4480,68,4412,0.015178571428571428,-6.802611204294184
ZCTA5 28040,3118,36,3082,0.011545862732520847,-6.803174318275464
ZCTA5 36401,2939,32,2907,0.010888057162300102,-6.803325076157191
ZCTA5 46554,1990,12,1978,0.006030150753768844,-6.803337988395813
ZCTA5 23947,1455,2,1453,0.0013745704467353953,-6.8049455823694585
ZCTA5 66725,2190,16,2174,0.0073059360730593605,-6.805011825475815
ZCTA5 16501,1338,0,1338,0,-6.8052250755367565
ZCTA5 24016,4150,60,4090,0.014457831325301205,-6.805482374357958
ZCTA5 44230,3514,45,3469,0.012805919180421172,-6.806893596982131
ZCTA5 15946,2851,30,2821,0.01052262364082778,-6.809207997510242
ZCTA5 57013,1733,7,1726,0.004039238315060588,-6.809754327011565
ZCTA5 01560,1733,7,1726,0.004039238315060588,-6.809754327011565
ZCTA5 15728,1340,0,1340,0,-6.810309293709929
ZCTA5 49781,1839,9,1830,0.004893964110929853,-6.811088956936258
ZCTA5 98374,14128,327,13801,0.023145526613816535,-6.8140975946375635
ZCTA5 08560,1342,0,1342,0,-6.815389719104069
ZCTA5 21013,1682,6,1676,0.0035671819262782403,-6.816468723772986
ZCTA5 02655,1517,3,1514,0.001977587343441002,-6.817805515056517
ZCTA5 44847,1343,0,1343,0,-6.817928512158825
ZCTA5 24149,1343,0,1343,0,-6.817928512158825
ZCTA5 48809,4073,58,4015,0.014240117849251166,-6.81932063788174
ZCTA5 21638,1946,11,1935,0.005652620760534429,-6.820320797953969
ZCTA5 62225,1344,0,1344,0,-6.820466360194664
ZCTA5 36784,2856,30,2826,0.01050420168067227,-6.820651200235786
ZCTA5 22180,8340,167,8173,0.02002398081534772,-6.820730169216336
ZCTA5 77578,6011,106,5905,0.01763433704874397,-6.82088273119695
ZCTA5 11968,4448,67,4381,0.01506294964028777,-6.821155630439462
ZCTA5 07649,2719,27,2692,0.009930121368150056,-6.82152200776683
ZCTA5 30295,1575,4,1571,0.0025396825396825397,-6.822862069580758
ZCTA5 19805,14841,347,14494,0.023381173775352065,-6.824279757879146
ZCTA5 44440,1999,12,1987,0.006003001500750375,-6.825455433486866
ZCTA5 93611,15615,369,15246,0.02363112391930836,-6.826275803387087
ZCTA5 37665,2488,22,2466,0.008842443729903537,-6.82703000773958
ZCTA5 29455,9273,192,9081,0.02070527337431252,-6.8272936057451385
ZCTA5 14738,1464,2,1462,0.001366120218579235,-6.827757411858333
ZCTA5 00688,4286,63,4223,0.014699020065328978,-6.828284512884997
ZCTA5 99201,6753,125,6628,0.018510291722197543,-6.829315075449107
ZCTA5 29690,7933,156,7777,0.019664691793772848,-6.830180900938373
ZCTA5 41129,3783,51,3732,0.013481363996827915,-6.831595237089869
ZCTA5 17569,2052,13,2039,0.006335282651072124,-6.831639852402952
ZCTA5 48362,6018,106,5912,0.017613825191093387,-6.833702143439504
ZCTA5 19605,7406,142,7264,0.01917364299216851,-6.834419763967763
ZCTA5 29572,4660,72,4588,0.015450643776824034,-6.83463923587631
ZCTA5 18336,1635,5,1630,0.0030581039755351682,-6.835031788494741
ZCTA5 63341,1350,0,1350,0,-6.83567366192827
ZCTA5 85263,1350,0,1350,0,-6.83567366192827
ZCTA5 92662,1350,0,1350,0,-6.83567366192827
ZCTA5 87505,14003,323,13680,0.023066485753052916,-6.835900759683749
ZCTA5 52404,16392,391,16001,0.0238530990727184,-6.836005246660995
ZCTA5 64468,5586,95,5491,0.017006802721088437,-6.836158111205451
ZCTA5 90068,11360,249,11111,0.02191901408450704,-6.837207645222055
ZCTA5 24522,3744,50,3694,0.013354700854700854,-6.8393900013789395
ZCTA5 14209,3787,51,3736,0.013467124372854503,-6.840079161918553
ZCTA5 02838,1352,0,1352,0,-6.840735249931651
ZCTA5 02916,3660,48,3612,0.013114754098360656,-6.84295779159653
ZCTA5 15935,1353,0,1353,0,-6.843264640016215
ZCTA5 20676,1353,0,1353,0,-6.843264640016215
ZCTA5 27832,1353,0,1353,0,-6.843264640016215
ZCTA5 17519,2157,15,2142,0.006954102920723227,-6.844417507962775
ZCTA5 43812,7904,155,7749,0.019610323886639677,-6.84456520985059
ZCTA5 12487,1354,0,1354,0,-6.845793095539409
ZCTA5 94552,5112,83,5029,0.016236306729264474,-6.84604620741829
ZCTA5 32832,8170,162,8008,0.019828641370869034,-6.8490457206440345
ZCTA5 24517,2159,15,2144,0.006947660954145438,-6.849254484191009
ZCTA5 33019,6880,128,6752,0.018604651162790697,-6.849708167968827
ZCTA5 91935,2869,30,2839,0.010456605088881143,-6.8503344172436975
ZCTA5 37354,6921,129,6792,0.018638925010836586,-6.854230978749446
ZCTA5 33029,12773,288,12485,0.022547561262037108,-6.854921672221133
ZCTA5 50208,8061,159,7902,0.01972459992556755,-6.855151479682063
ZCTA5 50025,1475,2,1473,0.0013559322033898306,-6.855536086434658
ZCTA5 04287,1358,0,1358,0,-6.855897592692751
ZCTA5 81006,4424,66,4358,0.014918625678119348,-6.856112100381834
ZCTA5 75007,19356,476,18880,0.024591857821864023,-6.856806388348863
ZCTA5 48732,4916,78,4838,0.015866558177379985,-6.857691049774359
ZCTA5 27358,5280,87,5193,0.016477272727272726,-6.860258162687338
ZCTA5 15670,1477,2,1475,0.0013540961408259986,-6.860574743771746
ZCTA5 00739,11737,259,11478,0.02206696770895459,-6.860594673387659
ZCTA5 75497,1479,2,1477,0.001352265043948614,-6.865609725617173
ZCTA5 59912,5800,100,5700,0.017241379310344827,-6.866525632011654
ZCTA5 48350,2693,26,2667,0.009654660230226514,-6.868324149059379
ZCTA5 07046,1363,0,1363,0,-6.868507310157297
ZCTA5 34488,4139,59,4080,0.01425465088185552,-6.8691501045724035
ZCTA5 12477,7541,145,7396,0.01922821906908898,-6.870072916131732
ZCTA5 19440,7389,141,7248,0.01908241981323589,-6.87017876976274
ZCTA5 63138,7122,134,6988,0.018814939623701208,-6.870442848762852
ZCTA5 04444,3500,44,3456,0.012571428571428572,-6.8704681517156185
ZCTA5 30546,3193,37,3156,0.011587848418415283,-6.871315873135275
ZCTA5 28635,1365,0,1365,0,-6.87354471993613
ZCTA5 06702,1705,6,1699,0.0035190615835777126,-6.873965142861372
ZCTA5 45365,11747,259,11488,0.0220481825146846,-6.874839186488515
ZCTA5 22655,7506,144,7362,0.019184652278177457,-6.875101869423129
ZCTA5 71446,8224,163,8061,0.019820038910505836,-6.875981365828082
ZCTA5 15089,2926,31,2895,0.010594668489405332,-6.876517798005167
ZCTA5 05465,2121,14,2107,0.006600660066006601,-6.877582739970112
ZCTA5 37709,1597,4,1593,0.002504696305572949,-6.878123776011203
ZCTA5 41169,2171,15,2156,0.006909258406264394,-6.878213315289476
ZCTA5 24083,1367,0,1367,0,-6.878578440654685
ZCTA5 37708,2651,25,2626,0.00943040362127499,-6.878766087598463
ZCTA5 14081,1368,0,1368,0,-6.881093920146581
ZCTA5 07422,2320,18,2302,0.007758620689655172,-6.882819607044793
ZCTA5 52068,1543,3,1540,0.0019442644199611147,-6.8832620830131095
ZCTA5 08750,1369,0,1369,0,-6.883608480405973
ZCTA5 03461,1816,8,1808,0.004405286343612335,-6.884171846746395
ZCTA5 12025,2272,17,2255,0.007482394366197183,-6.884466327695344
ZCTA5 48455,3065,34,3031,0.011092985318107667,-6.88453696842081
ZCTA5 75165,15240,357,14883,0.023425196850393702,-6.885183757995169
ZCTA5 48131,2976,32,2944,0.010752688172043012,-6.887083290297532
ZCTA5 37737,2322,18,2304,0.007751937984496124,-6.887576498341008
ZCTA5 29605,14219,328,13891,0.023067726281735704,-6.887599160992068
ZCTA5 63127,2075,13,2062,0.006265060240963855,-6.887608498165587
ZCTA5 03307,2075,13,2062,0.006265060240963855,-6.887608498165587
ZCTA5 22213,1371,0,1371,0,-6.8886348472534555
ZCTA5 32535,1818,8,1810,0.0044004400440044,-6.889110780245805
ZCTA5 43620,2562,23,2539,0.00897736143637783,-6.889836391479144
ZCTA5 53523,2176,15,2161,0.006893382352941176,-6.8902477817070285
ZCTA5 57717,3246,38,3208,0.01170671595810228,-6.890447235615694
ZCTA5 21162,1372,0,1372,0,-6.891146655850058
ZCTA5 19102,2978,32,2946,0.010745466756212223,-6.8915886418687675
ZCTA5 53955,2468,21,2447,0.008508914100486223,-6.891679463885422
ZCTA5 45318,2127,14,2113,0.006582040432534086,-6.8920792007039084
ZCTA5 25130,1373,0,1373,0,-6.893657549231195
ZCTA5 82716,6906,128,6778,0.01853460758760498,-6.895008877716282
ZCTA5 30711,1374,0,1374,0,-6.896167528396555
ZCTA5 66763,1374,0,1374,0,-6.896167528396555
ZCTA5 62684,2129,14,2115,0.006575857209957727,-6.896905315255348
ZCTA5 66012,4278,62,4216,0.014492753623188406,-6.8969349513736855
ZCTA5 02338,2798,28,2770,0.010007147962830594,-6.897253111199028
ZCTA5 49012,1375,0,1375,0,-6.898676594344009
ZCTA5 58054,1375,0,1375,0,-6.898676594344009
ZCTA5 37150,1978,11,1967,0.005561172901921132,-6.898786551274979
ZCTA5 48734,3250,38,3212,0.011692307692307693,-6.899259328445894
ZCTA5 44644,2130,14,2116,0.006572769953051643,-6.89931724319952
ZCTA5 79413,8539,171,8368,0.020025764141000116,-6.9007084514457055
ZCTA5 19530,4816,75,4741,0.015573089700996677,-6.9008417323106785
ZCTA5 37397,3773,50,3723,0.013252054068380599,-6.900890157899167
ZCTA5 15845,1376,0,1376,0,-6.901184748069612
ZCTA5 95640,2938,31,2907,0.01055139550714772,-6.903648079044506
ZCTA5 17970,1377,0,1377,0,-6.903691990567616
ZCTA5 36037,4489,67,4422,0.014925373134328358,-6.903781375890595
ZCTA5 11755,4282,62,4220,0.014479215319943952,-6.905085210258666
ZCTA5 23502,7941,155,7786,0.019518952273013476,-6.905847391940704
ZCTA5 49254,1378,0,1378,0,-6.906198322830459
ZCTA5 03884,1378,0,1378,0,-6.906198322830459
ZCTA5 45106,4614,70,4544,0.01517121803207629,-6.906374837363451
ZCTA5 25403,4821,75,4746,0.015556938394523958,-6.91065952825304
ZCTA5 28782,3256,38,3218,0.01167076167076167,-6.912462046821332
ZCTA5 28312,7225,136,7089,0.018823529411764704,-6.9158851131813694
ZCTA5 16033,2621,24,2597,0.009156810377718427,-6.917627266280937
ZCTA5 61603,6338,113,6225,0.01782896812874724,-6.917785746847571
ZCTA5 46637,6416,115,6301,0.017923940149625936,-6.9179182781291235
ZCTA5 40045,1500,2,1498,0.0013333333333333333,-6.918257120104911
ZCTA5 04039,3125,35,3090,0.0112,-6.918327359518977
ZCTA5 86327,4205,60,4145,0.014268727705112961,-6.918624482487674
ZCTA5 67107,1383,0,1383,0,-6.918716365227024
ZCTA5 43025,2088,13,2075,0.006226053639846743,-6.919062570433915
ZCTA5 06248,2088,13,2075,0.006226053639846743,-6.919062570433915
ZCTA5 49236,1883,9,1874,0.004779607010090282,-6.919684874596655
ZCTA5 65026,4744,73,4671,0.015387858347386173,-6.920012719672316
ZCTA5 95603,11851,261,11590,0.022023457936039152,-6.92017291477106
ZCTA5 28586,3036,33,3003,0.010869565217391304,-6.920349875710492
ZCTA5 51040,1614,4,1610,0.0024783147459727386,-6.920529611701101
ZCTA5 14416,1384,0,1384,0,-6.921217256819716
ZCTA5 32754,4038,56,3982,0.013868251609707775,-6.921369019458618
ZCTA5 65559,3481,43,3438,0.01235277219189888,-6.923536993717601
ZCTA5 51632,2717,26,2691,0.009569377990430622,-6.923582524972278
ZCTA5 87047,1832,8,1824,0.004366812227074236,-6.9235899599697595
ZCTA5 19125,10109,213,9896,0.021070333366307252,-6.9242899052710785
ZCTA5 04769,4082,57,4025,0.01396374326310632,-6.9250476106995915
ZCTA5 17322,2240,16,2224,0.007142857142857143,-6.925178704580094
ZCTA5 56172,1386,0,1386,0,-6.926216330968637
ZCTA5 53548,7384,140,7244,0.01895991332611051,-6.92639598521909
ZCTA5 30582,1780,7,1773,0.003932584269662922,-6.926502532954373
ZCTA5 17844,3828,51,3777,0.013322884012539185,-6.926635625022163
ZCTA5 28356,1886,9,1877,0.004772004241781549,-6.9270310496873515
ZCTA5 24090,1834,8,1826,0.004362050163576881,-6.928502298590009
ZCTA5 43316,2388,19,2369,0.007956448911222781,-6.929198876379658
ZCTA5 19153,5437,90,5347,0.016553246275519587,-6.930352017958994
ZCTA5 37716,10735,230,10505,0.021425244527247322,-6.930967632891233
ZCTA5 06231,1388,0,1388,0,-6.931211799581242
ZCTA5 89081,10845,233,10612,0.0214845550945136,-6.932038766488958
ZCTA5 76834,2243,16,2227,0.007133303611234953,-6.932330729509535
ZCTA5 65043,4086,57,4029,0.013950073421439061,-6.933299071371163
ZCTA5 62341,1389,0,1389,0,-6.933708184246943
ZCTA5 30725,1675,5,1670,0.0029850746268656717,-6.9347569460635565
ZCTA5 90603,6659,121,6538,0.01817089653101066,-6.9356360254278835
ZCTA5 44288,1390,0,1390,0,-6.936203670447678
ZCTA5 19151,11899,262,11637,0.022018657030002522,-6.937085447031079
ZCTA5 53581,4423,65,4358,0.014695907754917477,-6.937708643616492
ZCTA5 17074,2908,30,2878,0.01031636863823934,-6.938792911159075
ZCTA5 57325,1392,0,1392,0,-6.941191951330077
ZCTA5 02129,9050,184,8866,0.02033149171270718,-6.94244655172662
ZCTA5 42351,1623,4,1619,0.0024645717806531116,-6.942876896463329
ZCTA5 48006,1510,2,1508,0.0013245033112582781,-6.943187823942749
ZCTA5 30224,9533,197,9336,0.020665058218818838,-6.9441808318473495
ZCTA5 28086,9903,207,9696,0.020902756740381702,-6.946114077889254
ZCTA5 31635,2347,18,2329,0.007669365146996165,-6.946801309668298
ZCTA5 23325,6316,112,6204,0.01773274224192527,-6.948297169737493
ZCTA5 32462,1395,0,1395,0,-6.948667658344716
ZCTA5 34987,3361,40,3321,0.011901219875037191,-6.948734629439805
ZCTA5 80421,3753,49,3704,0.013056221689315214,-6.949292725787514
ZCTA5 44231,3624,46,3578,0.012693156732891833,-6.950362366314809
ZCTA5 88201,9981,209,9772,0.02093978559262599,-6.952842955199572
ZCTA5 40258,10423,221,10202,0.021203108510025905,-6.955623222805235
ZCTA5 43912,2731,26,2705,0.009520322226290736,-6.955653859808441
ZCTA5 28170,4639,70,4569,0.015089458935115327,-6.956027815532094
ZCTA5 38583,8947,181,8766,0.020230244774784845,-6.956084625080406
ZCTA5 43326,5371,88,5283,0.016384285980264382,-6.95702097415449
ZCTA5 02130,16631,395,16236,0.023750826769286273,-6.959007015165472
ZCTA5 49127,4434,65,4369,0.014659449706811005,-6.959830967837833
ZCTA5 75647,4517,67,4450,0.014832853663936241,-6.9598586765087385
ZCTA5 97231,1686,5,1681,0.0029655990510083037,-6.961937681786202
ZCTA5 04344,1401,0,1401,0,-6.963594995974324
ZCTA5 19144,17544,421,17123,0.023996808025535797,-6.966282981647834
ZCTA5 14108,2209,15,2194,0.006790402897238569,-6.969214073621664
ZCTA5 71107,12066,266,11800,0.022045416873860434,-6.969249473743612
ZCTA5 58301,4439,65,4374,0.014642937598558234,-6.969871971551505
ZCTA5 43783,1798,7,1791,0.00389321468298109,-6.970719733840392
ZCTA5 37191,1404,0,1404,0,-6.9710466781449
ZCTA5 70656,1404,0,1404,0,-6.9710466781449
ZCTA5 17026,1404,0,1404,0,-6.9710466781449
ZCTA5 55746,7181,134,7047,0.018660353711182288,-6.9716915038559994
ZCTA5 95409,12176,269,11907,0.022092641261498028,-6.971966176716522
ZCTA5 33957,3678,47,3631,0.01277868406742795,-6.9731081668296
ZCTA5 21817,2009,11,1998,0.0054753608760577405,-6.974026171594791
ZCTA5 46774,6292,111,6181,0.017641449459631278,-6.975354422616943
ZCTA5 59860,4276,61,4215,0.014265668849391955,-6.977901650596084
ZCTA5 85018,17207,411,16796,0.02388562794211658,-6.980155510062358
ZCTA5 35215,18078,436,17642,0.024117712136298264,-6.981105013501273
ZCTA5 06043,1803,7,1796,0.003882418191902385,-6.982954762582834
ZCTA5 07750,1409,0,1409,0,-6.983448478872672
ZCTA5 15541,1409,0,1409,0,-6.983448478872672
ZCTA5 35186,2013,11,2002,0.00546448087431694,-6.983680153808544
ZCTA5 57201,10917,234,10683,0.021434460016488046,-6.984119449429251
ZCTA5 18447,4405,64,4341,0.01452894438138479,-6.98520233145646
ZCTA5 01749,7686,147,7539,0.01912568306010929,-6.985798822626352
ZCTA5 13132,1410,0,1410,0,-6.985926197055609
ZCTA5 66538,1411,0,1411,0,-6.98840303677075
ZCTA5 33762,2652,24,2628,0.00904977375565611,-6.989069949787786
ZCTA5 53228,6339,112,6227,0.0176684019561445,-6.989424584884203
ZCTA5 15697,1412,0,1412,0,-6.990878998951809
ZCTA5 16870,2653,24,2629,0.009046362608367886,-6.991364608318985
ZCTA5 36866,1698,5,1693,0.002944640753828033,-6.991472060179506
ZCTA5 33809,10886,233,10653,0.021403637699797907,-6.992080234148863
ZCTA5 54940,1753,6,1747,0.0034227039361095267,-6.992488918518642
ZCTA5 78652,2169,14,2155,0.006454587367450438,-6.992802305914922
ZCTA5 71033,1413,0,1413,0,-6.993354084530844
ZCTA5 44408,4326,62,4264,0.014331946370781322,-6.994337745435408
ZCTA5 46158,8560,170,8390,0.01985981308411215,-6.994573411076748
ZCTA5 52544,3338,39,3299,0.011683642899940084,-6.994824790554082
ZCTA5 15233,1414,0,1414,0,-6.995828294438268
ZCTA5 27976,1414,0,1414,0,-6.995828294438268
ZCTA5 97444,2465,20,2445,0.008113590263691683,-6.996639787043977
ZCTA5 05060,1915,9,1906,0.004699738903394256,-6.997670911123571
ZCTA5 53813,2320,17,2303,0.007327586206896552,-6.998276310918792
ZCTA5 29323,5192,83,5109,0.015986132511556242,-6.999654070943392
ZCTA5 46710,1590,3,1587,0.0018867924528301887,-7.000052635450712
ZCTA5 25443,2797,27,2770,0.009653199856989631,-7.000120047301321
ZCTA5 19807,2981,31,2950,0.01039919490103992,-7.0001974098639534
ZCTA5 46979,1757,6,1751,0.003414911781445646,-7.002278492079843
ZCTA5 43542,1417,0,1417,0,-7.0032456794103295
ZCTA5 55071,2073,12,2061,0.005788712011577424,-7.004899489444133
ZCTA5 55308,3254,37,3217,0.011370620774431468,-7.00555191448308
ZCTA5 54548,2175,14,2161,0.006436781609195402,-7.007085544931124
ZCTA5 95033,3608,45,3563,0.012472283813747228,-7.00878247009752
ZCTA5 61455,7166,133,7033,0.018559866034049678,-7.011712100210914
ZCTA5 41224,1921,9,1912,0.004685059864653826,-7.01220261563548
ZCTA5 29039,1421,0,1421,0,-7.013123322795247
ZCTA5 48759,1421,0,1421,0,-7.013123322795247
ZCTA5 83014,1421,0,1421,0,-7.013123322795247
ZCTA5 84526,1652,4,1648,0.002421307506053269,-7.014409500435914
ZCTA5 76437,2077,12,2065,0.005777563793933558,-7.014479901617637
ZCTA5 01545,13140,295,12845,0.022450532724505326,-7.014556660231234
ZCTA5 08203,4127,57,4070,0.013811485340440998,-7.017509040047748
ZCTA5 37206,11013,236,10777,0.02142922001271225,-7.0178181696707105
ZCTA5 01225,1423,0,1423,0,-7.018056931089419
ZCTA5 15636,1423,0,1423,0,-7.018056931089419
ZCTA5 48166,4296,61,4235,0.014199255121042831,-7.018409051615196
ZCTA5 01844,17692,424,17268,0.023965634184942346,-7.018663895989076
ZCTA5 35224,2079,12,2067,0.005772005772005772,-7.019265629448976
ZCTA5 18224,2523,21,2502,0.008323424494649227,-7.019861052408979
ZCTA5 37218,5445,89,5356,0.016345270890725436,-7.020793005394681
ZCTA5 06098,5163,82,5081,0.01588223900832849,-7.021593123607048
ZCTA5 97370,3262,37,3225,0.011342734518700184,-7.023015424020238
ZCTA5 17104,7594,144,7450,0.01896233868843824,-7.023023017685602
ZCTA5 46226,17975,432,17543,0.02403337969401947,-7.024066134160822
ZCTA5 60152,4591,68,4523,0.014811587889348726,-7.024650262619916
ZCTA5 19123,7519,142,7377,0.018885490091767522,-7.025314268035089
ZCTA5 18051,1426,0,1426,0,-7.025450847378311
ZCTA5 36870,7443,140,7303,0.01880961977697165,-7.026119755337296
ZCTA5 89128,14679,338,14341,0.02302609169561959,-7.026175135105247
ZCTA5 39066,1657,4,1653,0.0024140012070006035,-7.026670455079649
ZCTA5 14001,4047,55,3992,0.013590313812700766,-7.027406025524695
ZCTA5 19505,1427,0,1427,0,-7.027913757479345
ZCTA5 19943,4676,70,4606,0.014970059880239521,-7.029117613156338
ZCTA5 92648,19471,475,18996,0.02439525448102306,-7.029708060579547
ZCTA5 14619,5490,90,5400,0.01639344262295082,-7.029895717068688
ZCTA5 62640,1487,1,1486,6.724949562878278e-4,-7.029927137205442
ZCTA5 15112,1428,0,1428,0,-7.030375804763656
ZCTA5 30223,13653,309,13344,0.022632388486047022,-7.032004474158808
ZCTA5 07419,3619,45,3574,0.012434374136501796,-7.032141036250241
ZCTA5 60502,8056,156,7900,0.019364448857994043,-7.032791137401016
ZCTA5 48817,2433,19,2414,0.007809288943690916,-7.03454860398824
ZCTA5 14454,3312,38,3274,0.011473429951690822,-7.034807036893825
ZCTA5 01929,1430,0,1430,0,-7.035297314505182
ZCTA5 47220,1983,10,1973,0.005042864346949067,-7.035855471297029
ZCTA5 46167,2287,16,2271,0.006996064713598601,-7.036493202114035
ZCTA5 10706,3179,35,3144,0.01100975149418056,-7.037498329588597
ZCTA5 27921,1826,7,1819,0.0038335158817086527,-7.03897369494059
ZCTA5 50701,13051,292,12759,0.022373764462493295,-7.039532331578346
ZCTA5 39170,3796,49,3747,0.012908324552160169,-7.039664201258957
ZCTA5 52052,1432,0,1432,0,-7.040215383833185
ZCTA5 16242,1880,8,1872,0.00425531914893617,-7.040589309671386
ZCTA5 17061,3045,32,3013,0.010509031198686371,-7.041237396847215
ZCTA5 47164,1773,6,1767,0.00338409475465313,-7.041305315149846
ZCTA5 40456,3926,52,3874,0.013245033112582781,-7.041866149053953
ZCTA5 53538,7376,138,7238,0.018709327548806942,-7.042325183348822
ZCTA5 62563,2191,14,2177,0.006389776357827476,-7.0450472611175785
ZCTA5 98339,1434,0,1434,0,-7.045130019952722
ZCTA5 71263,2956,30,2926,0.010148849797023005,-7.0464749952039805
ZCTA5 33071,12879,287,12592,0.02228433884618371,-7.04942853896983
ZCTA5 39735,1436,0,1436,0,-7.050041230043739
ZCTA5 15672,1436,0,1436,0,-7.050041230043739
ZCTA5 85295,14095,321,13774,0.022774033345157856,-7.051406046880457
ZCTA5 02138,14131,322,13809,0.02278678083645885,-7.0519782667931095
ZCTA5 00979,8069,156,7913,0.01933325071260379,-7.054048091596006
ZCTA5 07737,1438,0,1438,0,-7.054949021261192
ZCTA5 27514,9938,206,9732,0.020728516804185953,-7.054974284049816
ZCTA5 37772,4936,76,4860,0.01539708265802269,-7.055053801638023
ZCTA5 10538,5744,96,5648,0.016713091922005572,-7.055955665051091
ZCTA5 63049,6534,116,6418,0.01775329048056321,-7.057955052701649
ZCTA5 08730,1780,6,1774,0.0033707865168539327,-7.058313985563133
ZCTA5 18472,1557,2,1555,0.0012845215157353885,-7.05918949675338
ZCTA5 06365,1835,7,1828,0.0038147138964577656,-7.060778280445424
ZCTA5 52333,2493,20,2473,0.008022462896109106,-7.061568150353893
ZCTA5 62946,5226,83,5143,0.01588212782242633,-7.06434739979789
ZCTA5 30523,4982,77,4905,0.015455640305098354,-7.064866382972633
ZCTA5 31901,2919,29,2890,0.009934909215484755,-7.066515691921019
ZCTA5 30324,14393,329,14064,0.02285833391231849,-7.0693143489570005
ZCTA5 70777,1562,2,1560,0.0012804097311139564,-7.071418732876425
ZCTA5 10308,10648,225,10423,0.021130728775356874,-7.0718324580783225
ZCTA5 31537,2922,29,2893,0.009924709103353867,-7.073212316914471
ZCTA5 35672,2353,17,2336,0.007224819379515512,-7.075594950272191
ZCTA5 84054,6467,114,6353,0.017627957321787537,-7.077726116067892
ZCTA5 52358,1448,0,1448,0,-7.079436942934249
ZCTA5 06278,1844,7,1837,0.003796095444685466,-7.082518542515881
ZCTA5 83274,2787,26,2761,0.009329027628274129,-7.082766835451412
ZCTA5 28129,2207,14,2193,0.006343452650657001,-7.082826347907145
ZCTA5 37331,2973,30,2943,0.010090817356205853,-7.084304846396851
ZCTA5 48017,5680,94,5586,0.016549295774647886,-7.085186681983855
ZCTA5 50124,1451,0,1451,0,-7.086766819213021
ZCTA5 19075,2789,26,2763,0.00932233775546791,-7.0872724792393464
ZCTA5 14025,1452,0,1452,0,-7.089208427147381
ZCTA5 97391,2160,13,2147,0.0060185185185185185,-7.090984830183605
ZCTA5 53010,3022,31,2991,0.010258107213765718,-7.091304569111957
ZCTA5 19079,3516,42,3474,0.011945392491467578,-7.092590889511003
ZCTA5 02113,4333,61,4272,0.014078006000461574,-7.092952835918915
ZCTA5 30106,8055,155,7900,0.019242706393544383,-7.093117462096045
ZCTA5 98563,3023,31,2992,0.010254713860403573,-7.093515307537513
ZCTA5 99403,8396,164,8232,0.01953311100524059,-7.0937211348966125
ZCTA5 73443,1454,0,1454,0,-7.09408912199551
ZCTA5 07702,1454,0,1454,0,-7.09408912199551
ZCTA5 84405,11139,238,10901,0.021366370410270223,-7.094737821479389
ZCTA5 29150,15477,359,15118,0.023195709762873943,-7.097282257080096
ZCTA5 60416,3650,45,3605,0.012328767123287671,-7.097676659572839
ZCTA5 73131,1456,0,1456,0,-7.098966461259882
ZCTA5 17102,3954,52,3902,0.013151239251390997,-7.099731266350338
ZCTA5 06057,2413,18,2395,0.0074595938665561546,-7.101104016507479
ZCTA5 49080,6047,103,5944,0.01703323962295353,-7.101220366595852
ZCTA5 61348,1906,8,1898,0.004197271773347324,-7.103200185330138
ZCTA5 37029,2463,19,2444,0.007714169711733658,-7.104037405150545
ZCTA5 92009,16469,387,16082,0.02349869451697128,-7.104969710773319
ZCTA5 02538,1459,0,1459,0,-7.106276193549546
ZCTA5 03840,1459,0,1459,0,-7.106276193549546
ZCTA5 11596,3567,43,3524,0.012054948135688253,-7.107457866665484
ZCTA5 16743,1634,3,1631,0.0018359853121175031,-7.107669007957865
ZCTA5 49107,4214,58,4156,0.013763644992880873,-7.108360729913855
ZCTA5 29655,2799,26,2773,0.009289031797070382,-7.109765977354809
ZCTA5 80104,10894,231,10663,0.021204332660179917,-7.110333447026082
ZCTA5 55992,2066,11,2055,0.005324298160696999,-7.110453235743767
ZCTA5 15909,2219,14,2205,0.006309148264984227,-7.11104229401462
ZCTA5 25309,5454,88,5366,0.016134946828016136,-7.112972217198843
ZCTA5 36875,1462,0,1462,0,-7.113578414548155
ZCTA5 21660,1462,0,1462,0,-7.113578414548155
ZCTA5 43068,21201,523,20678,0.02466864770529692,-7.113983081966249
ZCTA5 13795,1463,0,1463,0,-7.1160108230359125
ZCTA5 14423,1858,7,1851,0.003767491926803014,-7.116210167849721
ZCTA5 67665,2120,12,2108,0.005660377358490566,-7.116724120659856
ZCTA5 54106,1966,9,1957,0.004577822990844354,-7.1203009412286296
ZCTA5 35643,1465,0,1465,0,-7.120873147363448
ZCTA5 20002,27479,707,26772,0.02572873830925434,-7.121817277841121
ZCTA5 03070,1914,8,1906,0.0041797283176593526,-7.122359850869953
ZCTA5 11579,1967,9,1958,0.004575495678698526,-7.122685581535116
ZCTA5 60534,3836,49,3787,0.012773722627737226,-7.123018009316429
ZCTA5 31305,2423,18,2405,0.007428807263722658,-7.124230623208965
ZCTA5 01570,6884,124,6760,0.01801278326554329,-7.124790685946169
ZCTA5 54208,2424,18,2406,0.007425742574257425,-7.126539701830215
ZCTA5 68114,8152,157,7995,0.01925907752698724,-7.1274780179758475
ZCTA5 18641,2760,25,2735,0.009057971014492754,-7.127566334907228
ZCTA5 48933,1468,0,1468,0,-7.128160414984938
ZCTA5 08056,1469,0,1469,0,-7.130587849216713
ZCTA5 54157,2426,18,2408,0.00741962077493817,-7.131155911863224
ZCTA5 92130,19525,474,19051,0.024276568501920615,-7.131676250915185
ZCTA5 46072,3579,43,3536,0.012014529198100027,-7.1328502903544475
ZCTA5 79124,3402,39,3363,0.01146384479717813,-7.132857060266928
ZCTA5 29704,1470,0,1470,0,-7.133014457369046
ZCTA5 35966,1470,0,1470,0,-7.133014457369046
ZCTA5 43112,1645,3,1642,0.00182370820668693,-7.13432222322164
ZCTA5 12027,1471,0,1471,0,-7.135440240284732
ZCTA5 11716,3625,44,3581,0.012137931034482758,-7.137224369606197
ZCTA5 28594,1758,5,1753,0.002844141069397042,-7.137357468236973
ZCTA5 16125,6892,124,6768,0.017991874637260593,-7.138582375276326
ZCTA5 64129,3887,50,3837,0.012863390789812194,-7.139123140794527
ZCTA5 43532,1473,0,1473,0,-7.140289333770182
ZCTA5 19506,2766,25,2741,0.009038322487346349,-7.141056193072495
ZCTA5 33625,10180,211,9969,0.020726915520628685,-7.141253860512877
ZCTA5 23015,1474,0,1474,0,-7.142712646018389
ZCTA5 54929,3759,47,3712,0.012503325352487363,-7.143359243196484
ZCTA5 37190,3407,39,3368,0.011447020839448195,-7.1435578657012
ZCTA5 44824,1475,0,1475,0,-7.145135136386843
ZCTA5 20746,11211,239,10972,0.02131834805102132,-7.145906991846436
ZCTA5 17339,2862,27,2835,0.009433962264150943,-7.146216275954339
ZCTA5 98937,1593,2,1591,0.0012554927809165098,-7.146775434155634
ZCTA5 54474,1762,5,1757,0.0028376844494892167,-7.146979916787988
ZCTA5 44504,1925,8,1917,0.004155844155844156,-7.148624664087727
ZCTA5 69201,1763,5,1758,0.0028360748723766306,-7.149383554841867
ZCTA5 72110,4655,68,4587,0.014607948442534909,-7.150709103102553
ZCTA5 90290,2236,14,2222,0.006261180679785331,-7.150843383822398
ZCTA5 66523,1652,3,1649,0.0018159806295399517,-7.151232190809852
ZCTA5 63043,9259,186,9073,0.020088562479749432,-7.152147652755687
ZCTA5 17020,3676,45,3631,0.012241566920565832,-7.1523126233223735
ZCTA5 44436,1478,0,1478,0,-7.152397684563284
ZCTA5 13748,1478,0,1478,0,-7.152397684563284
ZCTA5 04609,2337,16,2321,0.0068463842533162175,-7.153235669612311
ZCTA5 13502,12992,288,12704,0.022167487684729065,-7.15435535648229
ZCTA5 28734,12127,264,11863,0.021769605013606003,-7.155752875501067
ZCTA5 22827,4196,57,4139,0.013584366062917064,-7.157744685975712
ZCTA5 97504,19201,464,18737,0.024165408051663975,-7.1579162731186505
ZCTA5 48218,2870,27,2843,0.009407665505226481,-7.16403144025444
ZCTA5 47404,9677,197,9480,0.02035754882711584,-7.164657177835108
ZCTA5 74501,10859,229,10630,0.021088498020075515,-7.166029186499711
ZCTA5 27295,15213,350,14863,0.023006639058699797,-7.166177226624062
ZCTA5 18709,1484,0,1484,0,-7.16690070253377
ZCTA5 98524,1484,0,1484,0,-7.16690070253377
ZCTA5 71654,1771,5,1766,0.00282326369282891,-7.168584351115667
ZCTA5 92008,11410,244,11166,0.021384750219106047,-7.1696048002286785
ZCTA5 58368,1716,4,1712,0.002331002331002331,-7.1697941794657645
ZCTA5 33321,19836,482,19354,0.024299253881831014,-7.170481684350029
ZCTA5 15767,5889,98,5791,0.01664119544914247,-7.175142484832688
ZCTA5 01983,2145,12,2133,0.005594405594405594,-7.175554577443995
ZCTA5 61364,8068,154,7914,0.01908775409023302,-7.176239525843269
ZCTA5 29128,1829,6,1823,0.0032804811372334607,-7.176282883495921
ZCTA5 33773,7263,133,7130,0.018311992289687457,-7.176485043152504
ZCTA5 49412,4417,62,4355,0.014036676477247,-7.176650398765539
ZCTA5 28146,10683,224,10459,0.020967892913975474,-7.177042032456818
ZCTA5 43917,1489,0,1489,0,-7.178964169584148
ZCTA5 12051,1489,0,1489,0,-7.178964169584148
ZCTA5 24637,1489,0,1489,0,-7.178964169584148
ZCTA5 08801,2593,21,2572,0.008098727342846125,-7.18020694889083
ZCTA5 61270,2878,27,2851,0.009381514940931202,-7.181810911233747
ZCTA5 60143,4208,57,4151,0.013545627376425855,-7.181947285671553
ZCTA5 54986,2148,12,2136,0.00558659217877095,-7.182584517115811
ZCTA5 30740,3291,36,3255,0.010938924339106655,-7.182990778528619
ZCTA5 53103,1491,0,1491,0,-7.183783884238906
ZCTA5 45203,1492,0,1492,0,-7.186192529364172
ZCTA5 76380,1492,0,1492,0,-7.186192529364172
ZCTA5 04474,1492,0,1492,0,-7.186192529364172
ZCTA5 29472,2644,22,2622,0.00832072617246596,-7.186993371204565
ZCTA5 24013,3157,33,3124,0.010452961672473868,-7.187081802953752
ZCTA5 84664,2451,18,2433,0.0073439412484700125,-7.188641065107266
ZCTA5 19139,16643,390,16253,0.023433275250856214,-7.189337859689389
ZCTA5 08884,3339,37,3302,0.011081162024558252,-7.189476601137832
ZCTA5 11953,5252,82,5170,0.015613099771515614,-7.190322012797356
ZCTA5 31794,10287,213,10074,0.020705745115193935,-7.19062681238336
ZCTA5 28654,1494,0,1494,0,-7.191007399270774
ZCTA5 70005,11352,242,11110,0.02131782945736434,-7.191010654214891
ZCTA5 36201,7234,132,7102,0.01824716615980094,-7.192805575381776
ZCTA5 55921,2049,10,2039,0.004880429477794046,-7.19287361013346
ZCTA5 65473,2101,11,2090,0.005235602094240838,-7.19303815910306
ZCTA5 98422,7658,143,7515,0.01867328284147297,-7.193225269724975
ZCTA5 97374,1782,5,1777,0.0028058361391694723,-7.194903798570567
ZCTA5 04619,1496,0,1496,0,-7.195819047450027
ZCTA5 49801,4720,69,4651,0.01461864406779661,-7.196374027211767
ZCTA5 78729,12483,273,12210,0.021869742850276375,-7.197806548169586
ZCTA5 43506,6261,107,6154,0.017089921737741574,-7.200840058012256
ZCTA5 79911,1947,8,1939,0.004108885464817668,-7.200880806137387
ZCTA5 54660,6380,110,6270,0.017241379310344827,-7.201672839040966
ZCTA5 65078,1499,0,1499,0,-7.203030493102263
ZCTA5 04742,1499,0,1499,0,-7.203030493102263
ZCTA5 46225,2360,16,2344,0.006779661016949152,-7.206375276132547
ZCTA5 33035,4390,61,4329,0.013895216400911162,-7.206805241597044
ZCTA5 42127,2605,21,2584,0.008061420345489444,-7.207391268030809
ZCTA5 19035,1501,0,1501,0,-7.20783411517209
ZCTA5 43517,1619,2,1617,0.0012353304508956147,-7.209373657476801
ZCTA5 46148,2004,9,1995,0.004491017964071856,-7.2103943831207316
ZCTA5 63857,5181,80,5101,0.015441034549314805,-7.210430104678367
ZCTA5 21152,2212,13,2199,0.005877034358047016,-7.2128369279450535
ZCTA5 62644,2161,12,2149,0.005552984729291994,-7.21297486492181
ZCTA5 49099,2263,14,2249,0.0061864781263809105,-7.213649983363656
ZCTA5 97048,2656,22,2634,0.008283132530120483,-7.214058635054367
ZCTA5 26034,2110,11,2099,0.005213270142180095,-7.2141326893212465
ZCTA5 60403,6897,123,6774,0.01783384080034798,-7.214157986536534
ZCTA5 27052,4267,58,4209,0.013592688071244434,-7.215025216577815
ZCTA5 15342,2163,12,2151,0.005547850208044383,-7.217639867412649
ZCTA5 19090,7055,127,6928,0.018001417434443657,-7.218047522575721
ZCTA5 77062,9601,194,9407,0.02020622851786272,-7.218922585465782
ZCTA5 23192,2563,20,2543,0.007803355442840421,-7.221708507081495
ZCTA5 64153,2317,15,2302,0.006473888649115235,-7.222273250344065
ZCTA5 17043,2944,28,2916,0.009510869565217392,-7.224661511416554
ZCTA5 70462,2115,11,2104,0.005200945626477541,-7.22582719659683
ZCTA5 48626,2319,15,2304,0.00646830530401035,-7.22688488747303
ZCTA5 53565,2012,9,2003,0.0044731610337972166,-7.229226399091058
ZCTA5 53212,13012,287,12725,0.022056563172456193,-7.230225951691882
ZCTA5 44262,2013,9,2004,0.004470938897168405,-7.231577144935658
ZCTA5 52213,1511,0,1511,0,-7.231804364626204
ZCTA5 07863,1511,0,1511,0,-7.231804364626204
ZCTA5 42320,3360,37,3323,0.011011904761904763,-7.23437492301861
ZCTA5 70815,10575,220,10355,0.020803782505910164,-7.234522773124441
ZCTA5 74137,10834,227,10607,0.02095255676573749,-7.236463541279219
ZCTA5 44473,1513,0,1513,0,-7.236588886727243
ZCTA5 50674,1513,0,1513,0,-7.236588886727243
ZCTA5 20119,1513,0,1513,0,-7.236588886727243
ZCTA5 21163,2521,19,2502,0.00753669178897263,-7.236751201446306
ZCTA5 70611,7492,138,7354,0.018419647624132406,-7.236923129657737
ZCTA5 72160,4278,58,4220,0.013557737260402058,-7.23703191023584
ZCTA5 56425,3226,34,3192,0.010539367637941723,-7.237906167114026
ZCTA5 38571,5683,92,5591,0.016188632764385008,-7.238258145284072
ZCTA5 02859,2473,18,2455,0.007278608976951072,-7.238899058912264
ZCTA5 26385,1514,0,1514,0,-7.238979961924402
ZCTA5 26288,1514,0,1514,0,-7.238979961924402
ZCTA5 70123,11715,251,11464,0.02142552283397354,-7.240256375577646
ZCTA5 99703,2017,9,2008,0.004462072384729797,-7.240972920221924
ZCTA5 35646,1857,6,1851,0.0032310177705977385,-7.242858455585047
ZCTA5 42167,3454,39,3415,0.01129125651418645,-7.24357097764387
ZCTA5 28605,1516,0,1516,0,-7.243759744526362
ZCTA5 13118,2123,11,2112,0.0051813471502590676,-7.2445019772181825
ZCTA5 60005,12555,274,12281,0.021823974512146554,-7.247053770405306
ZCTA5 21087,1913,7,1906,0.0036591740721380033,-7.247114439556054
ZCTA5 65049,2672,22,2650,0.008233532934131737,-7.250013130629377
ZCTA5 01013,9285,185,9100,0.01992460958535272,-7.250038866153034
ZCTA5 65255,1519,0,1519,0,-7.2509235106527665
ZCTA5 30557,1915,7,1908,0.0036553524804177544,-7.25183181938442
ZCTA5 43031,5081,77,5004,0.015154497146231056,-7.254090238886076
ZCTA5 16229,2230,13,2217,0.005829596412556054,-7.254582255803602
ZCTA5 04864,1521,0,1521,0,-7.255695425292783
ZCTA5 31204,11726,251,11475,0.021405423844448233,-7.25575829680729
ZCTA5 39056,9365,187,9178,0.0199679658302189,-7.257872317806769
ZCTA5 76247,4246,57,4189,0.013424399434762129,-7.258231859595904
ZCTA5 19053,9776,198,9578,0.02025368248772504,-7.258323573295355
ZCTA5 84065,11363,241,11122,0.021209187714512013,-7.25889686844416
ZCTA5 78749,15428,354,15074,0.022945294270158154,-7.25901172859128
ZCTA5 46928,1809,5,1804,0.002763957987838585,-7.259111082114261
ZCTA5 60083,3506,40,3466,0.011409013120365089,-7.25911806756653
ZCTA5 49749,1864,6,1858,0.003218884120171674,-7.259409916672934
ZCTA5 48739,1972,8,1964,0.004056795131845842,-7.259827896348783
ZCTA5 71328,2433,17,2416,0.006987258528565557,-7.260035905089351
ZCTA5 29918,1523,0,1523,0,-7.260464203609313
ZCTA5 23336,1523,0,1523,0,-7.260464203609313
ZCTA5 15401,13359,296,13063,0.022157347106819374,-7.261218289945282
ZCTA5 33955,4376,60,4316,0.013711151736745886,-7.263017602883318
ZCTA5 65079,1642,2,1640,0.001218026796589525,-7.26430163573345
ZCTA5 10530,5738,93,5645,0.01620773788776577,-7.2651515937444
ZCTA5 36904,1526,0,1526,0,-7.267611503981802
ZCTA5 04064,4463,62,4401,0.013892000896258123,-7.267672709612242
ZCTA5 07648,2133,11,2122,0.005157055789967183,-7.2677828121942385
ZCTA5 28327,6299,107,6192,0.016986823305286555,-7.2681632462811905
ZCTA5 23831,13652,304,13348,0.022267799589803693,-7.268646760294537
ZCTA5 24360,2287,14,2273,0.006121556624398776,-7.2690666121612475
ZCTA5 03034,1527,0,1527,0,-7.269992375955247
ZCTA5 02356,4422,61,4361,0.013794663048394391,-7.270208920259448
ZCTA5 07974,4124,54,4070,0.013094083414161009,-7.271161465404919
ZCTA5 53040,3105,31,3074,0.00998389694041868,-7.272999541472393
ZCTA5 70401,7282,132,7150,0.01812688821752266,-7.273708204206947
ZCTA5 45631,6184,104,6080,0.016817593790426907,-7.275517890449655
ZCTA5 37135,3997,51,3946,0.012759569677257944,-7.2759369986614155
ZCTA5 43607,8964,176,8788,0.01963409192324855,-7.2765758615558225
ZCTA5 02638,1530,0,1530,0,-7.277130318151779
ZCTA5 48808,2441,17,2424,0.006964358869315854,-7.2782538667696075
ZCTA5 02911,6621,115,6506,0.01736897749584655,-7.278692067470075
ZCTA5 35903,6503,112,6391,0.017222820236813777,-7.279084881977972
ZCTA5 73107,10496,217,10279,0.02067454268292683,-7.281082365218172
ZCTA5 02370,6897,122,6775,0.017688850224735393,-7.281120698530678
ZCTA5 14548,1532,0,1532,0,-7.281885059147902
ZCTA5 21220,15128,345,14783,0.02280539397144368,-7.283780240884874
ZCTA5 04096,3474,39,3435,0.011226252158894647,-7.285819161828715
ZCTA5 95938,1534,0,1534,0,-7.286636697538791
ZCTA5 95614,1534,0,1534,0,-7.286636697538791
ZCTA5 47112,6032,100,5932,0.016578249336870028,-7.288922470073618
ZCTA5 48235,17745,419,17326,0.02361228515074669,-7.2909300253578175
ZCTA5 71433,1536,0,1536,0,-7.291385239390154
ZCTA5 54665,3566,41,3525,0.011497476163768929,-7.291591539837504
ZCTA5 77586,8824,172,8652,0.019492293744333637,-7.293603493466889
ZCTA5 19365,2595,20,2575,0.007707129094412331,-7.293911505368993
ZCTA5 40217,5915,97,5818,0.01639898562975486,-7.294557650478279
ZCTA5 68505,7023,125,6898,0.01779866154065214,-7.296151780175824
ZCTA5 12143,2041,9,2032,0.004409603135717786,-7.297107436323617
ZCTA5 93730,4223,56,4167,0.013260715131423158,-7.297700279577237
ZCTA5 03755,2789,24,2765,0.008605234851201148,-7.2978775802074285
ZCTA5 29654,3834,47,3787,0.012258737610850287,-7.298491526003056
ZCTA5 23663,5105,77,5028,0.015083251714005876,-7.299510906735348
ZCTA5 63445,1540,0,1540,0,-7.300873057638506
ZCTA5 27101,8829,172,8657,0.01948125495526107,-7.301437812010045
ZCTA5 12037,1882,6,1876,0.003188097768331562,-7.301803807144865
ZCTA5 14036,1990,8,1982,0.004020100502512563,-7.301988880578243
ZCTA5 02822,2352,15,2337,0.006377551020408163,-7.302599992860559
ZCTA5 28751,1772,4,1768,0.002257336343115124,-7.303089583795883
ZCTA5 18326,1541,0,1541,0,-7.303243086286436
ZCTA5 11730,4439,61,4378,0.013741833746339265,-7.303744407753285
ZCTA5 27341,2097,10,2087,0.004768717215069146,-7.305084993985197
ZCTA5 24219,4184,55,4129,0.013145315487571701,-7.305435497134655
ZCTA5 16511,4943,73,4870,0.014768359295974105,-7.3058750732274875
ZCTA5 50548,2552,19,2533,0.007445141065830721,-7.306829022484756
ZCTA5 16424,2046,9,2037,0.004398826979472141,-7.30875081099417
ZCTA5 92010,5963,98,5865,0.016434680529934596,-7.308766803202678
ZCTA5 01035,2355,15,2340,0.006369426751592357,-7.309448295700178
ZCTA5 60044,3927,49,3878,0.012477718360071301,-7.3101664525859125
ZCTA5 78726,5520,87,5433,0.01576086956521739,-7.3104394752141335
ZCTA5 02467,6004,99,5905,0.016489007328447703,-7.310440532703437
ZCTA5 47532,1719,3,1716,0.0017452006980802793,-7.3111264947162065
ZCTA5 08535,1545,0,1545,0,-7.312715519692109
ZCTA5 64156,2844,25,2819,0.008790436005625879,-7.314559353841119
ZCTA5 33909,10445,215,10230,0.0205840114887506,-7.314825039844239
ZCTA5 26062,9064,178,8886,0.01963812886142983,-7.3149137167460845
ZCTA5 39669,1546,0,1546,0,-7.315081711476956
ZCTA5 75454,2892,26,2866,0.008990318118948824,-7.316250029576105
ZCTA5 98290,12824,280,12544,0.021834061135371178,-7.317926858721504
ZCTA5 28202,6958,123,6835,0.01767749353262432,-7.318516619179265
ZCTA5 37184,2259,13,2246,0.005754758742806552,-7.3213816304366475
ZCTA5 42327,1550,0,1550,0,-7.324538834639339
ZCTA5 16625,1551,0,1551,0,-7.326901208135581
ZCTA5 34997,17670,416,17254,0.02354272778720996,-7.326925104559661
ZCTA5 41031,6014,99,5915,0.016461589624210175,-7.328350288764714
ZCTA5 29204,7160,128,7032,0.017877094972067038,-7.330064269044887
ZCTA5 28115,13483,298,13185,0.022101906103982792,-7.330640610341834
ZCTA5 02631,4241,56,4185,0.013204432916764914,-7.3336195179552
ZCTA5 64054,1554,0,1554,0,-7.3339837629146025
ZCTA5 20616,2265,13,2252,0.005739514348785872,-7.335132797622479
ZCTA5 16833,2214,12,2202,0.005420054200542005,-7.335674420365006
ZCTA5 37681,2516,18,2498,0.007154213036565978,-7.336261677909632
ZCTA5 63101,2163,11,2152,0.005085529357374018,-7.337213352555083
ZCTA5 60420,2111,10,2101,0.0047370914258645196,-7.337510241999708
ZCTA5 48117,3897,48,3849,0.012317167051578136,-7.337927027485138
ZCTA5 01770,1556,0,1556,0,-7.338701668685859
ZCTA5 04756,1556,0,1556,0,-7.338701668685859
ZCTA5 66614,14066,314,13752,0.02232333285937722,-7.341408298006679
ZCTA5 48191,1558,0,1558,0,-7.343416543357064
ZCTA5 20764,1558,0,1558,0,-7.343416543357064
ZCTA5 25301,1558,0,1558,0,-7.343416543357064
ZCTA5 19533,2370,15,2355,0.006329113924050633,-7.34360375871579
ZCTA5 06712,3367,36,3331,0.010692010692010692,-7.3451332363062845
ZCTA5 40026,1955,7,1948,0.0035805626598465474,-7.345567434681004
ZCTA5 49242,5661,90,5571,0.01589825119236884,-7.345734905239854
ZCTA5 53560,1560,0,1560,0,-7.3481283927628684
ZCTA5 08244,4504,62,4442,0.013765541740674956,-7.348175964889852
ZCTA5 55443,11022,230,10792,0.020867356196697513,-7.34872331692796
ZCTA5 68512,5296,81,5215,0.015294561933534742,-7.3492920214436195
ZCTA5 32751,8481,162,8319,0.01910152104704634,-7.350572114211494
ZCTA5 13456,1562,0,1562,0,-7.352837222719229
ZCTA5 18249,1562,0,1562,0,-7.352837222719229
ZCTA5 18972,1562,0,1562,0,-7.352837222719229
ZCTA5 34289,1563,0,1563,0,-7.355190507216263
ZCTA5 37341,4295,57,4238,0.013271245634458672,-7.355810485098289
ZCTA5 52246,10325,211,10114,0.020435835351089587,-7.356415587268822
ZCTA5 63012,3907,48,3859,0.012285641156897875,-7.35829436566292
ZCTA5 35007,8979,175,8804,0.019489920926606525,-7.358633740529309
ZCTA5 55975,1796,4,1792,0.0022271714922048997,-7.359488983734674
ZCTA5 73044,8220,155,8065,0.018856447688564478,-7.3601474475439606
ZCTA5 19095,2961,27,2934,0.00911854103343465,-7.364213016490138
ZCTA5 72632,2017,8,2009,0.0039662865642042635,-7.364798450977866
ZCTA5 22835,4513,62,4451,0.013738089962331043,-7.365769674399317
ZCTA5 12553,9323,184,9139,0.019736136436769282,-7.366061875451885
ZCTA5 37890,2820,24,2796,0.00851063829787234,-7.366259723575416
ZCTA5 11357,14515,326,14189,0.02245952462969342,-7.366412382525825
ZCTA5 47805,5058,75,4983,0.01482799525504152,-7.366786490911907
ZCTA5 00677,5141,77,5064,0.01497763081112624,-7.367318439467148
ZCTA5 19033,3149,31,3118,0.009844395046046363,-7.367884084599065
ZCTA5 45804,6197,103,6094,0.01662094561884783,-7.369249405494686
ZCTA5 54983,1856,5,1851,0.0026939655172413795,-7.369575487393751
ZCTA5 48317,11625,246,11379,0.021161290322580645,-7.370824355746885
ZCTA5 53042,2870,25,2845,0.008710801393728223,-7.371643317114624
ZCTA5 18324,3471,38,3433,0.010947853644482858,-7.373885751006129
ZCTA5 68142,1571,0,1571,0,-7.3739897468436055
ZCTA5 18240,1571,0,1571,0,-7.3739897468436055
ZCTA5 48005,2021,8,2013,0.0039584364176150424,-7.3740601243576265
ZCTA5 13114,2333,14,2319,0.006000857265323617,-7.3742274589353976
ZCTA5 59634,1913,6,1907,0.0031364349189754314,-7.3742613062617615
ZCTA5 55920,2919,26,2893,0.008907159986296678,-7.375308626309457
ZCTA5 72823,2384,15,2369,0.006291946308724832,-7.375353876929204
ZCTA5 07981,3517,39,3478,0.011088996303667898,-7.376038038635767
ZCTA5 01908,1572,0,1572,0,-7.376336283019736
ZCTA5 11705,2729,22,2707,0.008061561011359472,-7.376894924393338
ZCTA5 20115,2385,15,2370,0.006289308176100629,-7.377617038926887
ZCTA5 97080,15558,355,15203,0.022817842910399795,-7.377937216254616
ZCTA5 34480,6679,115,6564,0.017218146429106154,-7.379053595309912
ZCTA5 66436,2536,18,2518,0.007097791798107256,-7.381163241499283
ZCTA5 43460,2683,21,2662,0.007827059262020127,-7.382007360796468
ZCTA5 55435,6996,123,6873,0.01758147512864494,-7.383136308501075
ZCTA5 11715,1575,0,1575,0,-7.383371416982206
ZCTA5 89129,19954,480,19474,0.024055327252681166,-7.383396328730449
ZCTA5 33952,13739,304,13435,0.02212679234296528,-7.383684505362656
ZCTA5 33716,8882,172,8710,0.019365007881107857,-7.384245790742309
ZCTA5 75965,7504,136,7368,0.01812366737739872,-7.385301021778956
ZCTA5 02170,7621,139,7482,0.018239076236714342,-7.386624567310738
ZCTA5 04015,1577,0,1577,0,-7.388057784586381
ZCTA5 08270,3019,28,2991,0.009274594236502154,-7.3883048364680395
ZCTA5 04976,4440,60,4380,0.013513513513513514,-7.389172625116234
ZCTA5 21076,6961,122,6839,0.017526217497485994,-7.390283175916557
ZCTA5 22920,1578,0,1578,0,-7.390399854001557
ZCTA5 13084,1580,0,1580,0,-7.395081767587415
ZCTA5 43028,3162,31,3131,0.00980392156862745,-7.395733347582356
ZCTA5 32801,7394,133,7261,0.017987557479037058,-7.3960579277345095
ZCTA5 97304,11753,249,11504,0.021186080149749,-7.396346907315243
ZCTA5 17737,2592,19,2573,0.0073302469135802465,-7.396399515951294
ZCTA5 66219,5323,81,5242,0.015216982904377232,-7.3994786865861375
ZCTA5 92657,3884,47,3837,0.012100926879505664,-7.400621901169927
ZCTA5 25661,2740,22,2718,0.008029197080291971,-7.401168353315719
ZCTA5 02633,2033,8,2025,0.003935071323167732,-7.4017787089435805
ZCTA5 75251,1583,0,1583,0,-7.402099085409505
ZCTA5 01451,1583,0,1583,0,-7.402099085409505
ZCTA5 26753,2396,15,2381,0.006260434056761269,-7.402470708448562
ZCTA5 33545,5814,93,5721,0.015995872033023734,-7.402945232144615
ZCTA5 98580,4233,55,4178,0.012993149066855657,-7.403145167126277
ZCTA5 45123,3530,39,3491,0.01104815864022663,-7.403150696743066
ZCTA5 29164,1980,7,1973,0.0035353535353535356,-7.403571993262402
ZCTA5 61548,4362,58,4304,0.013296652911508482,-7.403630300597996
ZCTA5 27944,5243,79,5164,0.015067709326721343,-7.40377287772754
ZCTA5 87043,2244,12,2232,0.0053475935828877,-7.40429559435336
ZCTA5 18343,1584,0,1584,0,-7.404436713475173
ZCTA5 39645,2035,8,2027,0.003931203931203931,-7.406388834927206
ZCTA5 97539,1585,0,1585,0,-7.40677360376958
ZCTA5 81503,6378,107,6271,0.016776418940106615,-7.407044573756247
ZCTA5 89123,23638,586,23052,0.02479059142059396,-7.407468409853103
ZCTA5 37711,1983,7,1976,0.0035300050428643467,-7.410503148990958
ZCTA5 56215,1983,7,1976,0.0035300050428643467,-7.410503148990958
ZCTA5 32619,2037,8,2029,0.0039273441335297005,-7.41099621987471
ZCTA5 61953,2599,19,2580,0.007310504040015391,-7.411977479260004
ZCTA5 21144,11691,247,11444,0.02112736292874861,-7.412118809459546
ZCTA5 63090,8900,172,8728,0.019325842696629212,-7.412271820065083
ZCTA5 99005,2984,27,2957,0.009048257372654156,-7.414109926685116
ZCTA5 36272,5331,81,5250,0.015194147439504783,-7.414309064968835
ZCTA5 07430,9505,188,9317,0.019779063650710152,-7.414339022785707
ZCTA5 21029,3309,34,3275,0.010275007555152614,-7.414993194265469
ZCTA5 85355,3491,38,3453,0.010885133199656259,-7.415708044141753
ZCTA5 01985,1589,0,1589,0,-7.416113801180037
ZCTA5 17824,1764,3,1761,0.0017006802721088435,-7.416602179921746
ZCTA5 30273,4960,72,4888,0.014516129032258065,-7.417214812604192
ZCTA5 02032,1590,0,1590,0,-7.418447013067615
ZCTA5 67042,6702,115,6587,0.017159056997911072,-7.4186494562316
ZCTA5 94925,3893,47,3846,0.012072951451322887,-7.418898230087669
ZCTA5 31503,7757,142,7615,0.018306046151862834,-7.419440650342233
ZCTA5 83406,5904,95,5809,0.01609078590785908,-7.419466507984958
ZCTA5 37843,1650,1,1649,6.060606060606061e-4,-7.420215987206587
ZCTA5 17320,3034,28,3006,0.00922874093605801,-7.420682251108256
ZCTA5 10516,2200,11,2189,0.005,-7.422011462212098
ZCTA5 02675,3035,28,3007,0.009225700164744647,-7.422836664046423
ZCTA5 04222,1592,0,1592,0,-7.423111236736886
ZCTA5 48380,2702,21,2681,0.007772020725388601,-7.424009644876867
ZCTA5 48320,2406,15,2391,0.006234413965087282,-7.424999918843164
ZCTA5 81505,4459,60,4399,0.013455931823278762,-7.426348798442427
ZCTA5 77054,12614,272,12342,0.0215633423180593,-7.426848148521208
ZCTA5 03304,2752,22,2730,0.007994186046511628,-7.427571501589864
ZCTA5 80013,24994,625,24369,0.025006001440345683,-7.427585840399188
ZCTA5 45308,1594,0,1594,0,-7.427772531536425
ZCTA5 99223,13232,289,12943,0.021840991535671102,-7.4289932017351585
ZCTA5 54911,10523,215,10308,0.02043143590230923,-7.429126473610795
ZCTA5 01462,4203,54,4149,0.01284796573875803,-7.429207956728789
ZCTA5 24202,4757,67,4690,0.014084507042253521,-7.429396998406621
ZCTA5 60301,1595,0,1595,0,-7.430102082332774
ZCTA5 04055,1595,0,1595,0,-7.430102082332774
ZCTA5 15431,1770,3,1767,0.001694915254237288,-7.430553550516459
ZCTA5 04084,2802,23,2779,0.00820842255531763,-7.431676747798794
ZCTA5 97089,4632,64,4568,0.013816925734024179,-7.432411042135496
ZCTA5 35553,1596,0,1596,0,-7.432430902976805
ZCTA5 17067,5831,93,5738,0.015949236837592178,-7.433564148615476
ZCTA5 28168,3768,44,3724,0.01167728237791932,-7.4338875406149345
ZCTA5 24577,1939,6,1933,0.0030943785456420837,-7.434503511972556
ZCTA5 39705,5506,85,5421,0.01543770432255721,-7.434517058451793
ZCTA5 15203,5342,81,5261,0.015162860351928117,-7.434671345787782
ZCTA5 07420,1598,0,1598,0,-7.437086356551349
ZCTA5 14604,1598,0,1598,0,-7.437086356551349
ZCTA5 89029,3946,48,3898,0.012164216928535226,-7.437346417591579
ZCTA5 91381,6675,114,6561,0.01707865168539326,-7.440222817518157
ZCTA5 28139,8155,152,8003,0.01863887185775598,-7.440255536366889
ZCTA5 04294,1600,0,1600,0,-7.4417388977361885
ZCTA5 92119,9335,183,9152,0.019603642206748796,-7.441990643213368
ZCTA5 65584,4339,57,4282,0.013136667434892833,-7.442691053367398
ZCTA5 78657,2565,18,2547,0.007017543859649123,-7.4458479780481195
ZCTA5 61265,18928,449,18479,0.02372147083685545,-7.446502700271881
ZCTA5 98816,2466,16,2450,0.006488240064882401,-7.4469144235702585
ZCTA5 18452,2263,12,2251,0.005302695536897923,-7.447453406802076
ZCTA5 98390,4513,61,4452,0.013516507866164413,-7.448550638588894
ZCTA5 04357,1603,0,1603,0,-7.448712260719716
ZCTA5 19567,2000,7,1993,0.0035,-7.44966229324122
ZCTA5 62557,3048,28,3020,0.009186351706036745,-7.450797894638402
ZCTA5 08812,4684,65,4619,0.013877028181041844,-7.451138528705992
ZCTA5 33785,3002,27,2975,0.00899400399733511,-7.452968749988438
ZCTA5 48847,2368,14,2354,0.0059121621621621625,-7.4533384923781325
ZCTA5 68066,2214,11,2203,0.004968383017163505,-7.453862680399159
ZCTA5 62918,4129,52,4077,0.012593848389440542,-7.4543235751481385
ZCTA5 71269,4302,56,4246,0.01301720130172013,-7.454465623469008
ZCTA5 56267,2569,18,2551,0.0070066173608407945,-7.4547312720784085
ZCTA5 06471,3144,30,3114,0.009541984732824428,-7.4563300581430365
ZCTA5 83713,10393,211,10182,0.020302126431251805,-7.456404675007506
ZCTA5 04429,1838,4,1834,0.002176278563656148,-7.457177327839523
ZCTA5 12885,1949,6,1943,0.0030785017957927143,-7.457547731156308
ZCTA5 25143,3512,38,3474,0.01082004555808656,-7.459429655084178
ZCTA5 01370,1839,4,1835,0.002175095160413268,-7.45948788322031
ZCTA5 82941,1608,0,1608,0,-7.460320047504009
ZCTA5 01516,3146,30,3116,0.009535918626827717,-7.460593424015822
ZCTA5 27896,8398,158,8240,0.018814003334127173,-7.4610415264988665
ZCTA5 55045,3006,27,2979,0.008982035928143712,-7.46158149875961
ZCTA5 07072,2321,13,2308,0.005601034037052995,-7.462357550329299
ZCTA5 76360,1609,0,1609,0,-7.462639438216819
ZCTA5 73651,1610,0,1610,0,-7.464958108286196
ZCTA5 02135,19539,466,19073,0.023849736424586723,-7.466028770116926
ZCTA5 08827,1611,0,1611,0,-7.4672760583834465
ZCTA5 12186,2425,15,2410,0.006185567010309278,-7.467636530216333
ZCTA5 07701,9804,195,9609,0.01988984088127295,-7.469055008274418
ZCTA5 43543,3243,32,3211,0.009867406722170829,-7.469756262903115
ZCTA5 98075,7750,141,7609,0.018193548387096775,-7.471167632763603
ZCTA5 21090,3742,43,3699,0.011491181186531267,-7.471504258612345
ZCTA5 43207,17792,416,17376,0.023381294964028777,-7.47192320429042
ZCTA5 44444,4225,54,4171,0.012781065088757397,-7.472808954942135
ZCTA5 36083,3428,36,3392,0.010501750291715286,-7.473319199504831
ZCTA5 05450,1956,6,1950,0.003067484662576687,-7.473637606333655
ZCTA5 27350,2528,17,2511,0.006724683544303798,-7.473836386565854
ZCTA5 65711,3965,48,3917,0.01210592686002522,-7.475642042801842
ZCTA5 06890,1615,0,1615,0,-7.476540672440819
ZCTA5 79121,2579,18,2561,0.006979449398991857,-7.476898852582429
ZCTA5 13032,4740,66,4674,0.013924050632911392,-7.477544053888601
ZCTA5 75495,2871,24,2847,0.008359456635318705,-7.477619397601381
ZCTA5 15074,3611,40,3571,0.011077263915812794,-7.4778796401051135
ZCTA5 13357,4271,55,4216,0.01287754624209787,-7.478314482536256
ZCTA5 18618,1616,0,1616,0,-7.478855032710595
ZCTA5 26170,2277,12,2265,0.005270092226613966,-7.479106439067149
ZCTA5 57110,6619,112,6507,0.016920985043057862,-7.480281582714019
ZCTA5 06426,1617,0,1617,0,-7.481168677014268
ZCTA5 98371,8335,156,8179,0.01871625674865027,-7.482630219721616
ZCTA5 70719,1618,0,1618,0,-7.483481606015893
ZCTA5 58501,13382,292,13090,0.021820355701688835,-7.484257986755925
ZCTA5 56721,4057,50,4007,0.012324377618930245,-7.484495159422449
ZCTA5 17960,1678,1,1677,5.959475566150178e-4,-7.485214318954675
ZCTA5 47601,5779,91,5688,0.015746668973870913,-7.485980927966096
ZCTA5 46567,3707,42,3665,0.01132991637442676,-7.491083299845002
ZCTA5 53531,1739,2,1737,0.0011500862564692352,-7.491545689307992
ZCTA5 49094,1622,0,1622,0,-7.492726182247247
ZCTA5 15314,1623,0,1623,0,-7.495035544663694
ZCTA5 26426,2637,19,2618,0.00720515737580584,-7.496050381437999
ZCTA5 43830,2336,13,2323,0.005565068493150685,-7.496099199819243
ZCTA5 90210,8036,148,7888,0.01841712294673967,-7.496317316806159
ZCTA5 48604,4107,51,4056,0.01241782322863404,-7.497171717945777
ZCTA5 17954,1967,6,1961,0.003050330452465684,-7.498853905469918
ZCTA5 24531,3349,34,3315,0.01015228426395939,-7.499171199794496
ZCTA5 58523,1625,0,1625,0,-7.499652136136037
ZCTA5 20759,1625,0,1625,0,-7.499652136136037
ZCTA5 28203,8193,152,8041,0.018552422799951177,-7.501085726998526
ZCTA5 46342,11534,241,11293,0.020894745968441132,-7.501110930064298
ZCTA5 60140,6031,97,5934,0.016083568230807494,-7.501958535289098
ZCTA5 61745,1626,0,1626,0,-7.501959366504768
ZCTA5 19056,5543,85,5458,0.015334656323290638,-7.5021203285951215
ZCTA5 02143,11168,231,10937,0.02068409742120344,-7.504934636459397
ZCTA5 30461,5463,83,5380,0.01519311733479773,-7.505963422444334
ZCTA5 21032,3121,29,3092,0.009291893623838513,-7.506704244668399
ZCTA5 35043,3671,41,3630,0.011168618904930537,-7.5089681815274885
ZCTA5 14569,2643,19,2624,0.007188800605372683,-7.509249840459767
ZCTA5 30257,1630,0,1630,0,-7.511181200799499
ZCTA5 54806,4842,68,4774,0.014043783560512184,-7.511237548291988
ZCTA5 56334,2644,19,2625,0.0071860816944024205,-7.511447777556351
ZCTA5 43947,2081,8,2073,0.0038443056222969728,-7.511674653419063
ZCTA5 01238,2292,12,2280,0.005235602094240838,-7.512883331619292
ZCTA5 28692,1631,0,1631,0,-7.513484890840109
ZCTA5 23417,1631,0,1631,0,-7.513484890840109
ZCTA5 20106,2028,7,2021,0.0034516765285996054,-7.513730626142698
ZCTA5 37153,2189,10,2179,0.0045682960255824575,-7.515757055953556
ZCTA5 22947,1632,0,1632,0,-7.51578787476878
ZCTA5 33881,12680,272,12408,0.02145110410094637,-7.516537622939096
ZCTA5 76549,17267,400,16867,0.02316557595413216,-7.518496000306365
ZCTA5 07626,2890,24,2866,0.008304498269896194,-7.518751990712792
ZCTA5 93422,12791,275,12516,0.021499491830193104,-7.518932196151163
ZCTA5 06085,2938,25,2913,0.00850918992511913,-7.519233749691712
ZCTA5 49285,2138,9,2129,0.00420954162768943,-7.519938399639772
ZCTA5 98671,8512,160,8352,0.018796992481203006,-7.520239184611849
ZCTA5 24277,2296,12,2284,0.005226480836236934,-7.5218667643715085
ZCTA5 08027,1922,5,1917,0.0026014568158168575,-7.522017124434959
ZCTA5 21663,1635,0,1635,0,-7.522692596367196
ZCTA5 07734,5183,76,5107,0.01466332240015435,-7.5231887145257215
ZCTA5 98105,16564,380,16184,0.02294131852209611,-7.524359984866264
ZCTA5 18074,2193,10,2183,0.004559963520291838,-7.5247907541004375
ZCTA5 33028,8054,148,7906,0.018375962254780234,-7.525250618669068
ZCTA5 17728,2087,8,2079,0.003833253473885961,-7.525303630731836
ZCTA5 75249,5143,75,5068,0.014582928251993,-7.5261646257132
ZCTA5 33956,1637,0,1637,0,-7.527292225409839
ZCTA5 02421,6766,115,6651,0.01699674844812297,-7.5282326447166055
ZCTA5 32960,8364,156,8208,0.018651362984218076,-7.52864058752949
ZCTA5 37830,12289,261,12028,0.02123850598095858,-7.53080357049998
ZCTA5 08559,2036,7,2029,0.00343811394891945,-7.531939274833445
ZCTA5 38363,2249,11,2238,0.004891062694530902,-7.532940427901291
ZCTA5 32686,1871,4,1867,0.002137894174238375,-7.533056955752537
ZCTA5 41501,9735,192,9543,0.019722650231124808,-7.534461904914372
ZCTA5 63040,3040,27,3013,0.008881578947368421,-7.534462827256804
ZCTA5 86429,3549,38,3511,0.010707241476472246,-7.535991933678817
ZCTA5 74003,5685,88,5597,0.015479331574318382,-7.536944100885219
ZCTA5 76249,2852,23,2829,0.008064516129032258,-7.540428834829747
ZCTA5 27609,15510,350,15160,0.02256608639587363,-7.540908275112437
ZCTA5 41056,5524,84,5440,0.015206372194062274,-7.542274438437747
ZCTA5 82601,11968,252,11716,0.021056149732620322,-7.5427386347536505
ZCTA5 80906,15011,336,14675,0.022383585370728133,-7.542956947510019
ZCTA5 01534,2307,12,2295,0.005201560468140442,-7.5465200741258744
ZCTA5 70072,19750,470,19280,0.02379746835443038,-7.547082189027513
ZCTA5 48049,2203,10,2193,0.004539264639128461,-7.547330405905881
ZCTA5 25832,1646,0,1646,0,-7.547955869602354
ZCTA5 35555,3869,45,3824,0.011630912380460066,-7.548899972444049
ZCTA5 63016,3047,27,3020,0.008861174926156876,-7.549395857451308
ZCTA5 31553,1766,2,1764,0.0011325028312570782,-7.553588413916408
ZCTA5 11510,10648,216,10432,0.0202854996243426,-7.556865846696711
ZCTA5 30518,16911,389,16522,0.023002779256105492,-7.558318249492349
ZCTA5 24124,1938,5,1933,0.0025799793601651187,-7.558519386764809
ZCTA5 58047,1651,0,1651,0,-7.559411265281088
ZCTA5 49082,2262,11,2251,0.004862953138815208,-7.562115260580184
ZCTA5 12122,1995,6,1989,0.0030075187969924814,-7.562671932023002
ZCTA5 40391,14273,315,13958,0.022069641981363415,-7.5637791128358245
ZCTA5 38606,5659,87,5572,0.015373740943629616,-7.563862624287266
ZCTA5 49230,4401,57,4344,0.012951601908657124,-7.563952193975763
ZCTA5 99567,3148,29,3119,0.009212198221092757,-7.563971294624859
ZCTA5 17252,1653,0,1653,0,-7.5639885658914245
ZCTA5 18977,1653,0,1653,0,-7.5639885658914245
ZCTA5 01951,1654,0,1654,0,-7.566276177788848
ZCTA5 24381,1654,0,1654,0,-7.566276177788848
ZCTA5 80304,11286,233,11053,0.020645046960836435,-7.567549283783902
ZCTA5 53130,3103,28,3075,0.009023525620367387,-7.568161092667202
ZCTA5 37336,1655,0,1655,0,-7.568563098251464
ZCTA5 04079,1656,0,1656,0,-7.570849327905861
ZCTA5 14004,4145,51,4094,0.012303980699638117,-7.572535237197942
ZCTA5 52753,2054,7,2047,0.0034079844206426485,-7.572754177084031
ZCTA5 28451,14064,309,13755,0.02197098976109215,-7.573258112427921
ZCTA5 48137,2000,6,1994,0.003,-7.574012968931222
ZCTA5 78250,18794,442,18352,0.023518144088538896,-7.575109975451772
ZCTA5 38683,2163,9,2154,0.004160887656033287,-7.576360322839952
ZCTA5 37204,5789,90,5699,0.01554672655035412,-7.577054915834011
ZCTA5 05819,3794,43,3751,0.011333684765419082,-7.577187216477579
ZCTA5 45239,11773,246,11527,0.020895268835470993,-7.578113507038683
ZCTA5 27243,1777,2,1775,0.0011254924029262803,-7.578720091501392
ZCTA5 46121,2111,8,2103,0.0037896731406916154,-7.579584732412892
ZCTA5 13159,2058,7,2051,0.003401360544217687,-7.581795339013446
ZCTA5 54162,3435,35,3400,0.010189228529839884,-7.5828063227337354
ZCTA5 94117,18204,425,17779,0.023346517248956273,-7.584034212104255
ZCTA5 48021,12439,264,12175,0.021223571026609857,-7.58588798074463
ZCTA5 06119,6601,110,6491,0.01666414179669747,-7.586151155106326
ZCTA5 14456,7431,131,7300,0.017628852106042255,-7.586498884887744
ZCTA5 19127,2529,16,2513,0.006326611308817715,-7.586641180941332
ZCTA5 11570,10258,205,10053,0.01998440241762527,-7.586774140607758
ZCTA5 30187,2922,24,2898,0.008213552361396304,-7.5876029431590055
ZCTA5 95959,7510,133,7377,0.01770972037283622,-7.587746068812042
ZCTA5 72450,14544,322,14222,0.022139713971397138,-7.5882530479315
ZCTA5 67410,4197,52,4145,0.012389802239695021,-7.588967559899975
ZCTA5 81419,1664,0,1664,0,-7.589114370923857
ZCTA5 61016,2116,8,2108,0.003780718336483932,-7.590846466689222
ZCTA5 80543,2531,16,2515,0.006321612011062821,-7.59103912574751
ZCTA5 13068,2170,9,2161,0.004147465437788019,-7.592087003940779
ZCTA5 12586,4069,49,4020,0.01204227082821332,-7.595629828341731
ZCTA5 12833,1667,0,1667,0,-7.59595243902168
ZCTA5 71111,17261,398,16863,0.02305776026881409,-7.595962734033242
ZCTA5 60081,3443,35,3408,0.010165553296543712,-7.5993567265836734
ZCTA5 06281,2635,18,2617,0.00683111954459203,-7.599982053178519
ZCTA5 62285,1669,0,1669,0,-7.600507733247628
ZCTA5 28466,4072,49,4023,0.012033398821218075,-7.60157776534964
ZCTA5 84004,2735,20,2715,0.007312614259597806,-7.6028174128483315
ZCTA5 60419,7637,136,7501,0.017808039806206627,-7.603852519523669
ZCTA5 30560,2068,7,2061,0.0033849129593810446,-7.604352810868527
ZCTA5 48326,9404,182,9222,0.019353466609953213,-7.604360175294993
ZCTA5 42041,1903,4,1899,0.0021019442984760903,-7.605924630548309
ZCTA5 44667,5311,78,5233,0.014686499717567313,-7.606125715159848
ZCTA5 27045,3674,40,3634,0.010887316276537834,-7.606857212249763
ZCTA5 55359,2283,11,2272,0.004818221638195357,-7.609022653491076
ZCTA5 07079,5146,74,5072,0.014380101049358725,-7.609273481910958
ZCTA5 72650,1673,0,1673,0,-7.609610140980431
ZCTA5 49228,2178,9,2169,0.004132231404958678,-7.6100224894802295
ZCTA5 38344,3076,27,3049,0.008777633289986996,-7.611003416519667
ZCTA5 02035,6657,111,6546,0.016674177557458314,-7.613708413925673
ZCTA5 08221,2491,15,2476,0.00602167804094741,-7.614064086176797
ZCTA5 24066,2181,9,2172,0.0041265474552957355,-7.616737934680573
ZCTA5 79015,7723,138,7585,0.017868703871552507,-7.616898554592512
ZCTA5 15145,3267,31,3236,0.009488827670645853,-7.617681130186204
ZCTA5 06779,3360,33,3327,0.009821428571428571,-7.618129439598952
ZCTA5 48631,1677,0,1677,0,-7.618701673662476
ZCTA5 63107,4037,48,3989,0.01189001733960862,-7.619500779026875
ZCTA5 49265,2129,8,2121,0.0037576326914044154,-7.620052278785909
ZCTA5 08731,7725,138,7587,0.017864077669902913,-7.620145941826524
ZCTA5 01740,1678,0,1678,0,-7.620972862168334
ZCTA5 59833,2289,11,2278,0.004805591961555264,-7.622375110084627
ZCTA5 47102,2695,19,2676,0.007050092764378479,-7.622805377503112
ZCTA5 95423,1679,0,1679,0,-7.623243374020339
ZCTA5 89523,14428,318,14110,0.022040476850568338,-7.624220114108898
ZCTA5 18507,2077,7,2070,0.003370245546461242,-7.624599398357713
ZCTA5 61048,1680,0,1680,0,-7.625513209822917
ZCTA5 65265,5941,93,5848,0.015653930314761824,-7.629932743653594
ZCTA5 35473,6104,97,6007,0.01589121887287025,-7.630796375638838
ZCTA5 33431,7576,134,7442,0.017687434002111934,-7.63180230376858
ZCTA5 03036,1683,0,1683,0,-7.632318666964856
ZCTA5 61832,14435,318,14117,0.022029788708001385,-7.633210645089597
ZCTA5 43334,2189,9,2180,0.004111466423024212,-7.634618298651027
ZCTA5 57022,1802,2,1800,0.0011098779134295228,-7.6355312043915635
ZCTA5 45701,10926,222,10704,0.020318506315211423,-7.6356917801634525
ZCTA5 22812,3415,34,3381,0.009956076134699853,-7.63646915971919
ZCTA5 29574,4265,53,4212,0.01242672919109027,-7.636787797310585
ZCTA5 71483,3689,40,3649,0.010843046896177827,-7.637322563384997
ZCTA5 47714,13607,295,13312,0.021680017637980453,-7.637951881563046
ZCTA5 60490,6068,96,5972,0.015820698747528016,-7.63880989200185
ZCTA5 55431,7970,144,7826,0.01806775407779172,-7.63892094859488
ZCTA5 44904,5660,86,5574,0.01519434628975265,-7.639586111176147
ZCTA5 78736,3278,31,3247,0.009456985967053081,-7.64063300389342
ZCTA5 71106,13064,280,12784,0.021432945499081445,-7.641045886352783
ZCTA5 49740,3232,30,3202,0.009282178217821782,-7.6420994835351745
ZCTA5 14572,2139,8,2131,0.0037400654511453952,-7.642445431050878
ZCTA5 26047,2504,15,2489,0.0059904153354632585,-7.642606075439491
ZCTA5 98011,13286,286,13000,0.021526418786692758,-7.64577885925217
ZCTA5 12188,4616,61,4555,0.013214904679376083,-7.647024714184429
ZCTA5 35953,2657,18,2639,0.006774557771923222,-7.647856478481549
ZCTA5 21128,5083,72,5011,0.014164863269722605,-7.647889559606736
ZCTA5 02532,5707,87,5620,0.01524443665673734,-7.650196003753474
ZCTA5 08106,3965,46,3919,0.011601513240857503,-7.652274921565675
ZCTA5 79201,2250,10,2240,0.0044444444444444444,-7.652427337245221
ZCTA5 46580,8558,159,8399,0.018579107268053282,-7.652624627095353
ZCTA5 19953,1692,0,1692,0,-7.652698726387274
ZCTA5 61061,2953,24,2929,0.008127328140873687,-7.65380282900222
ZCTA5 79922,2611,17,2594,0.0065109153581003444,-7.656281941865555
ZCTA5 61834,2711,19,2692,0.007008483954260421,-7.657447836660429
ZCTA5 36587,3193,29,3164,0.009082367679298466,-7.658640208098852
ZCTA5 19066,1695,0,1695,0,-7.659480029203405
ZCTA5 85748,7515,132,7383,0.017564870259481037,-7.660102242826209
ZCTA5 62254,2512,15,2497,0.005971337579617835,-7.660122386846981
ZCTA5 29451,1927,4,1923,0.0020757654385054488,-7.660126839958723
ZCTA5 00920,6924,117,6807,0.016897746967071057,-7.661437673157613
ZCTA5 18651,3701,40,3661,0.010807889759524453,-7.661628481065008
ZCTA5 65010,2359,12,2347,0.005086901229334464,-7.662065425837091
ZCTA5 48421,2462,14,2448,0.005686433793663688,-7.662118908917875
ZCTA5 14871,1984,5,1979,0.0025201612903225806,-7.662514312233453
ZCTA5 19551,1872,3,1869,0.0016025641025641025,-7.663876275940853
ZCTA5 24065,2910,23,2887,0.007903780068728522,-7.6649358233769105
ZCTA5 03264,2256,10,2246,0.004432624113475178,-7.665745992184315
ZCTA5 35014,1698,0,1698,0,-7.666255333517285
ZCTA5 67062,1698,0,1698,0,-7.666255333517285
ZCTA5 03257,1698,0,1698,0,-7.666255333517285
ZCTA5 12801,6488,106,6382,0.016337854500616523,-7.66709535142529
ZCTA5 24421,1699,0,1699,0,-7.668512438036533
ZCTA5 18929,3245,30,3215,0.009244992295839754,-7.669233483004511
ZCTA5 19504,1987,5,1982,0.0025163563160543532,-7.669248577239012
ZCTA5 95945,11136,227,10909,0.02038433908045977,-7.670088313357522
ZCTA5 54311,13813,300,13513,0.021718670817345978,-7.6702877588219165
ZCTA5 14611,6370,103,6267,0.01616954474097331,-7.6717567736942645
ZCTA5 75169,5096,72,5024,0.0141287284144427,-7.672008344079729
ZCTA5 68803,9752,190,9562,0.01948318293683347,-7.672546881268114
ZCTA5 61074,1989,5,1984,0.002513826043237808,-7.6737348682622315
ZCTA5 67156,5390,79,5311,0.014656771799628942,-7.674623952215685
ZCTA5 71129,5056,71,4985,0.014042721518987342,-7.67584857962709
ZCTA5 48083,9224,176,9048,0.019080659150043366,-7.676938352889154
ZCTA5 29671,6814,114,6700,0.016730261226885822,-7.677221350164748
ZCTA5 36426,6090,96,5994,0.015763546798029555,-7.67744783104252
ZCTA5 08518,2314,11,2303,0.004753673292999135,-7.677776016022166
ZCTA5 33767,4111,49,4062,0.011919241060569205,-7.678597956607834
ZCTA5 18436,4804,65,4739,0.013530391340549543,-7.6795908888457864
ZCTA5 47567,2471,14,2457,0.0056657223796034,-7.6818362640686555
ZCTA5 14882,1705,0,1705,0,-7.68204113853563
ZCTA5 10533,2623,17,2606,0.006481128478841022,-7.682339419202154
ZCTA5 46107,5103,72,5031,0.014109347442680775,-7.684975076553491
ZCTA5 67456,1707,0,1707,0,-7.686545413996551
ZCTA5 83647,8155,148,8007,0.018148375229920296,-7.686582047616078
ZCTA5 19464,18186,422,17764,0.023204662927526667,-7.686667271277814
ZCTA5 94301,7177,123,7054,0.017138079977706562,-7.686928214475456
ZCTA5 46011,6980,118,6862,0.0169054441260745,-7.688781212870785
ZCTA5 24095,1996,5,1991,0.00250501002004008,-7.689416675808751
ZCTA5 46970,8851,166,8685,0.01875494294430008,-7.69052805011805
ZCTA5 42086,1709,0,1709,0,-7.691047051520943
ZCTA5 08525,1885,3,1882,0.0015915119363395225,-7.693109412087624
ZCTA5 70431,1999,5,1994,0.0025012506253126563,-7.696127858638488
ZCTA5 28204,3536,36,3500,0.010180995475113122,-7.696200662347226
ZCTA5 32757,11303,231,11072,0.020437052110059275,-7.696220405102359
ZCTA5 01610,7928,142,7786,0.01791120080726539,-7.696285528151667
ZCTA5 36732,3258,30,3228,0.009208103130755065,-7.69628970635545
ZCTA5 78957,3537,36,3501,0.010178117048346057,-7.698240846702866
ZCTA5 03276,3261,30,3231,0.00919963201471941,-7.702522469101462
ZCTA5 38668,4986,69,4917,0.013838748495788207,-7.7026237802973325
ZCTA5 43623,9127,173,8954,0.018954749643913662,-7.703359927978561
ZCTA5 03044,1715,0,1715,0,-7.70453618270054
ZCTA5 03033,1715,0,1715,0,-7.70453618270054
ZCTA5 19031,1715,0,1715,0,-7.70453618270054
ZCTA5 02921,4474,57,4417,0.01274027715690657,-7.705033408008807
ZCTA5 11518,3948,45,3903,0.011398176291793313,-7.706903319903998
ZCTA5 06279,2483,14,2469,0.005638340716874748,-7.70805417261613
ZCTA5 29470,1717,0,1717,0,-7.709027314637003
ZCTA5 93265,1717,0,1717,0,-7.709027314637003
ZCTA5 64628,2433,13,2420,0.005343197698314837,-7.711010507291573
ZCTA5 60456,1718,0,1718,0,-7.711271899723041
ZCTA5 02832,1718,0,1718,0,-7.711271899723041
ZCTA5 37748,6914,116,6798,0.016777552791437663,-7.711482219019444
ZCTA5 48532,8287,151,8136,0.01822131048630385,-7.71161813244637
ZCTA5 53705,11796,244,11552,0.020684977958630044,-7.712526097574947
ZCTA5 34974,9779,190,9589,0.019429389508129665,-7.712743709159533
ZCTA5 28675,2981,24,2957,0.008050989600805098,-7.7131820916394185
ZCTA5 85377,1719,0,1719,0,-7.713515831648821
ZCTA5 06412,1720,0,1720,0,-7.715759110984207
ZCTA5 24260,2118,7,2111,0.0033050047214353163,-7.716183743123507
ZCTA5 13417,1721,0,1721,0,-7.718001738298237
ZCTA5 42544,2280,10,2270,0.0043859649122807015,-7.71880326702041
ZCTA5 37076,16693,379,16314,0.022704127478583837,-7.724026085417023
ZCTA5 06483,6239,99,6140,0.015867927552492386,-7.724949621242514
ZCTA5 43232,18748,437,18311,0.023309152976317474,-7.724969915345651
ZCTA5 60545,4398,55,4343,0.01250568440200091,-7.725828039016636
ZCTA5 15133,2987,24,2963,0.008034817542684968,-7.7258557882391035
ZCTA5 11769,3366,32,3334,0.009506833036244802,-7.726429876555617
ZCTA5 43412,1725,0,1725,0,-7.726965738692634
ZCTA5 10989,3460,34,3426,0.009826589595375723,-7.728975043271979
ZCTA5 01033,2493,14,2479,0.005615724027276374,-7.729840140302951
ZCTA5 50219,5128,72,5056,0.014040561622464899,-7.7311695047701825
ZCTA5 08510,1727,0,1727,0,-7.731443841496064
ZCTA5 22302,8067,145,7922,0.01797446386512954,-7.731862352467831
ZCTA5 18353,4095,48,4047,0.011721611721611722,-7.733970994643624
ZCTA5 83638,2495,14,2481,0.0056112224448897794,-7.734190578682897
ZCTA5 60484,2444,13,2431,0.005319148936170213,-7.7350338319065
ZCTA5 08628,3918,44,3874,0.011230219499744768,-7.736030527413227
ZCTA5 71251,3136,27,3109,0.00860969387755102,-7.737174733597217
ZCTA5 20120,13574,292,13282,0.02151171357006041,-7.737730881483496
ZCTA5 62549,2342,11,2331,0.004696840307429547,-7.7393831482135855
ZCTA5 65785,2183,8,2175,0.0036646816307833257,-7.740236245571578
ZCTA5 48357,3185,28,3157,0.008791208791208791,-7.740419222351084
ZCTA5 98406,9722,188,9534,0.019337584859082494,-7.740571894229035
ZCTA5 21154,2019,5,2014,0.0024764735017335313,-7.7407232336671274
ZCTA5 66547,3558,36,3522,0.01011804384485666,-7.740987387184498
ZCTA5 46360,17705,407,17298,0.022987856537701214,-7.744763191097913
ZCTA5 07936,3697,39,3658,0.010549093859886394,-7.744994557342102
ZCTA5 23930,2292,10,2282,0.004363001745200698,-7.745202923616372
ZCTA5 10956,10330,204,10126,0.019748305905130686,-7.746798210083787
ZCTA5 21111,1734,0,1734,0,-7.747096816852038
ZCTA5 44065,1735,0,1735,0,-7.749330375156154
ZCTA5 52772,2188,8,2180,0.003656307129798903,-7.751273835620967
ZCTA5 23181,2134,7,2127,0.0032802249297094657,-7.751639950718844
ZCTA5 11598,3971,45,3926,0.011332158146562578,-7.7524552733881595
ZCTA5 54229,1912,3,1909,0.0015690376569037657,-7.753475090802302
ZCTA5 48866,1913,3,1910,0.0015682174594877157,-7.755701906378886
ZCTA5 23310,1913,3,1910,0.0015682174594877157,-7.755701906378886
ZCTA5 28318,1739,0,1739,0,-7.758258178088237
ZCTA5 12845,2027,5,2022,0.00246669955599408,-7.758490975393669
ZCTA5 48383,4761,63,4698,0.013232514177693762,-7.759444953631101
ZCTA5 24361,2083,6,2077,0.0028804608737397984,-7.7599163354744345
ZCTA5 53583,2508,14,2494,0.0055821371610845294,-7.762413877791871
ZCTA5 03860,1741,0,1741,0,-7.762718229148253
ZCTA5 34453,4418,55,4363,0.01244907197827071,-7.764300871777321
ZCTA5 43351,4155,49,4106,0.011793020457280385,-7.764826442286994
ZCTA5 30183,1974,4,1970,0.002026342451874367,-7.765191659472515
ZCTA5 85615,3978,45,3933,0.011312217194570135,-7.766279456354704
ZCTA5 30014,13560,291,13269,0.021460176991150444,-7.767113592301616
ZCTA5 12077,2713,18,2695,0.006634721710283818,-7.7685357515206235
ZCTA5 20754,2460,13,2447,0.005284552845528455,-7.7698541900363125
ZCTA5 58703,9362,178,9184,0.01901303140354625,-7.770541569904244
ZCTA5 24558,2664,17,2647,0.0063813813813813815,-7.770778373202552
ZCTA5 14085,2614,16,2598,0.00612088752869166,-7.771574046073075
ZCTA5 33713,12724,268,12456,0.021062558943728386,-7.773301843546865
ZCTA5 49270,2144,7,2137,0.0032649253731343282,-7.773720574085994
ZCTA5 07401,2254,9,2245,0.003992901508429458,-7.7784437397491635
ZCTA5 43440,2516,14,2502,0.005564387917329093,-7.7797353278035235
ZCTA5 95030,5070,70,5000,0.013806706114398421,-7.779924458949069
ZCTA5 46748,1749,0,1749,0,-7.780532866986746
ZCTA5 44502,3941,44,3897,0.011164679015478305,-7.781584926723967
ZCTA5 54942,3532,35,3497,0.009909399773499434,-7.781609175056006
ZCTA5 43431,1750,0,1750,0,-7.782756829549527
ZCTA5 29154,11291,229,11062,0.020281640244442477,-7.783970035686126
ZCTA5 36022,4385,54,4331,0.012314709236031927,-7.784728688874774
ZCTA5 01468,1751,0,1751,0,-7.784980156785155
ZCTA5 45714,4077,47,4030,0.011528084375766495,-7.785673379937909
ZCTA5 29607,17243,393,16850,0.022791857565388852,-7.78617566862053
ZCTA5 43105,2871,21,2850,0.0073145245559038665,-7.7889829730906195
ZCTA5 46184,4734,62,4672,0.01309674693705112,-7.7893598746618595
ZCTA5 35470,1753,0,1753,0,-7.789424907450884
ZCTA5 93614,4562,58,4504,0.012713722051731697,-7.790414782695649
ZCTA5 56468,1929,3,1926,0.0015552099533437014,-7.79124508800476
ZCTA5 13035,3163,27,3136,0.00853619981030667,-7.7933967879213775
ZCTA5 30536,3399,32,3367,0.009414533686378346,-7.794137376409499
ZCTA5 48184,6724,110,6614,0.01635930993456276,-7.795510587189342
ZCTA5 85142,19760,464,19296,0.02348178137651822,-7.795774490409226
ZCTA5 56716,3493,34,3459,0.009733753220727169,-7.796258103439378
ZCTA5 64130,8496,155,8341,0.01824387947269303,-7.796688339289144
ZCTA5 76643,5164,72,5092,0.013942680092951201,-7.797375765293072
ZCTA5 03824,3308,30,3278,0.009068923821039904,-7.799638157633312
ZCTA5 22503,1758,0,1758,0,-7.800525703887541
ZCTA5 36105,3996,45,3951,0.01126126126126126,-7.8017434885253145
ZCTA5 78751,7605,132,7473,0.01735700197238659,-7.8066439944349
ZCTA5 80829,2681,17,2664,0.006340917568071615,-7.8071845006113785
ZCTA5 34479,5128,71,5057,0.013845553822152886,-7.808828030034576
ZCTA5 37055,10071,196,9875,0.01946182107040016,-7.808948071821563
ZCTA5 10962,1762,0,1762,0,-7.8093949798665845
ZCTA5 48237,12088,250,11838,0.02068166776968895,-7.809424997656295
ZCTA5 18661,2107,6,2101,0.0028476506881822496,-7.812867945796437
ZCTA5 74804,7727,135,7592,0.017471204866054097,-7.81318507213585
ZCTA5 17584,3868,42,3826,0.010858324715615306,-7.815135235001474
ZCTA5 15330,1940,3,1937,0.0015463917525773195,-7.815588000372318
ZCTA5 83814,11202,226,10976,0.02017496875557936,-7.816016710885371
ZCTA5 22642,1765,0,1765,0,-7.8160403320659615
ZCTA5 24184,1765,0,1765,0,-7.8160403320659615
ZCTA5 46409,2884,21,2863,0.007281553398058253,-7.816444261966991
ZCTA5 47713,4446,55,4391,0.012370670265407108,-7.8179378536180515
ZCTA5 32820,2836,20,2816,0.007052186177715092,-7.819052450918119
ZCTA5 76109,9737,187,9550,0.01920509397144911,-7.819245602810741
ZCTA5 44280,1767,0,1767,0,-7.820467429748646
ZCTA5 24127,1767,0,1767,0,-7.820467429748646
ZCTA5 81252,1885,2,1883,0.0010610079575596816,-7.821197124676476
ZCTA5 14469,2484,13,2471,0.005233494363929146,-7.821815564926793
ZCTA5 47660,1943,3,1940,0.001544004117344313,-7.822213931564478
ZCTA5 60193,15126,333,14793,0.022015073383577947,-7.823839561574885
ZCTA5 04938,3737,39,3698,0.010436178753010436,-7.825166985447402
ZCTA5 53704,20524,485,20039,0.02363087117520951,-7.8262733751972595
ZCTA5 28307,4840,64,4776,0.013223140495867768,-7.827183490165453
ZCTA5 30286,8748,161,8587,0.018404206675811614,-7.828080190073755
ZCTA5 45171,2277,9,2268,0.003952569169960474,-7.828731766979003
ZCTA5 29924,1771,0,1771,0,-7.829314115190079
ZCTA5 97206,20247,477,19770,0.023559045784560674,-7.8301164646767445
ZCTA5 14727,2224,8,2216,0.0035971223021582736,-7.830302768105473
ZCTA5 54165,3037,24,3013,0.007902535396773132,-7.830790048534299
ZCTA5 08867,1772,0,1772,0,-7.831524225076074
ZCTA5 08093,3557,35,3522,0.009839752600506044,-7.832200103185181
ZCTA5 35613,7621,132,7489,0.01732056160608844,-7.832542775728157
ZCTA5 67550,2116,6,2110,0.002835538752362949,-7.832634783116071
ZCTA5 07027,1773,0,1773,0,-7.833733711429831
ZCTA5 53223,12180,252,11928,0.020689655172413793,-7.8341846471139265
ZCTA5 17316,3087,25,3062,0.008098477486232589,-7.834446111447195
ZCTA5 03290,1774,0,1774,0,-7.835942574778798
ZCTA5 37419,2645,16,2629,0.0060491493383742915,-7.838038219105801
ZCTA5 02653,2845,20,2825,0.007029876977152899,-7.8380668551261445
ZCTA5 02576,1775,0,1775,0,-7.8381508156496835
ZCTA5 30132,13505,288,13217,0.02132543502406516,-7.83842467587041
ZCTA5 57005,4193,49,4144,0.011686143572621035,-7.838739240244063
ZCTA5 23805,7467,128,7339,0.017142091870898622,-7.838764705133185
ZCTA5 72774,2282,9,2273,0.003943908851884312,-7.839623171582558
ZCTA5 61705,4458,55,4403,0.012337371018393899,-7.840845512240387
ZCTA5 06249,2847,20,2827,0.007024938531787847,-7.842286772848305
ZCTA5 30058,20013,470,19543,0.023484734922300503,-7.843199307696158
ZCTA5 61755,1778,0,1778,0,-7.844771808649771
ZCTA5 11955,1778,0,1778,0,-7.844771808649771
ZCTA5 12204,3656,37,3619,0.01012035010940919,-7.8460949420989055
ZCTA5 30080,25061,615,24446,0.024540122102070946,-7.847677996329162
ZCTA5 43204,16548,372,16176,0.022480058013052938,-7.850700894167266
ZCTA5 35739,1956,3,1953,0.0015337423312883436,-7.850862180353455
ZCTA5 61739,1899,2,1897,0.00105318588730911,-7.852083231886213
ZCTA5 27817,3096,25,3071,0.008074935400516795,-7.8531429227900675
ZCTA5 14428,3048,24,3024,0.007874015748031496,-7.8537149555183525
ZCTA5 45220,6436,102,6334,0.015848353014294592,-7.854694629074242
ZCTA5 04578,2015,4,2011,0.0019851116625310174,-7.855711309875229
ZCTA5 21117,22819,550,22269,0.024102721416363555,-7.855865277344551
ZCTA5 60542,6640,107,6533,0.016114457831325302,-7.8576206573425225
ZCTA5 27023,5197,72,5125,0.01385414662305176,-7.857743594851892
ZCTA5 62049,2755,18,2737,0.006533575317604356,-7.857961168500797
ZCTA5 35206,6722,109,6613,0.016215412079738173,-7.859960643777925
ZCTA5 29697,5156,71,5085,0.013770364623739333,-7.860142410678585
ZCTA5 25545,1785,0,1785,0,-7.860199103410664
ZCTA5 46278,2954,22,2932,0.007447528774542992,-7.860569000203649
ZCTA5 46526,11718,239,11479,0.020395972008875236,-7.860963547600306
ZCTA5 63775,6724,109,6615,0.016210588935157644,-7.863329261309067
ZCTA5 39443,8150,145,8005,0.017791411042944787,-7.863437083362753
ZCTA5 24091,3245,28,3217,0.008628659476117103,-7.86448112265176
ZCTA5 59644,1787,0,1787,0,-7.864601343522468
ZCTA5 28428,2956,22,2934,0.007442489851150203,-7.864753078881671
ZCTA5 23321,12683,265,12418,0.020894110226287156,-7.866265373046944
ZCTA5 36250,1788,0,1788,0,-7.8668015397729585
ZCTA5 06259,1788,0,1788,0,-7.8668015397729585
ZCTA5 84040,7326,124,7202,0.016926016926016925,-7.8672511732048775
ZCTA5 04743,1906,2,1904,0.001049317943336831,-7.867480985326165
ZCTA5 35905,2401,11,2390,0.004581424406497293,-7.8677129240943255
ZCTA5 19565,3436,32,3404,0.009313154831199068,-7.869491693895796
ZCTA5 06340,12132,250,11882,0.020606660072535442,-7.8695698121189865
ZCTA5 62260,2910,21,2889,0.007216494845360825,-7.871115877105421
ZCTA5 30571,1791,0,1791,0,-7.873398439498068
ZCTA5 12589,4779,62,4717,0.012973425402803935,-7.873704051875369
ZCTA5 21853,3716,38,3678,0.01022604951560818,-7.874383346826591
ZCTA5 32033,1792,0,1792,0,-7.875596178114352
ZCTA5 80918,18774,434,18340,0.023117076808351976,-7.876682128289824
ZCTA5 37172,10796,214,10582,0.019822156354205263,-7.876932527468873
ZCTA5 03858,1793,0,1793,0,-7.877793303607819
ZCTA5 27616,18811,435,18376,0.023124767423316143,-7.878574193267417
ZCTA5 49643,2562,14,2548,0.00546448087431694,-7.878653777886115
ZCTA5 21104,1794,0,1794,0,-7.879989816491325
ZCTA5 80235,3627,36,3591,0.009925558312655087,-7.880153766411809
ZCTA5 07647,1795,0,1795,0,-7.882185717277017
ZCTA5 48314,8279,148,8131,0.017876555139509604,-7.882341797947427
ZCTA5 21214,7771,135,7636,0.017372281559644834,-7.883894240772184
ZCTA5 83617,6086,93,5993,0.015280972724285245,-7.884285797078302
ZCTA5 52730,2249,8,2241,0.0035571365051133837,-7.884735437360407
ZCTA5 43062,10427,204,10223,0.01956459192481059,-7.887409124587649
ZCTA5 06237,2086,5,2081,0.0023969319271332696,-7.888314916909228
ZCTA5 59801,14237,307,13930,0.021563531642902298,-7.890062777047361
ZCTA5 55807,4309,51,4258,0.011835692736133673,-7.891836675891538
ZCTA5 07830,2413,11,2402,0.0045586406962287605,-7.893573461682634
ZCTA5 06250,1803,0,1803,0,-7.899730949263791
ZCTA5 16828,1803,0,1803,0,-7.899730949263791
ZCTA5 47960,6219,96,6123,0.015436565364206465,-7.901733736491387
ZCTA5 11741,9105,169,8936,0.0185612300933553,-7.90288884243754
ZCTA5 12534,7705,133,7572,0.0172615184944841,-7.90441195332728
ZCTA5 34241,5727,84,5643,0.014667365112624411,-7.906449442211284
ZCTA5 12542,2313,9,2304,0.0038910505836575876,-7.90682973863987
ZCTA5 94027,2313,9,2304,0.0038910505836575876,-7.90682973863987
ZCTA5 12528,4969,66,4903,0.013282350573556048,-7.90759514095502
ZCTA5 55079,3220,27,3193,0.008385093167701863,-7.910989337863171
ZCTA5 48088,8957,165,8792,0.018421346432957463,-7.91201837529161
ZCTA5 24343,3827,40,3787,0.010452051215050953,-7.913374486889914
ZCTA5 52314,1810,0,1810,0,-7.915051123412141
ZCTA5 10605,7276,122,7154,0.016767454645409567,-7.915574038418293
ZCTA5 17319,4498,55,4443,0.012227656736327256,-7.916863513149203
ZCTA5 90265,7555,129,7426,0.017074784910655196,-7.917354285285541
ZCTA5 33947,4100,46,4054,0.01121951219512195,-7.917481832924846
ZCTA5 12498,2372,10,2362,0.0042158516020236085,-7.919067767063731
ZCTA5 55406,15275,335,14940,0.021931260229132568,-7.919885604594456
ZCTA5 21040,8420,151,8269,0.017933491686460808,-7.920126370809454
ZCTA5 07924,2633,15,2618,0.00569692366122294,-7.92074803120035
ZCTA5 52205,3415,31,3384,0.009077598828696925,-7.921957941888276
ZCTA5 38011,3416,31,3385,0.009074941451990632,-7.92398145812918
ZCTA5 20634,2686,16,2670,0.005956813104988831,-7.925165773039563
ZCTA5 17019,7003,115,6888,0.01642153362844495,-7.9266395258232825
ZCTA5 54755,2937,21,2916,0.007150153217568948,-7.927541124584409
ZCTA5 35754,1816,0,1816,0,-7.928159138668989
ZCTA5 66227,2323,9,2314,0.0038743004735256135,-7.928393033886186
ZCTA5 21120,2534,13,2521,0.005130228887134964,-7.929053570559878
ZCTA5 63552,2987,22,2965,0.007365249414127887,-7.929360997977132
ZCTA5 37073,5321,74,5247,0.013907160308212742,-7.929428146778659
ZCTA5 13901,8153,144,8009,0.017662210229363425,-7.929760664443013
ZCTA5 34688,2839,19,2820,0.006692497358224727,-7.929766243832029
ZCTA5 70518,5152,70,5082,0.01358695652173913,-7.930302751254626
ZCTA5 34201,1817,0,1817,0,-7.930341701446376
ZCTA5 50659,2324,9,2315,0.00387263339070568,-7.93054627783403
ZCTA5 35645,5322,74,5248,0.013904547162720781,-7.931233361046243
ZCTA5 91307,8738,159,8579,0.018196383611810484,-7.9316393099599205
ZCTA5 45383,2840,19,2821,0.006690140845070422,-7.931861078861524
ZCTA5 03784,1818,0,1818,0,-7.932523663711201
ZCTA5 08826,2162,6,2156,0.0027752081406105457,-7.9329145249724515
ZCTA5 14559,6967,114,6853,0.016362853451987944,-7.933477359697761
ZCTA5 47371,4769,61,4708,0.012790941497169217,-7.935543097674716
ZCTA5 18073,3701,37,3664,0.009997298027560119,-7.935864729719735
ZCTA5 75758,3422,31,3391,0.009059029807130333,-7.936113690710727
ZCTA5 57580,1820,0,1820,0,-7.93688578868411
ZCTA5 77656,6076,92,5984,0.015141540487162607,-7.938247237434649
ZCTA5 54669,3090,24,3066,0.007766990291262136,-7.940724939675821
ZCTA5 23704,7491,127,7364,0.01695367774662929,-7.94203935743763
ZCTA5 57049,2845,19,2826,0.006678383128295255,-7.942327885341097
ZCTA5 72704,10503,205,10298,0.01951823288584214,-7.942522994217814
ZCTA5 01830,10049,193,9856,0.019205891133446115,-7.9430883940507755
ZCTA5 10567,6812,110,6702,0.01614797416324134,-7.9433568268334165
ZCTA5 01741,1823,0,1823,0,-7.9434244846622795
ZCTA5 35586,1824,0,1824,0,-7.945602854231452
ZCTA5 34669,4990,66,4924,0.013226452905811623,-7.946245797078776
ZCTA5 13849,1825,0,1825,0,-7.947780626741643
ZCTA5 68102,3981,43,3938,0.010801306204471239,-7.948476070625222
ZCTA5 00968,1826,0,1826,0,-7.949957802683521
ZCTA5 19801,6124,93,6031,0.015186152841280208,-7.950126436675546
ZCTA5 40513,4207,48,4159,0.011409555502733539,-7.951580776867822
ZCTA5 37048,2334,9,2325,0.0038560411311053984,-7.9520480245173
ZCTA5 80807,1827,0,1827,0,-7.952134382547077
ZCTA5 47933,11299,226,11073,0.020001770068147625,-7.952166846221907
ZCTA5 93619,12342,254,12088,0.02058013287959812,-7.9537759318955565
ZCTA5 65037,2118,5,2113,0.002360717658168083,-7.957857873798331
ZCTA5 46765,1831,0,1831,0,-7.960834750994557
ZCTA5 16827,1831,0,1831,0,-7.960834750994557
ZCTA5 16933,2755,17,2738,0.006170598911070781,-7.963911506298915
ZCTA5 04239,1833,0,1833,0,-7.9651813714390824
ZCTA5 17349,2705,16,2689,0.005914972273567467,-7.965248282082841
ZCTA5 19020,21738,516,21222,0.02373723433618548,-7.967201723631779
ZCTA5 29945,2067,4,2063,0.0019351717464925011,-7.969056117870628
ZCTA5 32968,4615,57,4558,0.012351029252437704,-7.972558753889445
ZCTA5 61301,4218,48,4170,0.011379800853485065,-7.97271605369697
ZCTA5 37818,2181,6,2175,0.002751031636863824,-7.973975046240003
ZCTA5 91301,9191,170,9021,0.018496355130018495,-7.974711636025169
ZCTA5 28714,7073,116,6957,0.016400395871624486,-7.976043313039869
ZCTA5 01568,2608,14,2594,0.005368098159509203,-7.976441239619075
ZCTA5 34608,13208,277,12931,0.020972138098122352,-7.977553521288844
ZCTA5 99016,5517,78,5439,0.014138118542686243,-7.978748523034816
ZCTA5 80433,3537,33,3504,0.009329940627650551,-7.9787628115217615
ZCTA5 13732,3011,22,2989,0.0073065426768515445,-7.979067323279869
ZCTA5 45224,9348,174,9174,0.018613607188703467,-7.979491062999481
ZCTA5 32548,9502,178,9324,0.01873289833719217,-7.9802836554773595
ZCTA5 75752,2763,17,2746,0.006152732537097358,-7.980688611334439
ZCTA5 06451,10719,210,10509,0.019591379792891127,-7.981663595438212
ZCTA5 70395,1841,0,1841,0,-7.982544185222566
ZCTA5 10576,1841,0,1841,0,-7.982544185222566
ZCTA5 83703,7077,116,6961,0.01639112618341105,-7.982634978721569
ZCTA5 68352,2240,7,2233,0.003125,-7.982681800704138
ZCTA5 48746,3303,28,3275,0.008477141992128368,-7.982879518034341
ZCTA5 60115,16012,354,15658,0.02210841868598551,-7.984031385497485
ZCTA5 64145,2018,3,2015,0.0014866204162537165,-7.986089145375032
ZCTA5 03848,2404,10,2394,0.004159733777038269,-7.987607198379943
ZCTA5 74119,2297,8,2289,0.0034828036569438396,-7.988244275361296
ZCTA5 25276,3258,27,3231,0.008287292817679558,-7.988576277160043
ZCTA5 28690,3497,32,3465,0.009150700600514728,-7.992463404085309
ZCTA5 83860,2512,12,2500,0.004777070063694267,-7.992992332019144
ZCTA5 81323,1846,0,1846,0,-7.993376791896188
ZCTA5 78642,3639,35,3604,0.009618026930475405,-7.996346491172949
ZCTA5 24538,2023,3,2020,0.0014829461196243204,-7.99689563581907
ZCTA5 36606,7921,137,7784,0.017295795985355383,-7.997475956889984
ZCTA5 63401,8820,160,8660,0.018140589569160998,-7.99790855302084
ZCTA5 90720,7922,137,7785,0.01729361272405958,-7.999061421422322
ZCTA5 22473,2463,11,2452,0.004466098254161592,-8.00047678887831
ZCTA5 21133,11334,226,11108,0.019940003529204164,-8.001042289064733
ZCTA5 62812,4499,54,4445,0.012002667259390976,-8.00166696093101
ZCTA5 33525,7249,120,7129,0.01655400744930335,-8.001936821150535
ZCTA5 11940,1850,0,1850,0,-8.002032318841245
ZCTA5 10994,2621,14,2607,0.00534147272033575,-8.003876884501155
ZCTA5 17313,4501,54,4447,0.011997333925794268,-8.005435138725376
ZCTA5 29715,11599,233,11366,0.020087938615397878,-8.005435721304204
ZCTA5 30906,19490,451,19039,0.023140071831708568,-8.007623929549712
ZCTA5 44405,3364,29,3335,0.008620689655172414,-8.009955762808712
ZCTA5 98205,5025,66,4959,0.013134328358208954,-8.010381411380097
ZCTA5 06477,4939,64,4875,0.012958088681919416,-8.010417966224058
ZCTA5 51601,2468,11,2457,0.004457050243111832,-8.011093039833213
ZCTA5 18947,2255,7,2248,0.0031042128603104213,-8.014854413397071
ZCTA5 01129,2830,18,2812,0.0063604240282685515,-8.015427524607764
ZCTA5 48219,19214,443,18771,0.023056104923493286,-8.015449566467176
ZCTA5 19343,2678,15,2663,0.005601194921583271,-8.015696434025385
ZCTA5 15666,6775,108,6667,0.015940959409594096,-8.01651362001676
ZCTA5 62522,6245,95,6150,0.01521216973578863,-8.016849219215716
ZCTA5 52031,2090,4,2086,0.0019138755980861245,-8.018684491192754
ZCTA5 77566,11272,224,11048,0.0198722498225692,-8.019131743426914
ZCTA5 16053,1860,0,1860,0,-8.023630286109137
ZCTA5 65066,2474,11,2463,0.00444624090541633,-8.023815023279866
ZCTA5 02724,7820,134,7686,0.017135549872122763,-8.025129854821303
ZCTA5 60936,1861,0,1861,0,-8.025786886144349
ZCTA5 08051,4201,47,4154,0.01118781242561295,-8.025834775812115
ZCTA5 05255,1862,0,1862,0,-8.027942906837678
ZCTA5 48519,3035,22,3013,0.007248764415156508,-8.02850525160889
ZCTA5 42345,4068,44,4024,0.010816125860373648,-8.029602457918536
ZCTA5 02738,1863,0,1863,0,-8.030098348655773
ZCTA5 60401,3037,22,3015,0.007243990780375371,-8.032613090142448
ZCTA5 32771,19336,446,18890,0.023065784029788993,-8.033371669421335
ZCTA5 28478,1865,0,1865,0,-8.03440749752972
ZCTA5 42122,1865,0,1865,0,-8.03440749752972
ZCTA5 50644,3565,33,3532,0.009256661991584854,-8.034613327860544
ZCTA5 32601,7628,129,7499,0.01691137912952281,-8.034879208174807
ZCTA5 56013,1983,2,1981,0.0010085728693898135,-8.034915945147505
ZCTA5 28305,2789,17,2772,0.006095374686267479,-8.034995433595714
ZCTA5 02446,13216,276,12940,0.020883777239709442,-8.03645932871127
ZCTA5 32210,23548,566,22982,0.02403601155087481,-8.0372932170512
ZCTA5 54154,2374,9,2365,0.0037910699241786015,-8.03750402351268
ZCTA5 52245,9156,168,8988,0.01834862385321101,-8.038124946134422
ZCTA5 45338,2043,3,2040,0.0014684287812041115,-8.039977387122887
ZCTA5 19968,4782,60,4722,0.012547051442910916,-8.040142822584892
ZCTA5 68410,3568,33,3535,0.009248878923766817,-8.040578631573311
ZCTA5 10506,1868,0,1868,0,-8.040866890906614
ZCTA5 19085,1868,0,1868,0,-8.040866890906614
ZCTA5 45144,1869,0,1869,0,-8.043018869237905
ZCTA5 94705,5805,84,5721,0.014470284237726097,-8.043613353752136
ZCTA5 18222,3570,33,3537,0.009243697478991597,-8.044553504198353
ZCTA5 60012,3849,39,3810,0.010132501948558068,-8.046336483620745
ZCTA5 71822,3757,37,3720,0.009848283204684588,-8.046472378283893
ZCTA5 49442,15087,327,14760,0.0216742891230861,-8.046525957772841
ZCTA5 61231,2270,7,2263,0.0030837004405286344,-8.046902091915326
ZCTA5 98443,2215,6,2209,0.002708803611738149,-8.046940799612297
ZCTA5 24293,3667,35,3632,0.009544586855740387,-8.051782742474765
ZCTA5 48462,4832,61,4771,0.012624172185430464,-8.052254428435917
ZCTA5 44307,3145,24,3121,0.007631160572337043,-8.0534443221574
ZCTA5 18642,1874,0,1874,0,-8.053770135725937
ZCTA5 07043,4171,46,4125,0.011028530328458403,-8.054333695133552
ZCTA5 59802,9283,171,9112,0.018420769147904772,-8.055024256121518
ZCTA5 03906,1875,0,1875,0,-8.055918667212932
ZCTA5 12540,2698,15,2683,0.005559673832468495,-8.057566100529897
ZCTA5 48227,15386,335,15051,0.021773040426361627,-8.057750261861079
ZCTA5 07901,8274,145,8129,0.01752477640802514,-8.057908140430309
ZCTA5 35058,3577,33,3544,0.009225608051439753,-8.058453007822084
ZCTA5 61071,5689,81,5608,0.014238003164000703,-8.060271453346509
ZCTA5 18078,2953,20,2933,0.006772773450728073,-8.063149643537576
ZCTA5 31092,2701,15,2686,0.0055534987041836355,-8.063829325344825
ZCTA5 44114,3858,39,3819,0.01010886469673406,-8.063902962158677
ZCTA5 02191,3580,33,3547,0.009217877094972068,-8.064403974536662
ZCTA5 19713,11829,238,11591,0.02012004395975991,-8.064998735288007
ZCTA5 77336,4400,51,4349,0.011590909090909091,-8.065030224974002
ZCTA5 89141,10740,209,10531,0.019459962756052142,-8.065216905053727
ZCTA5 70438,7168,117,7051,0.016322544642857144,-8.066083725841667
ZCTA5 17602,18940,434,18506,0.022914466737064414,-8.06649349943577
ZCTA5 45065,1880,0,1880,0,-8.066652740817828
ZCTA5 92586,9137,167,8970,0.018277333917040603,-8.067676473392043
ZCTA5 50156,1881,0,1881,0,-8.068797841970175
ZCTA5 20748,14596,313,14283,0.021444231296245547,-8.0690746801871
ZCTA5 46777,2336,8,2328,0.003424657534246575,-8.071402323920818
ZCTA5 01507,4886,62,4824,0.012689316414244782,-8.071800350730813
ZCTA5 44438,1883,0,1883,0,-8.07308633434947
ZCTA5 37058,2958,20,2938,0.0067613252197430695,-8.07343557854909
ZCTA5 98034,17558,395,17163,0.022496867524775033,-8.07434803460985
ZCTA5 21842,5189,69,5120,0.013297359799576027,-8.07473909759509
ZCTA5 14006,4272,48,4224,0.011235955056179775,-8.075873066913987
ZCTA5 20637,1885,0,1885,0,-8.077372549854179
ZCTA5 41139,3254,26,3228,0.007990165949600492,-8.077927846159769
ZCTA5 28906,8405,148,8257,0.017608566329565735,-8.078727701139762
ZCTA5 15144,1886,0,1886,0,-8.079514804911033
ZCTA5 34434,2961,20,2941,0.006754474839581222,-8.079601564430662
ZCTA5 64158,1887,0,1887,0,-8.08165649210701
ZCTA5 27605,3159,24,3135,0.007597340930674264,-8.081920191658297
ZCTA5 08083,3729,36,3693,0.009654062751407884,-8.082388108804164
ZCTA5 60585,7098,115,6983,0.01620174697097774,-8.083198441304194
ZCTA5 40023,1888,0,1888,0,-8.083797611893447
ZCTA5 36854,6078,90,5988,0.014807502467917079,-8.084377240930664
ZCTA5 43822,1891,0,1891,0,-8.090217571299958
ZCTA5 06417,1892,0,1892,0,-8.0923564259497
ZCTA5 17236,3359,28,3331,0.008335814230425722,-8.095817854953726
ZCTA5 78130,26343,645,25698,0.024484682837945564,-8.095938826193134
ZCTA5 19054,6085,90,5995,0.014790468364831553,-8.096420728386406
ZCTA5 74104,5330,72,5258,0.01350844277673546,-8.098010861568458
ZCTA5 40071,5627,79,5548,0.014039452639061667,-8.099056942169799
ZCTA5 33446,12932,267,12665,0.020646458397772967,-8.099724098996505
ZCTA5 22551,6417,98,6319,0.015271933925510362,-8.09987570489774
ZCTA5 44703,3738,36,3702,0.009630818619582664,-8.100038791500019
ZCTA5 95650,5161,68,5093,0.013175741135438868,-8.101512004925398
ZCTA5 27403,7713,130,7583,0.016854660962012186,-8.107223245592454
ZCTA5 30288,3317,27,3290,0.008139885438649382,-8.107797666669654
ZCTA5 14414,3025,21,3004,0.006942148760330578,-8.10904995103875
ZCTA5 30296,9049,164,8885,0.01812354956348768,-8.110085272768524
ZCTA5 53718,5969,87,5882,0.014575305746356173,-8.111321695428044
ZCTA5 62951,1901,0,1901,0,-8.11158073912592
ZCTA5 37127,6465,99,6366,0.01531322505800464,-8.111650247846441
ZCTA5 47040,2190,5,2185,0.00228310502283105,-8.112186951093491
ZCTA5 14070,2190,5,2185,0.00228310502283105,-8.112186951093491
ZCTA5 33705,10546,203,10343,0.019249004361843354,-8.112519597350547
ZCTA5 61201,15433,335,15098,0.021706732326832113,-8.115857415279542
ZCTA5 37080,2979,20,2959,0.00671366230278617,-8.116510151991198
ZCTA5 25312,6304,95,6209,0.015069796954314721,-8.117493470169013
ZCTA5 30035,8313,145,8168,0.0174425598460243,-8.118563601414145
ZCTA5 81201,4115,44,4071,0.010692588092345079,-8.119925094006566
ZCTA5 30824,6634,103,6531,0.015526077781127525,-8.120576847471256
ZCTA5 73055,3795,37,3758,0.009749670619235836,-8.120846078936333
ZCTA5 87106,11082,217,10865,0.01958130301389641,-8.121587479683308
ZCTA5 35747,2139,4,2135,0.0018700327255726976,-8.12341516279558
ZCTA5 55441,7843,133,7710,0.016957796761443326,-8.12446585930015
ZCTA5 55386,2522,11,2511,0.0043616177636796195,-8.124912558656344
ZCTA5 28461,8631,153,8478,0.017726798748696558,-8.125536311074736
ZCTA5 52742,2934,19,2915,0.006475800954328562,-8.126624079232846
ZCTA5 01230,3565,32,3533,0.008976157082748949,-8.127752715914399
ZCTA5 58103,23775,570,23205,0.023974763406940065,-8.128458580111387
ZCTA5 38134,15190,328,14862,0.021593153390388413,-8.129556500463327
ZCTA5 06360,15009,323,14686,0.021520421080684922,-8.13052912904025
ZCTA5 17233,2255,6,2249,0.0026607538802660754,-8.131963305981913
ZCTA5 20607,3847,38,3809,0.009877826878086821,-8.13208942266775
ZCTA5 98360,4745,58,4687,0.012223393045310853,-8.132962440026745
ZCTA5 34431,3473,30,3443,0.008638065073423552,-8.132995731637456
ZCTA5 19076,2683,14,2669,0.005218039508013418,-8.133545198594756
ZCTA5 07069,1912,0,1912,0,-8.135015426991234
ZCTA5 35550,2367,8,2359,0.0033798056611744824,-8.136916865754907
ZCTA5 85085,8482,149,8333,0.01756661164819618,-8.137136645659748
ZCTA5 29847,1913,0,1913,0,-8.13714250649601
ZCTA5 02648,2788,16,2772,0.005738880918220947,-8.138234284962879
ZCTA5 00736,17219,384,16835,0.022300946628724085,-8.138991600254217
ZCTA5 85739,8601,152,8449,0.017672363678642018,-8.139477257766066
ZCTA5 23803,15162,327,14835,0.021567075583696083,-8.139917528309454
ZCTA5 16915,2260,6,2254,0.002654867256637168,-8.14253005971118
ZCTA5 36049,2206,5,2201,0.0022665457842248413,-8.1460917830364
ZCTA5 41143,5229,69,5160,0.013195639701663799,-8.146707142285194
ZCTA5 43205,5400,73,5327,0.013518518518518518,-8.14689630330218
ZCTA5 50511,3240,25,3215,0.007716049382716049,-8.147302155949136
ZCTA5 21787,3856,38,3818,0.009854771784232365,-8.149557884494488
ZCTA5 44437,1919,0,1919,0,-8.149893325244015
ZCTA5 52240,14879,319,14560,0.02143961287720949,-8.150057149653453
ZCTA5 43227,9463,174,9289,0.01838740357180598,-8.150793872599913
ZCTA5 77619,5992,87,5905,0.01451935914552737,-8.151017786802456
ZCTA5 14103,4579,54,4525,0.011792967896920725,-8.151407683340672
ZCTA5 60461,1922,0,1922,0,-8.15626125953389
ZCTA5 11559,2694,14,2680,0.005196733481811433,-8.156351305042348
ZCTA5 03885,2797,16,2781,0.00572041473006793,-8.156790387207025
ZCTA5 30814,2485,10,2475,0.004024144869215292,-8.15864709061397
ZCTA5 48438,2485,10,2475,0.004024144869215292,-8.15864709061397
ZCTA5 98532,9159,166,8993,0.018124249372202205,-8.158857182784692
ZCTA5 54944,3343,27,3316,0.00807657792402034,-8.159867480994787
ZCTA5 36350,2696,14,2682,0.0051928783382789315,-8.160491517697048
ZCTA5 08886,2487,10,2477,0.004020908725371934,-8.162827076494766
ZCTA5 62832,3909,39,3870,0.009976976208749041,-8.162884193435152
ZCTA5 95222,2380,8,2372,0.0033613445378151263,-8.16423951640066
ZCTA5 70578,6000,87,5913,0.0145,-8.164796449610575
ZCTA5 43724,2801,16,2785,0.005712245626561942,-8.165025161541042
ZCTA5 65807,24993,604,24389,0.024166766694674508,-8.16526638231864
ZCTA5 08402,3053,21,3032,0.006878480183426138,-8.166056724368762
ZCTA5 45304,2702,14,2688,0.0051813471502590676,-8.172900478637558
ZCTA5 06612,2805,16,2789,0.00570409982174688,-8.173252344385086
ZCTA5 98042,16457,362,16095,0.021996718721516678,-8.173903549078577
ZCTA5 50595,3916,39,3877,0.009959141981613892,-8.176396109162301
ZCTA5 39119,1932,0,1932,0,-8.177451893478883
ZCTA5 72923,1932,0,1932,0,-8.177451893478883
ZCTA5 06016,2653,13,2640,0.004900113079532605,-8.179011147262218
ZCTA5 53050,2705,14,2691,0.005175600739371534,-8.179098406977284
ZCTA5 46814,4192,45,4147,0.010734732824427481,-8.180368535315369
ZCTA5 37754,1934,0,1934,0,-8.18168343419855
ZCTA5 19128,16068,351,15717,0.021844660194174758,-8.183911228695353
ZCTA5 19147,17079,379,16700,0.02219099478892207,-8.18574603341908
ZCTA5 59047,5888,84,5804,0.014266304347826086,-8.187956240695158
ZCTA5 21216,10831,209,10622,0.019296463853753117,-8.193939505798017
ZCTA5 23842,2395,8,2387,0.003340292275574113,-8.195656224924571
ZCTA5 15223,3118,22,3096,0.007055805003207184,-8.19746436633685
ZCTA5 48128,3928,39,3889,0.009928716904276986,-8.199518467019054
ZCTA5 37687,1943,0,1943,0,-8.200698347103627
ZCTA5 64633,1943,0,1943,0,-8.200698347103627
ZCTA5 17078,9071,163,8908,0.01796935288281336,-8.201608541288739
ZCTA5 30415,2398,8,2390,0.003336113427856547,-8.201925602664975
ZCTA5 24382,5938,85,5853,0.01431458403502863,-8.20195879565543
ZCTA5 41001,6147,90,6057,0.014641288433382138,-8.202607053547831
ZCTA5 51351,1944,0,1944,0,-8.202808394313925
ZCTA5 18328,2665,13,2652,0.004878048780487805,-8.203822200176145
ZCTA5 37085,1945,0,1945,0,-8.204917898886363
ZCTA5 32763,8996,161,8835,0.017896843041351713,-8.205878171349829
ZCTA5 21201,9269,168,9101,0.018124932570935375,-8.207339288553202
ZCTA5 91377,5306,70,5236,0.013192612137203167,-8.207696805900987
ZCTA5 47720,6932,109,6823,0.015724177726485863,-8.209239276949186
ZCTA5 45014,17208,382,16826,0.022198977219897723,-8.210778678287843
ZCTA5 48415,3795,36,3759,0.009486166007905139,-8.211118950430661
ZCTA5 06480,3842,37,3805,0.009630400832899531,-8.212090873547577
ZCTA5 93401,12088,242,11846,0.0200198544010589,-8.214071609755827
ZCTA5 35207,3514,30,3484,0.008537279453614115,-8.214086148814225
ZCTA5 33880,13648,284,13364,0.020808909730363423,-8.215389376201331
ZCTA5 48144,3892,38,3854,0.009763617677286743,-8.219136701857634
ZCTA5 53083,8062,137,7925,0.01699330191019598,-8.219385926405769
ZCTA5 14305,6979,110,6869,0.0157615704255624,-8.21965033075822
ZCTA5 76065,11755,233,11522,0.019821352615908124,-8.219825711583416
ZCTA5 73134,2879,17,2862,0.005904828065300452,-8.220466428201924
ZCTA5 48888,2407,8,2399,0.0033236393851267137,-8.220705989047742
ZCTA5 52361,1953,0,1953,0,-8.221774450602265
ZCTA5 75771,7143,114,7029,0.015959680806383873,-8.222553513901797
ZCTA5 14057,3278,25,3253,0.00762660158633313,-8.223420094454848
ZCTA5 18032,3848,37,3811,0.009615384615384616,-8.22368086501033
ZCTA5 62230,2570,11,2559,0.004280155642023347,-8.22483288492145
ZCTA5 60020,4351,48,4303,0.011031946678924385,-8.225037745170196
ZCTA5 64117,5784,81,5703,0.014004149377593362,-8.226197410044755
ZCTA5 46240,9437,172,9265,0.018226131185758186,-8.226713309556654
ZCTA5 61088,2356,7,2349,0.0029711375212224107,-8.228299473234026
ZCTA5 15062,3474,29,3445,0.008347725964306276,-8.229332926241383
ZCTA5 02857,3378,27,3351,0.007992895204262877,-8.229519289559537
ZCTA5 30312,11424,224,11200,0.0196078431372549,-8.230179607307795
ZCTA5 27011,2302,6,2296,0.0026064291920069507,-8.230766613139968
ZCTA5 13421,5319,70,5249,0.01316036849031773,-8.230822742261125
ZCTA5 24228,2520,10,2510,0.003968253968253968,-8.23150432820746
ZCTA5 29511,1958,0,1958,0,-8.232292267939119
ZCTA5 64601,4579,53,4526,0.011574579602533304,-8.233589895162755
ZCTA5 75426,1959,0,1959,0,-8.234394219273753
ZCTA5 25510,1959,0,1959,0,-8.234394219273753
ZCTA5 67110,3333,26,3307,0.007800780078007801,-8.23620048805595
ZCTA5 62033,1960,0,1960,0,-8.236495634191023
ZCTA5 38301,13147,270,12877,0.020537004639841788,-8.236569473070091
ZCTA5 89084,9330,169,9161,0.018113612004287245,-8.240382525642644
ZCTA5 37909,7195,115,7080,0.015983321751216122,-8.241276977864327
ZCTA5 44889,2736,14,2722,0.005116959064327485,-8.242890163708127
ZCTA5 17225,7156,114,7042,0.01593068753493572,-8.243671895076952
ZCTA5 28320,4089,42,4047,0.010271460014673514,-8.243988766783863
ZCTA5 04426,1964,0,1964,0,-8.244895937888057
ZCTA5 30107,5068,64,5004,0.012628255722178374,-8.244933963781346
ZCTA5 20732,3482,29,3453,0.00832854681217691,-8.245096530666345
ZCTA5 08722,3766,35,3731,0.00929368029739777,-8.245375986828273
ZCTA5 12561,6340,94,6246,0.014826498422712935,-8.248371226424302
ZCTA5 11738,5243,68,5175,0.01296967385084875,-8.248596217628007
ZCTA5 13031,6216,91,6125,0.01463963963963964,-8.249238575458941
ZCTA5 80018,3954,39,3915,0.009863429438543247,-8.249440891239733
ZCTA5 14432,2311,6,2305,0.0025962786672436176,-8.249554236498291
ZCTA5 30635,5882,83,5799,0.014110846650799048,-8.250087043382262
ZCTA5 06524,1967,0,1967,0,-8.251190553339521
ZCTA5 47012,4047,41,4006,0.01013096120583148,-8.251245848539227
ZCTA5 60481,4678,55,4623,0.01175716117999145,-8.252674381561981
ZCTA5 55439,3486,29,3457,0.00831899024670109,-8.252968835540399
ZCTA5 19034,1968,0,1968,0,-8.253287691651016
ZCTA5 06382,4049,41,4008,0.010125957026426277,-8.255055253226077
ZCTA5 48030,7244,116,7128,0.01601325234676974,-8.255125414910106
ZCTA5 17113,3958,39,3919,0.009853461344113188,-8.257100034756059
ZCTA5 34432,5505,74,5431,0.013442325158946413,-8.257159200370166
ZCTA5 29420,8324,143,8181,0.017179240749639595,-8.257534746850132
ZCTA5 07716,3537,30,3507,0.008481764206955046,-8.259284776340657
ZCTA5 27249,4902,60,4842,0.012239902080783354,-8.259989106321234
ZCTA5 17560,1972,0,1972,0,-8.261670921533572
ZCTA5 25550,3492,29,3463,0.008304696449026346,-8.264765460528746
ZCTA5 17963,3540,30,3510,0.00847457627118644,-8.265165011995334
ZCTA5 36079,3299,25,3274,0.007578053955744165,-8.265225881724136
ZCTA5 30180,12872,262,12610,0.020354257302672468,-8.265272849608454
ZCTA5 63137,7129,113,7016,0.015850750455884417,-8.265639349458226
ZCTA5 01373,1974,0,1974,0,-8.265859348125334
ZCTA5 02468,1974,0,1974,0,-8.265859348125334
ZCTA5 10980,4774,57,4717,0.01193967322999581,-8.266794630011471
ZCTA5 14445,3397,27,3370,0.00794818957904033,-8.267120994113588
ZCTA5 80537,18153,407,17746,0.022420536550432437,-8.26721108518674
ZCTA5 32060,8093,137,7956,0.016928209563820587,-8.267738111857536
ZCTA5 37074,2749,14,2735,0.005092761004001455,-8.269505399836289
ZCTA5 23510,3779,35,3744,0.009261709446943637,-8.270524629707214
ZCTA5 15522,4864,59,4805,0.012129934210526315,-8.270562016415909
ZCTA5 44612,2152,3,2149,0.0013940520446096654,-8.270856228154516
ZCTA5 01057,3448,28,3420,0.008120649651972157,-8.272631508193667
ZCTA5 33154,6272,92,6180,0.014668367346938776,-8.273661760037399
ZCTA5 06851,10469,198,10271,0.018912981182538924,-8.27404790286613
ZCTA5 49120,14942,318,14624,0.021282291527238657,-8.274236921750088
ZCTA5 46052,9353,169,9184,0.018069068747995295,-8.274489575656867
ZCTA5 99202,7298,117,7181,0.01603178953137846,-8.27703036441217
ZCTA5 02537,2489,9,2480,0.0036159100040176776,-8.27847314725067
ZCTA5 37938,6441,96,6345,0.014904517931998137,-8.278991233690128
ZCTA5 62626,2908,17,2891,0.005845942228335626,-8.279424037560922
ZCTA5 98375,9860,182,9678,0.01845841784989858,-8.280797350990037
ZCTA5 03032,1982,0,1982,0,-8.282591874051345
ZCTA5 12018,2961,18,2943,0.0060790273556231,-8.283998292413667
ZCTA5 71112,13812,287,13525,0.020779032725166523,-8.284128416985807
ZCTA5 06355,5436,72,5364,0.013245033112582781,-8.28614143987721
ZCTA5 53916,9478,172,9306,0.01814728845748048,-8.287250607056349
ZCTA5 38570,3974,39,3935,0.009813789632611978,-8.287680427922112
ZCTA5 01036,1985,0,1985,0,-8.28885786300005
ZCTA5 35750,4918,60,4858,0.012200081333875559,-8.288988152782448
ZCTA5 18066,2330,6,2324,0.002575107296137339,-8.289080039553467
ZCTA5 32836,7145,113,7032,0.01581525542337299,-8.291594877812711
ZCTA5 71303,8740,153,8587,0.017505720823798625,-8.291621770822195
ZCTA5 92886,16559,362,16197,0.02186122350383477,-8.296157807779025
ZCTA5 06512,11510,225,11285,0.01954821894005213,-8.29667320073758
ZCTA5 24501,10179,190,9989,0.018665880734846253,-8.297284312798848
ZCTA5 92807,12337,247,12090,0.020021074815595362,-8.2974871247114
ZCTA5 01069,3557,30,3527,0.00843407365757661,-8.298420445631747
ZCTA5 49712,3462,28,3434,0.008087810514153668,-8.300154577226753
ZCTA5 44730,2391,7,2384,0.0029276453366792136,-8.3010193933248555
ZCTA5 89441,4437,49,4388,0.01104349785891368,-8.301647362795801
ZCTA5 14810,5144,65,5079,0.012636080870917573,-8.30340356525819
ZCTA5 59230,1992,0,1992,0,-8.303460115427146
ZCTA5 47586,4528,51,4477,0.011263250883392226,-8.304112034733118
ZCTA5 62274,2502,9,2493,0.0035971223021582736,-8.305290279106762
ZCTA5 27563,1994,0,1994,0,-8.3076274733384
ZCTA5 60130,7115,112,7003,0.015741391426563597,-8.308817857701829
ZCTA5 01527,5234,67,5167,0.012800917080626672,-8.309409046413094
ZCTA5 10579,3175,22,3153,0.006929133858267717,-8.311746623297438
ZCTA5 35111,6044,86,5958,0.014228987425545996,-8.31184891615798
ZCTA5 92067,2873,16,2857,0.005569091541942221,-8.311971910700755
ZCTA5 74063,12386,248,12138,0.02002260616825448,-8.313000970513203
ZCTA5 61520,6379,94,6285,0.014735852014422323,-8.313963436319492
ZCTA5 61530,2560,10,2550,0.00390625,-8.31402279232776
ZCTA5 48204,9535,173,9362,0.01814368117461982,-8.31409157472092
ZCTA5 41311,2719,13,2706,0.004781169547627804,-8.314614044410511
ZCTA5 46574,3566,30,3536,0.008412787436904094,-8.315981145347287
ZCTA5 39272,4801,57,4744,0.011872526556967298,-8.316012055268212
ZCTA5 65401,12762,258,12504,0.020216267042783263,-8.316571273224023
ZCTA5 94070,11638,228,11410,0.01959099501632583,-8.317015571453268
ZCTA5 18229,3567,30,3537,0.008410428931875526,-8.317930415482087
ZCTA5 42653,1999,0,1999,0,-8.31803673374679
ZCTA5 18431,4805,57,4748,0.01186264308012487,-8.323285570063552
ZCTA5 26525,2002,0,2002,0,-8.324276042087828
ZCTA5 24482,2002,0,2002,0,-8.324276042087828
ZCTA5 23225,17988,401,17587,0.022292639537469423,-8.324945962575997
ZCTA5 52040,2403,7,2396,0.002913025384935497,-8.325809514821666
ZCTA5 44811,5026,62,4964,0.012335853561480302,-8.325979061199474
ZCTA5 86324,2292,5,2287,0.002181500872600349,-8.326001903609074
ZCTA5 44050,2348,6,2342,0.002555366269165247,-8.326355982071146
ZCTA5 06424,4939,60,4879,0.012148208139299453,-8.32693976529401
ZCTA5 46410,15424,330,15094,0.021395228215767635,-8.328632741556333
ZCTA5 49007,4226,44,4182,0.010411736867013724,-8.330244050964026
ZCTA5 48125,7734,127,7607,0.01642099818981122,-8.330341037788608
ZCTA5 40342,8490,146,8344,0.017196702002355714,-8.330518246118494
ZCTA5 29609,11874,234,11640,0.019706922688226377,-8.330669823564678
ZCTA5 39355,2675,12,2663,0.004485981308411215,-8.3319675683559
ZCTA5 79119,6349,93,6256,0.014647976059221924,-8.333329492718212
ZCTA5 01430,2008,0,2008,0,-8.336740650080833
ZCTA5 95667,14222,297,13925,0.020883138799043736,-8.337140685839353
ZCTA5 44273,2886,16,2870,0.005544005544005544,-8.338250552468601
ZCTA5 07677,2009,0,2009,0,-8.338816273329746
ZCTA5 42211,5595,75,5520,0.013404825737265416,-8.339981449600065
ZCTA5 07676,3240,23,3217,0.0070987654320987656,-8.342700391561424
ZCTA5 08230,2012,0,2012,0,-8.345040045515981
ZCTA5 19013,12300,245,12055,0.01991869918699187,-8.348176370489524
ZCTA5 98014,2736,13,2723,0.004751461988304093,-8.349207748145714
ZCTA5 69101,12414,248,12166,0.019977444820364103,-8.35037438250013
ZCTA5 97423,2790,14,2776,0.005017921146953405,-8.352928559703344
ZCTA5 54136,2686,12,2674,0.004467609828741623,-8.35437607207598
ZCTA5 33606,8030,134,7896,0.016687422166874223,-8.355487772917511
ZCTA5 90292,12381,247,12134,0.019949923269525886,-8.356298113520442
ZCTA5 92663,10029,185,9844,0.018446505135108187,-8.358096521162622
ZCTA5 62863,4242,44,4198,0.010372465818010372,-8.360222638759609
ZCTA5 22031,12760,257,12503,0.020141065830721002,-8.36315995467011
ZCTA5 45133,9258,165,9093,0.01782242384964355,-8.364335297660684
ZCTA5 26143,2022,0,2022,0,-8.3657525123358365
ZCTA5 55944,2797,14,2783,0.0050053628888094386,-8.367094085371699
ZCTA5 79602,8197,138,8059,0.016835427595461753,-8.367406048595779
ZCTA5 24224,2533,9,2524,0.0035530990919857876,-8.368904992596033
ZCTA5 94904,5355,69,5286,0.01288515406162465,-8.370628639279088
ZCTA5 50662,2954,17,2937,0.005754908598510494,-8.37216590245717
ZCTA5 64128,4788,56,4732,0.011695906432748537,-8.37270973306141
ZCTA5 28150,10733,203,10530,0.018913630858101185,-8.377348678482946
ZCTA5 28539,5915,82,5833,0.013863060016906171,-8.379176210605504
ZCTA5 77024,15173,322,14851,0.021221907335398405,-8.379314511121155
ZCTA5 45690,5831,80,5751,0.013719773623735209,-8.3803134185294
ZCTA5 18519,2030,0,2030,0,-8.382285636195164
ZCTA5 24970,2030,0,2030,0,-8.382285636195164
ZCTA5 85054,3649,31,3618,0.008495478213209099,-8.38442487412506
ZCTA5 61108,11234,216,11018,0.019227345558127114,-8.385727618672252
ZCTA5 30153,6505,96,6409,0.014757878554957724,-8.385792470077174
ZCTA5 31021,10126,187,9939,0.01846731187043255,-8.386775241276164
ZCTA5 28697,5793,79,5714,0.013637148282409806,-8.387934604120119
ZCTA5 28164,5878,81,5797,0.013780197346036067,-8.388257487901381
ZCTA5 08098,3362,25,3337,0.0074360499702558,-8.389561060681434
ZCTA5 28673,2489,8,2481,0.0032141422257934912,-8.389941273031697
ZCTA5 97215,7772,127,7645,0.01634071024189398,-8.39014323196189
ZCTA5 19044,6675,100,6575,0.0149812734082397,-8.393162797665351
ZCTA5 37411,7208,113,7095,0.01567702552719201,-8.39333344270774
ZCTA5 52641,4668,53,4615,0.011353898886032563,-8.397069190503693
ZCTA5 60525,11508,223,11285,0.01937782412234967,-8.397605172236148
ZCTA5 24523,8137,136,8001,0.01671377657613371,-8.397751597634924
ZCTA5 63670,4579,51,4528,0.011137803013758463,-8.397954318806919
ZCTA5 32735,2038,0,2038,0,-8.398786214440404
ZCTA5 21797,2866,15,2851,0.0052337752965806,-8.401668565152027
ZCTA5 31730,3417,26,3391,0.007609013754755633,-8.401679919163804
ZCTA5 95472,12565,251,12314,0.019976124154397135,-8.401829806792673
ZCTA5 05001,4493,49,4444,0.010905853549966614,-8.405179762003456
ZCTA5 55303,17986,399,17587,0.02218392082731013,-8.405567063545496
ZCTA5 64109,4628,52,4576,0.011235955056179775,-8.405635189699563
ZCTA5 49802,2764,13,2751,0.004703328509406657,-8.405894317839122
ZCTA5 95326,3371,25,3346,0.007416196974191634,-8.407193046425505
ZCTA5 47060,2218,3,2215,0.001352569882777277,-8.407592851251582
ZCTA5 02302,10756,203,10553,0.018873187058386018,-8.409645896407644
ZCTA5 33602,7865,129,7736,0.016401780038143673,-8.410073424433863
ZCTA5 38843,4360,46,4314,0.01055045871559633,-8.410343949193852
ZCTA5 82201,2922,16,2906,0.0054757015742642025,-8.41062794515026
ZCTA5 37064,20633,473,20160,0.02292444142877914,-8.411332200960251
ZCTA5 67701,2767,13,2754,0.0046982291290206,-8.41194660271331
ZCTA5 65757,2767,13,2754,0.0046982291290206,-8.41194660271331
ZCTA5 49221,14651,307,14344,0.020954201078424682,-8.414115546300698
ZCTA5 97214,12614,252,12362,0.01997780244173141,-8.417148035821391
ZCTA5 42567,2448,7,2441,0.0028594771241830064,-8.418138724704987
ZCTA5 28715,10149,187,9962,0.018425460636515914,-8.419741389051046
ZCTA5 10536,3572,29,3543,0.008118701007838746,-8.420719106850157
ZCTA5 14131,2049,0,2049,0,-8.421421719988908
ZCTA5 59301,4771,55,4716,0.011527981555229511,-8.422336125728119
ZCTA5 06870,2505,8,2497,0.0031936127744510976,-8.422578593453583
ZCTA5 07751,6025,84,5941,0.013941908713692946,-8.422694370894254
ZCTA5 49053,2720,12,2708,0.004411764705882353,-8.423282527661351
ZCTA5 62286,2667,11,2656,0.004124484439445069,-8.423318785017852
ZCTA5 14551,2050,0,2050,0,-8.423476477057426
ZCTA5 14586,4322,45,4277,0.010411846367422489,-8.424289757587665
ZCTA5 20619,5213,65,5148,0.012468827930174564,-8.426063054058385
ZCTA5 08816,16487,357,16130,0.021653423909747074,-8.42648307001984
ZCTA5 53118,2829,14,2815,0.00494874513962531,-8.431568027312943
ZCTA5 14706,2618,10,2608,0.0038197097020626434,-8.43230202573062
ZCTA5 06073,2055,0,2055,0,-8.4337427532344
ZCTA5 19074,2055,0,2055,0,-8.4337427532344
ZCTA5 77630,11536,223,11313,0.019330790568654645,-8.435908059142953
ZCTA5 44509,5175,64,5111,0.012367149758454106,-8.435972853568298
ZCTA5 80118,2512,8,2504,0.0031847133757961785,-8.436818925582026
ZCTA5 15901,2059,0,2059,0,-8.441946785089858
ZCTA5 46131,11844,231,11613,0.01950354609929078,-8.443226647502826
ZCTA5 33991,7484,119,7365,0.015900587920897914,-8.444963060967114
ZCTA5 03106,5181,64,5117,0.012352827639451842,-8.44659479361003
ZCTA5 64052,8961,156,8805,0.017408771342484097,-8.446835676983039
ZCTA5 25702,3144,20,3124,0.006361323155216285,-8.448124976119109
ZCTA5 97759,3094,19,3075,0.006140917905623788,-8.44885733605584
ZCTA5 35223,4152,41,4111,0.0098747591522158,-8.449407014091781
ZCTA5 14514,2680,11,2669,0.004104477611940298,-8.449582920408808
ZCTA5 16652,5659,75,5584,0.013253224951404841,-8.45096664239057
ZCTA5 29730,21874,507,21367,0.023178202432111182,-8.451880144287175
ZCTA5 28716,7287,114,7173,0.015644298065047343,-8.454740134568118
ZCTA5 14787,2066,0,2066,0,-8.456284688783873
ZCTA5 17512,7288,114,7174,0.015642151481888036,-8.456339335438935
ZCTA5 39730,4248,43,4205,0.01012241054613936,-8.456767068676019
ZCTA5 48105,14722,308,14414,0.02092107050672463,-8.4568337095056485
ZCTA5 59405,13392,272,13120,0.02031063321385902,-8.458643754803168
ZCTA5 17801,7004,107,6897,0.015276984580239863,-8.459890644165581
ZCTA5 22968,3925,36,3889,0.009171974522292993,-8.4600386672319825
ZCTA5 70810,15752,336,15416,0.02133062468257999,-8.461814131541294
ZCTA5 31533,5922,81,5841,0.013677811550151976,-8.463410706601632
ZCTA5 89178,12424,246,12178,0.01980038634900193,-8.463488523572897
ZCTA5 99114,5060,61,4999,0.012055335968379446,-8.465061672931832
ZCTA5 24504,3882,35,3847,0.009015971148892323,-8.467623065930466
ZCTA5 39071,2132,1,2131,4.6904315196998124e-4,-8.46985451847316
ZCTA5 27298,4024,38,3986,0.009443339960238568,-8.47033802811007
ZCTA5 78015,5019,60,4959,0.011954572624028692,-8.470395228400251
ZCTA5 07719,8463,143,8320,0.016897081413210446,-8.470545342314868
ZCTA5 14067,2074,0,2074,0,-8.472641154142607
ZCTA5 17327,2798,13,2785,0.004646175839885632,-8.474248964179887
ZCTA5 07728,19946,452,19494,0.02266118520004011,-8.47687566265713
ZCTA5 07738,2077,0,2077,0,-8.478766693793819
ZCTA5 08071,3554,28,3526,0.007878446820483961,-8.47912678490646
ZCTA5 66030,8030,132,7898,0.01643835616438356,-8.479605944803577
ZCTA5 62881,4624,51,4573,0.011029411764705883,-8.480107667788378
ZCTA5 46341,3699,31,3668,0.008380643417139767,-8.4805127026101
ZCTA5 32806,11265,215,11050,0.01908566355969818,-8.480916175676171
ZCTA5 64118,16860,366,16494,0.021708185053380784,-8.481727322116804
ZCTA5 95973,14041,289,13752,0.02058257958834841,-8.481976324440893
ZCTA5 19025,2079,0,2079,0,-8.482847929502505
ZCTA5 53532,5679,75,5604,0.013206550449022716,-8.48544759309169
ZCTA5 44615,4079,39,4040,0.009561166952684481,-8.486178855781773
ZCTA5 36089,2645,10,2635,0.003780718336483932,-8.486824353140596
ZCTA5 02895,16940,368,16572,0.021723730814639904,-8.490574175266408
ZCTA5 72058,6150,86,6064,0.013983739837398375,-8.491375016862413
ZCTA5 70364,11044,209,10835,0.018924302788844622,-8.491616325989812
ZCTA5 45241,10008,182,9826,0.018185451638689048,-8.4945746459439615
ZCTA5 28547,2085,0,2085,0,-8.49507987230831
ZCTA5 08008,3563,28,3535,0.007858546168958742,-8.49646208518506
ZCTA5 48838,7395,116,7279,0.01568627450980392,-8.49708899816696
ZCTA5 39562,6280,89,6191,0.014171974522292994,-8.497696925373665
ZCTA5 27571,2087,0,2087,0,-8.499153274543023
ZCTA5 75056,21956,508,21448,0.023137183457824742,-8.501507898895603
ZCTA5 03867,9116,159,8957,0.01744186046511628,-8.50200653863209
ZCTA5 18634,5689,75,5614,0.013183336262963615,-8.502652417472506
ZCTA5 31087,3021,17,3004,0.005627275736511089,-8.50559081916201
ZCTA5 01720,8527,144,8383,0.01688753371643016,-8.507416525264077
ZCTA5 14901,5216,64,5152,0.012269938650306749,-8.508368206179606
ZCTA5 36549,2093,0,2093,0,-8.511361784462471
ZCTA5 57252,2093,0,2093,0,-8.511361784462471
ZCTA5 10504,2765,12,2753,0.00433996383363472,-8.513670773128423
ZCTA5 01772,3278,22,3256,0.006711409395973154,-8.514813639735564
ZCTA5 33487,9168,160,9008,0.017452006980802792,-8.52081808732033
ZCTA5 71055,7775,125,7650,0.01607717041800643,-8.520991262785016
ZCTA5 53143,8774,150,8624,0.017095965352176886,-8.52117934744966
ZCTA5 55356,2099,0,2099,0,-8.52355280782849
ZCTA5 60954,2099,0,2099,0,-8.52355280782849
ZCTA5 07739,2099,0,2099,0,-8.52355280782849
ZCTA5 18072,2502,7,2495,0.002797761790567546,-8.527646605470311
ZCTA5 49269,2219,2,2217,9.013068949977468e-4,-8.527702654903306
ZCTA5 06374,2878,14,2864,0.004864489228630994,-8.529411229249632
ZCTA5 16316,2448,6,2442,0.0024509803921568627,-8.530536428902868
ZCTA5 70394,5533,71,5462,0.012832098319175854,-8.530558107720648
ZCTA5 28278,9176,160,9016,0.017436791630340016,-8.53264026177808
ZCTA5 40361,7459,117,7342,0.015685748759887385,-8.53403131118791
ZCTA5 45640,6344,90,6254,0.014186633039092055,-8.534394690113047
ZCTA5 38068,4152,40,4112,0.009633911368015413,-8.535711719578183
ZCTA5 16025,2106,0,2106,0,-8.537753667289339
ZCTA5 01463,4338,44,4294,0.010142923005993546,-8.538368720416061
ZCTA5 13316,2617,9,2608,0.003439052350019106,-8.538984136828327
ZCTA5 44314,8189,135,8054,0.01648552936866528,-8.539406070528507
ZCTA5 23509,5146,62,5084,0.012048192771084338,-8.53954452433117
ZCTA5 45121,3537,27,3510,0.007633587786259542,-8.539806741159552
ZCTA5 01966,3243,21,3222,0.0064754856614246065,-8.543949362215816
ZCTA5 15370,4929,57,4872,0.011564211807668898,-8.546515070851125
ZCTA5 37130,21893,505,21388,0.02306673365916046,-8.547271093705781
ZCTA5 99362,15385,324,15061,0.02105947351316217,-8.549694062602471
ZCTA5 07070,7101,108,6993,0.015209125475285171,-8.550070977364227
ZCTA5 16415,3297,22,3275,0.006672732787382469,-8.551804954682833
ZCTA5 53033,2116,0,2116,0,-8.557999732396617
ZCTA5 97535,2463,6,2457,0.00243605359317905,-8.560751403708164
ZCTA5 00662,14144,290,13854,0.02050339366515837,-8.565401695860077
ZCTA5 12771,5897,79,5818,0.0133966423605223,-8.56560076910314
ZCTA5 83864,7479,117,7362,0.015643802647412757,-8.565638191277856
ZCTA5 00918,8086,132,7954,0.016324511501360377,-8.56605251298301
ZCTA5 86335,2238,2,2236,8.936550491510277e-4,-8.566146775817085
ZCTA5 23230,3103,18,3085,0.005800837898807605,-8.566486811411552
ZCTA5 73069,10097,183,9914,0.018124195305536297,-8.56649195516756
ZCTA5 02330,4491,47,4444,0.010465375194834113,-8.567465765705249
ZCTA5 23970,3104,18,3086,0.005798969072164949,-8.56844607508536
ZCTA5 60135,2632,9,2623,0.003419452887537994,-8.569012630685892
ZCTA5 36264,3306,22,3284,0.006654567453115548,-8.569277582650198
ZCTA5 92673,10294,188,10106,0.01826306586360987,-8.57130281766063
ZCTA5 75002,22236,514,21722,0.023115668285662888,-8.573386789272334
ZCTA5 03235,3797,32,3765,0.00842770608375033,-8.57599094321013
ZCTA5 62401,7689,122,7567,0.015866822733775522,-8.57630813276075
ZCTA5 65020,5386,67,5319,0.012439658373561084,-8.576641621092858
ZCTA5 49036,8970,154,8816,0.01716833890746934,-8.577711023301022
ZCTA5 53017,2126,0,2126,0,-8.578198013341064
ZCTA5 02493,3800,32,3768,0.008421052631578947,-8.581659086167635
ZCTA5 60546,5864,78,5786,0.01330150068212824,-8.582116720295122
ZCTA5 62681,2128,0,2128,0,-8.582231965133904
ZCTA5 95835,13526,273,13253,0.020183350584060327,-8.583179107241456
ZCTA5 65803,17454,380,17074,0.021771513693136242,-8.583317613151642
ZCTA5 00698,10727,199,10528,0.018551319101333084,-8.583688650875622
ZCTA5 18954,3112,18,3094,0.005784061696658098,-8.584105487658881
ZCTA5 03229,2129,0,2129,0,-8.584248230159993
ZCTA5 71104,6248,87,6161,0.013924455825864277,-8.58482229135748
ZCTA5 03874,3897,34,3863,0.008724659994867847,-8.585097959313133
ZCTA5 62420,2130,0,2130,0,-8.586264021717698
ZCTA5 62859,2420,5,2415,0.002066115702479339,-8.586898381332894
ZCTA5 39553,6040,82,5958,0.013576158940397352,-8.591248442001408
ZCTA5 94517,4731,52,4679,0.01099133375607694,-8.592227085604739
ZCTA5 74135,9648,171,9477,0.017723880597014924,-8.592522899841818
ZCTA5 02645,4183,40,4143,0.009562514941429595,-8.593196796875931
ZCTA5 76712,9922,178,9744,0.017939931465430357,-8.594001882187506
ZCTA5 62205,3370,23,3347,0.006824925816023739,-8.59682788501739
ZCTA5 10510,3567,27,3540,0.007569386038687973,-8.597270234439764
ZCTA5 63379,8427,140,8287,0.016613266880265813,-8.597398713462152
ZCTA5 74008,10119,183,9936,0.018084790987251704,-8.597862748836013
ZCTA5 94920,5355,66,5289,0.012324929971988795,-8.598612794298024
ZCTA5 31763,8508,142,8366,0.016690173953925715,-8.599169179916744
ZCTA5 47712,10507,193,10314,0.018368706576568004,-8.59930700513397
ZCTA5 43002,2137,0,2137,0,-8.600361333462411
ZCTA5 28152,9302,162,9140,0.017415609546334122,-8.602384474989172
ZCTA5 03275,4419,45,4374,0.010183299389002037,-8.602788787763533
ZCTA5 84020,13542,273,13269,0.020159503766061144,-8.6036866120852
ZCTA5 08889,3764,31,3733,0.008235919234856535,-8.604076837831355
ZCTA5 18414,2139,0,2139,0,-8.604384894540281
ZCTA5 62231,2969,15,2954,0.005052206130010104,-8.6063267396478
ZCTA5 01773,2140,0,2140,0,-8.606395969686252
ZCTA5 10312,21382,489,20893,0.02286970348891591,-8.6071533154315
ZCTA5 95693,2431,5,2426,0.0020567667626491155,-8.608955342335872
ZCTA5 34210,7262,111,7151,0.01528504544202699,-8.610476157737061
ZCTA5 48854,7345,113,7232,0.015384615384615385,-8.612086883534598
ZCTA5 44481,4006,36,3970,0.008986520219670495,-8.612163848611061
ZCTA5 82240,4055,37,4018,0.009124537607891493,-8.615798630739901
ZCTA5 70037,5884,78,5806,0.013256288239292998,-8.616026202047319
ZCTA5 37347,3281,21,3260,0.006400487656202377,-8.617750626623813
ZCTA5 51555,2146,0,2146,0,-8.618452565795357
ZCTA5 01566,2146,0,2146,0,-8.618452565795357
ZCTA5 05672,2148,0,2148,0,-8.622467684841862
ZCTA5 06088,2149,0,2149,0,-8.624474543401526
ZCTA5 27545,9592,169,9423,0.017618849040867388,-8.624755234833627
ZCTA5 46733,7639,120,7519,0.01570886241654667,-8.625154352779097
ZCTA5 47429,3484,25,3459,0.007175660160734788,-8.625896962911195
ZCTA5 25530,2150,0,2150,0,-8.626480935087015
ZCTA5 28120,8127,132,7995,0.016242155777039496,-8.629029935778163
ZCTA5 01754,4250,41,4209,0.009647058823529411,-8.631092279707504
ZCTA5 06759,2443,5,2438,0.002046663937781416,-8.632954069207255
ZCTA5 32531,2154,0,2154,0,-8.63450183959532
ZCTA5 87508,7808,124,7684,0.015881147540983607,-8.635380423525579
ZCTA5 38464,9049,155,8894,0.017128964526467012,-8.636230169798681
ZCTA5 92342,2502,6,2496,0.002398081534772182,-8.638824768652086
ZCTA5 01860,2775,11,2764,0.003963963963963964,-8.6392017553012
ZCTA5 63023,2157,0,2157,0,-8.640512631718755
ZCTA5 48034,7240,110,7130,0.015193370165745856,-8.640803193301165
ZCTA5 14568,2158,0,2158,0,-8.64251530010391
ZCTA5 98502,14354,294,14060,0.02048209558311272,-8.642944142802028
ZCTA5 44632,3640,28,3612,0.007692307692307693,-8.643555630679653
ZCTA5 21901,6452,91,6361,0.014104153750774954,-8.6435757356984
ZCTA5 50324,2160,0,2160,0,-8.646519245326859
ZCTA5 28021,5251,63,5188,0.011997714721005522,-8.646567543265189
ZCTA5 08022,3593,27,3566,0.0075146117450598385,-8.646804906209628
ZCTA5 45619,2990,15,2975,0.005016722408026756,-8.647499925169987
ZCTA5 39202,3446,24,3422,0.006964596633778294,-8.647628985199107
ZCTA5 19520,2337,3,2334,0.0012836970474967907,-8.64870373490189
ZCTA5 64116,7369,113,7256,0.015334509431401818,-8.650065286657197
ZCTA5 77069,8020,129,7891,0.016084788029925186,-8.650409786717432
ZCTA5 38103,7123,107,7016,0.015021760494173803,-8.65124476591266
ZCTA5 41179,3248,20,3228,0.006157635467980296,-8.651271353075282
ZCTA5 54521,3741,30,3711,0.00801924619085806,-8.651447911264555
ZCTA5 63077,4492,46,4446,0.010240427426536063,-8.652262155631886
ZCTA5 04011,8505,141,8364,0.016578483245149912,-8.654934864573933
ZCTA5 80907,12645,248,12397,0.019612495057334915,-8.655929287397676
ZCTA5 35466,2165,0,2165,0,-8.656521006039421
ZCTA5 44718,5301,64,5237,0.012073193737030748,-8.657075250162748
ZCTA5 46231,3451,24,3427,0.006954505940307157,-8.657196909804194
ZCTA5 24416,3452,24,3428,0.006952491309385863,-8.659109376407327
ZCTA5 29550,12272,238,12034,0.01939374185136897,-8.662072552002929
ZCTA5 24211,4080,37,4043,0.009068627450980393,-8.662177217296321
ZCTA5 32547,14518,298,14220,0.020526243284198924,-8.662596598684594
ZCTA5 42240,16577,354,16223,0.021354889304457985,-8.663203506088946
ZCTA5 44890,4268,41,4227,0.009606373008434864,-8.664132070439864
ZCTA5 47170,5524,69,5455,0.012490948587979726,-8.664622527325823
ZCTA5 07764,2459,5,2454,0.0020333468889792597,-8.664850345617563
ZCTA5 19934,5218,62,5156,0.011881947106170947,-8.66586025075686
ZCTA5 26416,3306,21,3285,0.006352087114337568,-8.665996565962402
ZCTA5 54001,3205,19,3186,0.00592823712948518,-8.666035476455637
ZCTA5 37212,6967,103,6864,0.014783981627673318,-8.666357455967201
ZCTA5 01969,2170,0,2170,0,-8.666511224027564
ZCTA5 75601,6043,81,5962,0.013403938441171603,-8.667833408669596
ZCTA5 62024,4271,41,4230,0.009599625380472957,-8.669628898747964
ZCTA5 08558,2518,6,2512,0.0023828435266084196,-8.670655144872162
ZCTA5 54301,9152,157,8995,0.01715472027972028,-8.671539563803847
ZCTA5 91108,4686,50,4636,0.010670081092616303,-8.673561627891326
ZCTA5 01077,3801,31,3770,0.0081557484872402,-8.67374936397852
ZCTA5 19720,21551,492,21059,0.02282956707345367,-8.673868074574456
ZCTA5 48507,13111,260,12851,0.019830676531157044,-8.67505173482761
ZCTA5 36064,3559,26,3533,0.007305422871593144,-8.675196974617808
ZCTA5 76522,13561,272,13289,0.020057517882162083,-8.675766552682587
ZCTA5 01240,2175,0,2175,0,-8.676489939162597
ZCTA5 33547,7916,126,7790,0.01591712986356746,-8.677093976718739
ZCTA5 35147,2177,0,2177,0,-8.680478213305264
ZCTA5 25304,3365,22,3343,0.006537890044576523,-8.683043937845742
ZCTA5 20882,4371,43,4328,0.00983756577442233,-8.683053189330463
ZCTA5 43449,3265,20,3245,0.006125574272588055,-8.684070034822838
ZCTA5 21046,6224,85,6139,0.01365681233933162,-8.685741683203009
ZCTA5 38614,6605,94,6511,0.014231642694928085,-8.687840468321522
ZCTA5 32804,7722,121,7601,0.01566951566951567,-8.691113311786209
ZCTA5 22939,2184,0,2184,0,-8.694422765608937
ZCTA5 03868,2185,0,2185,0,-8.696413019215322
ZCTA5 24340,2185,0,2185,0,-8.696413019215322
ZCTA5 29330,3170,18,3152,0.0056782334384858045,-8.696865041181635
ZCTA5 92625,5804,75,5729,0.012922122674017919,-8.698828811639675
ZCTA5 40162,2187,0,2187,0,-8.700392160589967
ZCTA5 45323,2187,0,2187,0,-8.700392160589967
ZCTA5 17090,2477,5,2472,0.0020185708518368995,-8.700595715549882
ZCTA5 68818,2188,0,2188,0,-8.702381048982753
ZCTA5 45240,10193,183,10010,0.017953497498283136,-8.702958712968055
ZCTA5 20024,7811,123,7688,0.01574702342849827,-8.702960143062658
ZCTA5 33330,4612,48,4564,0.010407632263660017,-8.703921846924896
ZCTA5 36693,7893,125,7768,0.01583681743316863,-8.704158695591229
ZCTA5 50049,2755,10,2745,0.003629764065335753,-8.705563870885749
ZCTA5 35128,4291,41,4250,0.009554882311815428,-8.70620328804621
ZCTA5 08260,6154,83,6071,0.013487162820929478,-8.710770933203934
ZCTA5 38028,2649,8,2641,0.003020007550018875,-8.710971908691892
ZCTA5 49721,6241,85,6156,0.013619612241627945,-8.713938644364552
ZCTA5 24354,5985,79,5906,0.013199665831244779,-8.714019795852542
ZCTA5 08036,2194,0,2194,0,-8.714304846832416
ZCTA5 18517,2194,0,2194,0,-8.714304846832416
ZCTA5 88401,2372,3,2369,0.0012647554806070826,-8.7183567832752
ZCTA5 02461,2708,9,2699,0.0033234859675036928,-8.719621072516581
ZCTA5 60656,12088,232,11856,0.019192587690271344,-8.71987987488024
ZCTA5 17842,3284,20,3264,0.0060901339829476245,-8.720595335901082
ZCTA5 44233,2923,13,2910,0.004447485460143688,-8.72121182297016
ZCTA5 32618,2871,12,2859,0.0041797283176593526,-8.723073699558338
ZCTA5 94598,10247,184,10063,0.01795647506587294,-8.724305135989043
ZCTA5 14482,3337,21,3316,0.006293077614623914,-8.725488533951458
ZCTA5 92808,7417,113,7304,0.015235270324929216,-8.725721002575787
ZCTA5 35504,5076,58,5018,0.011426319936958234,-8.727656199833838
ZCTA5 77340,10986,203,10783,0.018478062989259057,-8.729395700817346
ZCTA5 33710,13341,265,13076,0.019863578442395623,-8.729678221065534
ZCTA5 46203,14498,296,14202,0.020416609187474136,-8.73003903179176
ZCTA5 16507,3589,26,3563,0.007244357759821678,-8.732027627032299
ZCTA5 21102,3976,34,3942,0.008551307847082495,-8.73246761295863
ZCTA5 99506,2204,0,2204,0,-8.73414166932933
ZCTA5 72703,14651,300,14351,0.020476417991945942,-8.735724071959336
ZCTA5 18301,9669,169,9500,0.017478539662840003,-8.736029407833799
ZCTA5 13326,2439,4,2435,0.0016400164001640015,-8.73756670318716
ZCTA5 07071,8442,138,8304,0.016346837242359632,-8.74118151439949
ZCTA5 08043,10879,200,10679,0.01838404265097895,-8.741316491000733
ZCTA5 73099,22822,526,22296,0.023047936201910438,-8.742525112262525
ZCTA5 67152,3644,27,3617,0.007409440175631174,-8.743262374914016
ZCTA5 82435,4906,54,4852,0.0110069302894415,-8.743622496697682
ZCTA5 98362,10378,187,10191,0.018018886105222585,-8.744537304748441
ZCTA5 02874,2210,0,2210,0,-8.746022166776605
ZCTA5 35042,2211,0,2211,0,-8.74800068103487
ZCTA5 49854,2613,7,2606,0.0026789131266743206,-8.748541544428063
ZCTA5 92210,2613,7,2606,0.0026789131266743206,-8.748541544428063
ZCTA5 01220,3842,31,3811,0.008068714211348256,-8.750404926471434
ZCTA5 12210,5355,64,5291,0.011951447245564892,-8.750602230977313
ZCTA5 95642,2991,14,2977,0.004680708793045804,-8.75114054054627
ZCTA5 15135,2213,0,2213,0,-8.751956367730825
ZCTA5 56283,2560,6,2554,0.00234375,-8.75366882245541
ZCTA5 77713,5751,73,5678,0.012693444618327247,-8.75546093760827
ZCTA5 07826,2215,0,2215,0,-8.755910267353231
ZCTA5 12549,3749,29,3720,0.007735396105628167,-8.757345172072048
ZCTA5 11010,7726,120,7606,0.015531969971524721,-8.760597798168472
ZCTA5 21629,3605,26,3579,0.007212205270457697,-8.762205661878415
ZCTA5 06807,2620,7,2613,0.0026717557251908397,-8.762289364794713
ZCTA5 08807,13254,262,12992,0.01976761732307228,-8.762604729004334
ZCTA5 25430,3155,17,3138,0.005388272583201268,-8.766838182549629
ZCTA5 19734,4091,36,4055,0.008799804448790027,-8.769465337629958
ZCTA5 40014,6949,101,6848,0.014534465390703698,-8.770825612240547
ZCTA5 06811,11056,204,10852,0.01845151953690304,-8.772683281513874
ZCTA5 60554,4467,44,4423,0.009850011193194537,-8.773262248416549
ZCTA5 30909,17400,374,17026,0.021494252873563217,-8.773418037186989
ZCTA5 55731,2897,12,2885,0.004142216085605799,-8.773711299191273
ZCTA5 46738,3363,21,3342,0.006244424620874219,-8.77510507022721
ZCTA5 01757,11135,206,10929,0.01850022451728783,-8.775388561922647
ZCTA5 70445,3953,33,3920,0.008348090058183658,-8.778227549756748
ZCTA5 04073,6788,97,6691,0.014289923394225103,-8.780669140918267
ZCTA5 78730,3810,30,3780,0.007874015748031496,-8.780720258222887
ZCTA5 54720,3111,16,3095,0.005143040822886531,-8.781557744686422
ZCTA5 79423,14434,293,14141,0.020299293335180824,-8.789130201444205
ZCTA5 07462,2634,7,2627,0.0026575550493545936,-8.789721903145187
ZCTA5 93514,6159,82,6077,0.013313849650917357,-8.789948579997942
ZCTA5 30088,10099,179,9920,0.017724527180909,-8.790698504389898
ZCTA5 34685,7295,109,7186,0.014941740918437287,-8.793080816965727
ZCTA5 43072,2234,0,2234,0,-8.793383643915403
ZCTA5 64132,5602,69,5533,0.012317029632274188,-8.797971714870359
ZCTA5 22192,19808,440,19368,0.02221324717285945,-8.798091877169195
ZCTA5 45335,2583,6,2577,0.0023228803716608595,-8.798802494628948
ZCTA5 44306,8922,149,8773,0.01670029141448106,-8.800587747604322
ZCTA5 49935,2858,11,2847,0.003848845346396081,-8.80167344369636
ZCTA5 13662,7094,104,6990,0.014660276289822385,-8.80293184397998
ZCTA5 43571,2697,8,2689,0.0029662588060808304,-8.80506206574235
ZCTA5 75209,6636,93,6543,0.014014466546112115,-8.806589321956604
ZCTA5 89143,4206,38,4168,0.00903471231573942,-8.807146234535947
ZCTA5 33558,8688,143,8545,0.016459484346224677,-8.809235437156582
ZCTA5 15902,5212,60,5152,0.011511895625479662,-8.80944528879811
ZCTA5 19126,5783,73,5710,0.012623205948469652,-8.809490006652611
ZCTA5 49106,2243,0,2243,0,-8.81107856461558
ZCTA5 19055,4809,51,4758,0.010605115408608859,-8.81171169622064
ZCTA5 35904,5258,61,5197,0.011601369341955116,-8.812154833358958
ZCTA5 03870,2244,0,2244,0,-8.81304247382633
ZCTA5 02420,4991,55,4936,0.011019835704267681,-8.81397177394628
ZCTA5 55008,5830,74,5756,0.012692967409948542,-8.815594209006019
ZCTA5 66220,2595,6,2589,0.0023121387283236996,-8.822260381280522
ZCTA5 02554,3637,26,3611,0.0071487489689304375,-8.822290724614357
ZCTA5 59804,3184,17,3167,0.005339195979899497,-8.82243747339017
ZCTA5 14904,6392,87,6305,0.013610763454317897,-8.822659069773518
ZCTA5 53913,8937,149,8788,0.01667226138525232,-8.822718679956083
ZCTA5 96001,13939,279,13660,0.020015783054738504,-8.823251584250492
ZCTA5 34951,6982,101,6881,0.014465769120595818,-8.823548481658348
ZCTA5 64683,3236,18,3218,0.005562422744128554,-8.823570508563103
ZCTA5 48611,2596,6,2590,0.0023112480739599386,-8.824212437465562
ZCTA5 21769,3979,33,3946,0.008293541090726313,-8.826184040614914
ZCTA5 07009,4451,43,4408,0.009660750393170074,-8.827754693371816
ZCTA5 50323,4864,52,4812,0.01069078947368421,-8.82872933471324
ZCTA5 55792,4820,51,4769,0.01058091286307054,-8.831128117048552
ZCTA5 80107,4453,43,4410,0.009656411408039524,-8.831347982007642
ZCTA5 16057,4777,50,4727,0.010466820180029307,-8.835500830423216
ZCTA5 27603,20096,447,19649,0.022243232484076433,-8.838182483932078
ZCTA5 02835,2257,0,2257,0,-8.838533583280165
ZCTA5 34601,9267,157,9110,0.01694183662458185,-8.83981678856132
ZCTA5 15205,10330,184,10146,0.017812197483059053,-8.841114797449237
ZCTA5 14895,4319,40,4279,0.009261403102570039,-8.841820923002773
ZCTA5 31047,4962,54,4908,0.010882708585247884,-8.842045245920183
ZCTA5 36265,7697,118,7579,0.015330648304534233,-8.842363902785479
ZCTA5 48186,13543,268,13275,0.01978882079302961,-8.843900393104441
ZCTA5 22630,11724,220,11504,0.018764926646195838,-8.845101562377142
ZCTA5 36572,2262,0,2262,0,-8.84831830185631
ZCTA5 06786,3895,31,3864,0.007958921694480103,-8.848659345858342
ZCTA5 82604,10453,187,10266,0.017889601071462737,-8.849585584905846
ZCTA5 30240,10531,189,10342,0.017947013578957362,-8.849777332431229
ZCTA5 01747,2263,0,2263,0,-8.850273947432596
ZCTA5 01331,5281,61,5220,0.011550842643438742,-8.851826609986594
ZCTA5 74112,9199,155,9044,0.01684965757147516,-8.856490472178242
ZCTA5 53726,2268,0,2268,0,-8.860045700378647
ZCTA5 68355,2268,0,2268,0,-8.860045700378647
ZCTA5 52349,3048,14,3034,0.004593175853018373,-8.86100760771823
ZCTA5 49461,3561,24,3537,0.006739679865206402,-8.865379147727507
ZCTA5 11721,2271,0,2271,0,-8.865903582473393
ZCTA5 02189,6206,82,6124,0.013213019658395102,-8.867596557025973
ZCTA5 64085,3362,20,3342,0.00594883997620464,-8.869111504292821
ZCTA5 06416,5819,73,5746,0.012545110843787592,-8.869996845759886
ZCTA5 34233,7797,120,7677,0.015390534821085032,-8.870211509352261
ZCTA5 29061,5159,58,5101,0.011242488854429153,-8.872150356048325
ZCTA5 54130,10275,182,10093,0.017712895377128952,-8.873524393524198
ZCTA5 62948,5339,62,5277,0.0116126615471062,-8.875182956432761
ZCTA5 19118,4435,42,4393,0.00947012401352875,-8.882471944787026
ZCTA5 27589,2954,12,2942,0.004062288422477996,-8.883762804710692
ZCTA5 59106,6811,96,6715,0.014094846571722214,-8.885063643849687
ZCTA5 06040,14213,285,13928,0.02005206501090551,-8.885494705951881
ZCTA5 35773,4807,50,4757,0.01040149781568546,-8.888387456121047
ZCTA5 02814,2903,11,2892,0.0037891836031691355,-8.88857170835615
ZCTA5 66109,8422,135,8287,0.016029446687247685,-8.892802234931724
ZCTA5 47802,13623,269,13354,0.01974601776407546,-8.897765554112313
ZCTA5 06423,2289,0,2289,0,-8.900969916768226
ZCTA5 93108,4116,35,4081,0.008503401360544218,-8.901970293413841
ZCTA5 28771,3123,15,3108,0.004803073967339097,-8.904131855171709
ZCTA5 68028,4495,43,4452,0.009566184649610678,-8.906538755438001
ZCTA5 66605,7118,103,7015,0.014470356841809497,-8.906916999227397
ZCTA5 15717,4167,36,4131,0.008639308855291577,-8.908162601572487
ZCTA5 71109,7781,119,7662,0.015293664053463565,-8.908625371933882
ZCTA5 53122,2293,0,2293,0,-8.908743691103036
ZCTA5 35125,4405,41,4364,0.009307604994324632,-8.912363458730335
ZCTA5 43938,2295,0,2295,0,-8.912628035604635
ZCTA5 49202,8557,138,8419,0.01612714736473063,-8.913532348208491
ZCTA5 13077,2698,7,2691,0.0025945144551519643,-8.914075555753804
ZCTA5 28465,3487,22,3465,0.006309148264984227,-8.914163269602497
ZCTA5 07724,8920,147,8773,0.01647982062780269,-8.915398118697778
ZCTA5 98077,4685,47,4638,0.010032017075773746,-8.915510758455346
ZCTA5 55902,10266,181,10085,0.01763101500097409,-8.915773716750618
ZCTA5 03458,3132,15,3117,0.004789272030651341,-8.921248289288444
ZCTA5 57747,2758,8,2750,0.0029006526468455403,-8.923240946531319
ZCTA5 80615,2868,10,2858,0.003486750348675035,-8.924897156284707
ZCTA5 52002,6583,90,6493,0.013671578307762418,-8.92606416042542
ZCTA5 37220,2302,0,2302,0,-8.926209930116888
ZCTA5 19312,4366,40,4326,0.009161704076958314,-8.926434730095444
ZCTA5 01913,7131,103,7028,0.014443977001823026,-8.927435154312377
ZCTA5 34217,2761,8,2753,0.002897500905469033,-8.929013704781346
ZCTA5 54025,2651,6,2645,0.002263296869105998,-8.930929235291664
ZCTA5 48035,14474,291,14183,0.020105015890562388,-8.931281128677998
ZCTA5 66611,4648,46,4602,0.009896729776247849,-8.931528073733379
ZCTA5 06419,2305,0,2305,0,-8.932024419885659
ZCTA5 66901,2596,5,2591,0.001926040061633282,-8.933359186139969
ZCTA5 82834,3397,20,3377,0.0058875478363261706,-8.935024024399311
ZCTA5 76054,4371,40,4331,0.009151223976206819,-8.935397779567577
ZCTA5 33322,16111,335,15776,0.020793246849978277,-8.937015079076128
ZCTA5 38655,16920,357,16563,0.021099290780141843,-8.937264684150149
ZCTA5 36340,2308,0,2308,0,-8.937835127051189
ZCTA5 37033,2983,12,2971,0.004022795843110962,-8.939258266207112
ZCTA5 29440,10479,186,10293,0.017749785284855425,-8.940178450884787
ZCTA5 70127,9654,165,9489,0.01709136109384711,-8.940807802937456
ZCTA5 27803,7761,118,7643,0.015204226259502641,-8.940985844820858
ZCTA5 32817,11528,213,11315,0.01847675225537821,-8.942920607728578
ZCTA5 28303,13207,257,12950,0.0194593776027864,-8.944048778545458
ZCTA5 17578,2602,5,2597,0.001921598770176787,-8.944936703493484
ZCTA5 08012,14448,290,14158,0.020071982281284605,-8.945337002538102
ZCTA5 48616,2987,12,2975,0.004017408771342484,-8.94688704666728
ZCTA5 44104,8741,142,8599,0.016245280860313464,-8.947434891685129
ZCTA5 19611,3852,29,3823,0.007528556593977154,-8.94822006982353
ZCTA5 49738,4142,35,4107,0.008450024142926123,-8.949146062446301
ZCTA5 61010,2935,11,2924,0.003747870528109029,-8.949873873914857
ZCTA5 53528,2491,3,2488,0.0012043356081894822,-8.95114450758955
ZCTA5 98019,4096,34,4062,0.00830078125,-8.952431245037344
ZCTA5 22301,5827,72,5755,0.012356272524455123,-8.956255353109517
ZCTA5 44657,3956,31,3925,0.007836198179979777,-8.960605914355332
ZCTA5 20895,7027,100,6927,0.014230823964707557,-8.96146267804987
ZCTA5 41071,8751,142,8609,0.01622671694663467,-8.962208942083347
ZCTA5 32643,4339,39,4300,0.008988246139663517,-8.962331441019705
ZCTA5 14522,4054,33,4021,0.008140108534780463,-8.963305751918794
ZCTA5 45801,8752,142,8610,0.01622486288848263,-8.963685579379659
ZCTA5 12986,2612,5,2607,0.0019142419601837673,-8.964199728682003
ZCTA5 38355,2322,0,2322,0,-8.964901962056993
ZCTA5 45750,11120,202,10918,0.01816546762589928,-8.965787085891376
ZCTA5 06354,2323,0,2323,0,-8.966832181039864
ZCTA5 65270,5702,69,5633,0.012101017186951947,-8.966859723416704
ZCTA5 66203,8228,129,8099,0.015678172095284396,-8.966980346211345
ZCTA5 52761,11892,222,11670,0.01866801210898083,-8.967022668392483
ZCTA5 28376,14802,299,14503,0.02019997297662478,-8.967664859057438
ZCTA5 00627,11431,210,11221,0.01837109614206981,-8.968037222092503
ZCTA5 06071,3466,21,3445,0.006058857472590883,-8.96922551452753
ZCTA5 53110,7656,115,7541,0.015020898641588296,-8.969503334382699
ZCTA5 64067,2325,0,2325,0,-8.970691373033057
ZCTA5 44142,7535,112,7423,0.014863968148639682,-8.974096488675263
ZCTA5 49058,7659,115,7544,0.015015015015015015,-8.97412399094302
ZCTA5 68046,9916,171,9745,0.017244856797095604,-8.976316276164209
ZCTA5 48070,2328,0,2328,0,-8.976477050108585
ZCTA5 74820,11862,221,11641,0.018630922272803913,-8.97816946630513
ZCTA5 92109,22554,512,22042,0.022701072980402588,-8.980731335749129
ZCTA5 18702,15445,316,15129,0.020459695694399482,-8.980871249422497
ZCTA5 15690,3772,27,3745,0.0071580063626723225,-8.981372178921388
ZCTA5 76901,11403,209,11194,0.018328510041217223,-8.982336496344455
ZCTA5 17007,2333,0,2333,0,-8.986111567264238
ZCTA5 14174,2334,0,2334,0,-8.988037231395904
ZCTA5 02445,8529,136,8393,0.015945597373666315,-8.992178405763015
ZCTA5 36345,3223,16,3207,0.004964318957493019,-8.994658688045243
ZCTA5 53235,4730,47,4683,0.009936575052854123,-8.994729123520939
ZCTA5 02718,2339,0,2339,0,-8.997659370144712
ZCTA5 28759,3120,14,3106,0.004487179487179487,-8.997979742518199
ZCTA5 13619,4170,35,4135,0.008393285371702638,-8.9997189476065
ZCTA5 15066,5413,62,5351,0.01145390726029928,-9.001431786245616
ZCTA5 15627,2802,8,2794,0.0028551034975017845,-9.007546577178042
ZCTA5 87109,17859,381,17478,0.02133378128674618,-9.00764179871729
ZCTA5 92131,11654,215,11439,0.01844860133859619,-9.008560699531799
ZCTA5 44432,4413,40,4373,0.009064128710627692,-9.010399758818616
ZCTA5 06351,6251,81,6170,0.012957926731722925,-9.011847733227777
ZCTA5 81506,5241,58,5183,0.01106659034535394,-9.013197976761742
ZCTA5 19078,4368,39,4329,0.008928571428571428,-9.01416457406177
ZCTA5 21401,16066,332,15734,0.020664757873770697,-9.015094955032865
ZCTA5 26155,3023,12,3011,0.0039695666556400925,-9.015268780774802
ZCTA5 30045,11777,218,11559,0.018510656364099515,-9.018525034109322
ZCTA5 29842,2809,8,2801,0.002847988608045568,-9.02088799756573
ZCTA5 17347,2352,0,2352,0,-9.022628907278484
ZCTA5 48801,5112,55,5057,0.010758998435054772,-9.023885133798007
ZCTA5 37030,2920,10,2910,0.003424657534246575,-9.024102135018362
ZCTA5 18848,3597,23,3574,0.006394217403391716,-9.02530050880356
ZCTA5 48026,6043,76,5967,0.012576534833691875,-9.025523454650118
ZCTA5 28904,4137,34,4103,0.00821851583272903,-9.026551004663258
ZCTA5 37722,2355,0,2355,0,-9.02838130117319
ZCTA5 62243,2355,0,2355,0,-9.02838130117319
ZCTA5 78717,10347,181,10166,0.017492993138107663,-9.028954009262147
ZCTA5 78733,2923,10,2913,0.0034211426616489907,-9.029793400089217
ZCTA5 61252,2357,0,2357,0,-9.03221419512687
ZCTA5 67432,2359,0,2359,0,-9.036045463250444
ZCTA5 33449,3802,27,3775,0.0071015255128879535,-9.036384759779637
ZCTA5 48377,7659,114,7545,0.014884449667058363,-9.037668365948774
ZCTA5 07604,4239,36,4203,0.008492569002123142,-9.037923750522213
ZCTA5 15320,2360,0,2360,0,-9.037960488272104
ZCTA5 86336,6181,79,6102,0.012781103381329881,-9.038556772183492
ZCTA5 33331,7578,112,7466,0.014779625230931645,-9.040497219052735
ZCTA5 59923,4097,33,4064,0.008054674151818403,-9.041127264633051
ZCTA5 60503,5303,59,5244,0.01112577786158778,-9.042384185078623
ZCTA5 34473,6742,92,6650,0.013645802432512608,-9.044987008260437
ZCTA5 38672,4481,41,4440,0.009149743360856952,-9.047683861688089
ZCTA5 35906,4149,34,4115,0.008194745721860689,-9.048147605219718
ZCTA5 30143,8568,136,8432,0.015873015873015872,-9.050075818407173
ZCTA5 10520,5218,57,5161,0.01092372556535071,-9.050789678671267
ZCTA5 65233,4296,37,4259,0.00861266294227188,-9.05471135564611
ZCTA5 10014,18229,390,17839,0.02139448132097208,-9.05489719671578
ZCTA5 63116,19248,418,18830,0.021716541978387367,-9.056058731930552
ZCTA5 54457,3513,21,3492,0.005977796754910333,-9.056551972155683
ZCTA5 00690,2371,0,2371,0,-9.058999045015653
ZCTA5 23518,12002,223,11779,0.018580236627228797,-9.061875834093795
ZCTA5 30742,3104,13,3091,0.004188144329896907,-9.067528521592033
ZCTA5 56071,4446,40,4406,0.00899685110211426,-9.068973479045674
ZCTA5 03281,3158,14,3144,0.004433185560481318,-9.069483143028345
ZCTA5 11729,8744,140,8604,0.016010978956999086,-9.070811348945421
ZCTA5 89429,2836,8,2828,0.0028208744710860366,-9.07216846510224
ZCTA5 35214,7307,105,7202,0.014369782400437936,-9.072202491728158
ZCTA5 00924,19444,423,19021,0.021754782966467805,-9.072396187823488
ZCTA5 32219,4115,33,4082,0.00801944106925881,-9.073535348802464
ZCTA5 99006,4729,46,4683,0.009727215056037217,-9.073843034880149
ZCTA5 92128,20638,456,20182,0.022095164260102725,-9.074867740159393
ZCTA5 45828,2380,0,2380,0,-9.076176136476402
ZCTA5 35120,5009,52,4957,0.010381313635456179,-9.08116400803516
ZCTA5 23093,5055,53,5002,0.010484668644906034,-9.08190165551936
ZCTA5 72210,6808,93,6715,0.013660399529964748,-9.082453681147033
ZCTA5 12962,2384,0,2384,0,-9.08379997329856
ZCTA5 44030,5904,72,5832,0.012195121951219513,-9.0840968593435
ZCTA5 72560,3729,25,3704,0.006704210244033253,-9.084138776945643
ZCTA5 11565,3166,14,3152,0.004421983575489577,-9.084468712376962
ZCTA5 64772,5507,63,5444,0.01143998547303432,-9.08499836440976
ZCTA5 26150,2385,0,2385,0,-9.085704932944815
ZCTA5 84102,9079,148,8931,0.016301354774754927,-9.08907262785183
ZCTA5 32606,9160,150,9010,0.016375545851528384,-9.09003976368646
ZCTA5 25541,3979,30,3949,0.007539582809751194,-9.090666839664749
ZCTA5 76049,11174,201,10973,0.01798818686235905,-9.091744894989787
ZCTA5 05482,3223,15,3208,0.004654049022649705,-9.092615128320876
ZCTA5 07930,2957,10,2947,0.0033818058843422386,-9.094053957890807
ZCTA5 08090,2848,8,2840,0.0028089887640449437,-9.094869218775747
ZCTA5 26757,2849,8,2841,0.002808002808002808,-9.096758452626545
ZCTA5 94510,11179,201,10978,0.017980141336434385,-9.098509427814784
ZCTA5 08079,3886,28,3858,0.007205352547606794,-9.099669119927071
ZCTA5 21043,16876,352,16524,0.020858023228253142,-9.099936336316865
ZCTA5 85262,5203,56,5147,0.010763021333845858,-9.10223534182559
ZCTA5 80112,13369,258,13111,0.01929837684194779,-9.102260312145392
ZCTA5 84332,2395,0,2395,0,-9.104732608095953
ZCTA5 55901,22282,501,21781,0.022484516650210933,-9.106180982177415
ZCTA5 01267,2397,0,2397,0,-9.108533373282624
ZCTA5 50461,2398,0,2398,0,-9.110433161263087
ZCTA5 29676,2517,2,2515,7.945967421533572e-4,-9.112054655223783
ZCTA5 49331,6485,85,6400,0.013107170393215111,-9.112136311890646
ZCTA5 44136,10329,179,10150,0.017329848000774518,-9.113304586611472
ZCTA5 56082,4752,46,4706,0.00968013468013468,-9.113930582833827
ZCTA5 06472,2400,0,2400,0,-9.114231549237694
ZCTA5 43604,4378,38,4340,0.00867976244860667,-9.116028926861249
ZCTA5 43465,2401,0,2401,0,-9.11613014972683
ZCTA5 54868,6915,95,6820,0.01373825018076645,-9.117547419676052
ZCTA5 46173,4141,33,4108,0.007969089591886018,-9.12017397512978
ZCTA5 33176,17152,359,16793,0.020930503731343284,-9.121258605964778
ZCTA5 10901,8739,139,8600,0.015905710035473166,-9.122943600401639
ZCTA5 14425,4943,50,4893,0.010115314586283633,-9.125138873800731
ZCTA5 03446,2407,0,2407,0,-9.127513459239122
ZCTA5 24078,3029,11,3018,0.0036315615714757345,-9.12766233877133
ZCTA5 12208,9905,168,9737,0.01696113074204947,-9.128368621221096
ZCTA5 06238,4761,46,4715,0.00966183574879227,-9.129578746716577
ZCTA5 67301,5220,56,5164,0.010727969348659003,-9.131176803869195
ZCTA5 45050,3297,16,3281,0.004852896572641796,-9.13291037195035
ZCTA5 01609,7722,114,7608,0.014763014763014764,-9.134105725201259
ZCTA5 07825,3402,18,3384,0.005291005291005291,-9.135093160341423
ZCTA5 90278,15354,310,15044,0.0201901784551257,-9.140095846477115
ZCTA5 14472,3304,16,3288,0.004842615012106538,-9.1458870300863655
ZCTA5 01364,3199,14,3185,0.00437636761487965,-9.14603866883467
ZCTA5 14487,2418,0,2418,0,-9.148346072302804
ZCTA5 48848,2986,10,2976,0.003348961821835231,-9.148519716888998
ZCTA5 70447,4772,46,4726,0.009639564124056999,-9.148675220639275
ZCTA5 08865,11605,211,11394,0.01818181818181818,-9.149426995424202
ZCTA5 63114,14615,290,14325,0.019842627437564146,-9.15108173670156
ZCTA5 30317,5548,63,5485,0.011355443403028118,-9.153773916173547
ZCTA5 98365,2421,0,2421,0,-9.154019465761175
ZCTA5 58504,11182,200,10982,0.017885888034340904,-9.155156941936706
ZCTA5 21048,3621,22,3599,0.006075669704501519,-9.161958571146636
ZCTA5 07940,5464,61,5403,0.01116398243045388,-9.16291719159283
ZCTA5 24541,12195,226,11969,0.018532185321853217,-9.163955018922845
ZCTA5 18088,3262,15,3247,0.004598405885959534,-9.165135689004181
ZCTA5 48164,3103,12,3091,0.003867225265871737,-9.165482242658163
ZCTA5 37034,2776,6,2770,0.002161383285302594,-9.16892076107916
ZCTA5 15825,3676,23,3653,0.006256800870511426,-9.170205358350687
ZCTA5 05443,2889,8,2881,0.0027691242644513675,-9.172016265356143
ZCTA5 37840,3976,29,3947,0.007293762575452716,-9.173438546230821
ZCTA5 15857,5739,67,5672,0.011674507753964105,-9.175589642495863
ZCTA5 22911,7248,102,7146,0.014072847682119206,-9.176084871507163
ZCTA5 44011,7957,119,7838,0.014955385195425412,-9.17662298802986
ZCTA5 75048,7626,111,7515,0.014555468135326514,-9.177942767198296
ZCTA5 78219,5785,68,5717,0.011754537597234226,-9.178438323235843
ZCTA5 90056,3374,17,3357,0.005038529934795495,-9.178978280275048
ZCTA5 55803,7418,106,7312,0.014289565920733351,-9.179271419684753
ZCTA5 65240,3323,16,3307,0.004814926271441469,-9.181022816337633
ZCTA5 49068,6226,78,6148,0.012528107934468359,-9.182413827146846
ZCTA5 37821,8739,138,8601,0.01579128046687264,-9.18243199893858
ZCTA5 07092,2438,0,2438,0,-9.186102510390036
ZCTA5 34986,11362,204,11158,0.017954585460306285,-9.187827237699882
ZCTA5 60438,11440,206,11234,0.018006993006993006,-9.188138079571495
ZCTA5 46802,4562,41,4521,0.00898728627794827,-9.190113060350175
ZCTA5 52060,3687,23,3664,0.006238133984269053,-9.190218845476505
ZCTA5 61443,5570,63,5507,0.011310592459605027,-9.190520084270451
ZCTA5 32097,6578,86,6492,0.01307388263910003,-9.192255265446967
ZCTA5 92592,24505,561,23944,0.022893287084268518,-9.193777553889554
ZCTA5 18964,5349,58,5291,0.01084314825200972,-9.196469991473576
ZCTA5 21795,3791,25,3766,0.006594566077552097,-9.196888615217324
ZCTA5 61240,2446,0,2446,0,-9.201161704942725
ZCTA5 48173,4663,43,4620,0.00922153120308814,-9.202333874226213
ZCTA5 31808,2447,0,2447,0,-9.203042371636855
ZCTA5 73533,10709,187,10522,0.01746194789429452,-9.203405858203983
ZCTA5 01862,3388,17,3371,0.005017709563164109,-9.204741522323495
ZCTA5 46151,11726,213,11513,0.018164762067201093,-9.207272870907609
ZCTA5 28562,16195,331,15864,0.020438406915714726,-9.21140560625466
ZCTA5 18058,3599,21,3578,0.005834954153931648,-9.214391540315969
ZCTA5 63348,2454,0,2454,0,-9.216196292919054
ZCTA5 27540,12198,225,11973,0.018445646827348745,-9.21823378302719
ZCTA5 30542,12583,235,12348,0.018675991416991177,-9.218886919973242
ZCTA5 85719,17495,366,17129,0.020920262932266363,-9.21954185963464
ZCTA5 42330,3347,16,3331,0.004780400358530027,-9.225225636659731
ZCTA5 07044,5139,53,5086,0.010313290523448142,-9.225370264264829
ZCTA5 28469,2807,6,2801,0.0021375133594584966,-9.22700688586802
ZCTA5 01748,5991,72,5919,0.012018027040560842,-9.227011448381685
ZCTA5 30204,4441,38,4403,0.008556631389326727,-9.227017250661774
ZCTA5 60452,10295,176,10119,0.017095677513355997,-9.230425221384728
ZCTA5 01921,2753,5,2748,0.0018162005085361425,-9.231578035218778
ZCTA5 28301,6860,92,6768,0.013411078717201166,-9.231911422962217
ZCTA5 35816,6517,84,6433,0.01288936627282492,-9.232371091590755
ZCTA5 62363,2463,0,2463,0,-9.233080941503985
ZCTA5 41015,8160,123,8037,0.015073529411764706,-9.233593358332039
ZCTA5 44110,9018,144,8874,0.015968063872255488,-9.234499103924854
ZCTA5 07624,2756,5,2751,0.00181422351233672,-9.237183761111273
ZCTA5 29928,7790,114,7676,0.014634146341463415,-9.237487682181465
ZCTA5 61282,3354,16,3338,0.004770423375074538,-9.238080778105509
ZCTA5 68128,7582,109,7473,0.014376154049063571,-9.238257244531747
ZCTA5 36460,3663,22,3641,0.006006006006006006,-9.238387231807653
ZCTA5 06403,2466,0,2466,0,-9.238702300284414
ZCTA5 86351,3252,14,3238,0.004305043050430504,-9.244110956989203
ZCTA5 01062,4065,30,4035,0.007380073800738007,-9.244938095399798
ZCTA5 58104,17039,353,16686,0.020717178238159516,-9.246018803094753
ZCTA5 45345,2470,0,2470,0,-9.246192129078636
ZCTA5 53149,7421,105,7316,0.01414903651798949,-9.24845008617863
ZCTA5 25504,5380,58,5322,0.010780669144981412,-9.248565713478966
ZCTA5 61354,4643,42,4601,0.009045875511522722,-9.249139622408471
ZCTA5 06525,2931,8,2923,0.002729443875810304,-9.250393308487421
ZCTA5 85045,2473,0,2473,0,-9.251805521559136
ZCTA5 35096,2988,9,2979,0.0030120481927710845,-9.254000002051265
ZCTA5 04843,2475,0,2475,0,-9.255545891843965
ZCTA5 17361,2476,0,2476,0,-9.25741551026357
ZCTA5 32205,13074,247,12827,0.01889245831421141,-9.259385853066092
ZCTA5 27313,2479,0,2479,0,-9.263022101376253
ZCTA5 62703,12310,227,12083,0.018440292445166533,-9.263760931452357
ZCTA5 13108,2480,0,2480,0,-9.264890211126287
ZCTA5 33480,5615,63,5552,0.011219946571682992,-9.265343888437078
ZCTA5 47909,16427,336,16091,0.020454130395081267,-9.265942527730077
ZCTA5 63038,2484,0,2484,0,-9.27235888643116
ZCTA5 08046,10367,177,10190,0.01707340599980708,-9.275257039267876
ZCTA5 60178,8353,127,8226,0.015204118280857177,-9.275778637824587
ZCTA5 30605,16250,331,15919,0.020369230769230768,-9.276073339947303
ZCTA5 03825,3375,16,3359,0.004740740740740741,-9.276545940209832
ZCTA5 19040,7734,112,7622,0.014481510214636669,-9.278873770542884
ZCTA5 53186,13928,269,13659,0.01931361286616887,-9.280609180452968
ZCTA5 17821,7610,109,7501,0.014323258869908016,-9.280960649420692
ZCTA5 61525,3112,11,3101,0.0035347043701799484,-9.281922243039274
ZCTA5 65809,4710,43,4667,0.009129511677282378,-9.283714286612135
ZCTA5 24266,3588,20,3568,0.005574136008918618,-9.287180781216982
ZCTA5 50035,2492,0,2492,0,-9.287278218503488
ZCTA5 06897,6028,72,5956,0.011944260119442602,-9.287310428408121
ZCTA5 44102,19094,408,18686,0.021367968995495968,-9.287616414551284
ZCTA5 08620,4138,31,4107,0.007491541807636539,-9.287704123609803
ZCTA5 29644,7405,104,7301,0.014044564483457124,-9.28846957845575
ZCTA5 44647,7657,110,7547,0.014365939663053415,-9.288807082752932
ZCTA5 17257,11126,196,10930,0.017616394031997124,-9.290285198268293
ZCTA5 42276,5898,69,5829,0.011698880976602238,-9.291417451682896
ZCTA5 11797,3009,9,3000,0.0029910269192422734,-9.292874728251359
ZCTA5 15367,3012,9,3003,0.00298804780876494,-9.298415351192814
ZCTA5 46001,4146,31,4115,0.0074770863482875064,-9.30185393671975
ZCTA5 15224,5593,62,5531,0.011085285177900948,-9.303180150596225
ZCTA5 69341,4098,30,4068,0.007320644216691069,-9.303544712393563
ZCTA5 13676,5323,56,5267,0.010520383242532407,-9.305048756442625
ZCTA5 53140,11723,211,11512,0.017998805766442038,-9.306020480741768
ZCTA5 98642,6909,92,6817,0.013315964683745839,-9.308789704254142
ZCTA5 39525,3497,18,3479,0.005147269087789534,-9.309031621522605
ZCTA5 52136,2504,0,2504,0,-9.30961238675139
ZCTA5 16354,4537,39,4498,0.008595988538681949,-9.311470618796616
ZCTA5 48158,2964,8,2956,0.002699055330634278,-9.311522951621829
ZCTA5 06378,2506,0,2506,0,-9.313329540976873
ZCTA5 04473,3075,10,3065,0.0032520325203252032,-9.313748973042301
ZCTA5 32308,10318,175,10143,0.016960651289009497,-9.317004729707397
ZCTA5 05478,5825,67,5758,0.011502145922746782,-9.31723935378253
ZCTA5 63121,10556,181,10375,0.017146646456991283,-9.317576464903981
ZCTA5 06371,4155,31,4124,0.007460890493381468,-9.31775021497275
ZCTA5 07630,2509,0,2509,0,-9.318902492233134
ZCTA5 37404,5057,50,5007,0.009887284951552304,-9.319943292322282
ZCTA5 78414,14416,281,14135,0.019492230854605993,-9.322529002395733
ZCTA5 67217,11581,207,11374,0.017874104136084968,-9.324116245381035
ZCTA5 53179,2512,0,2512,0,-9.324472112707793
ZCTA5 06482,3962,27,3935,0.006814740030287734,-9.324951981390186
ZCTA5 21231,7471,105,7366,0.014054343461384018,-9.325070817090285
ZCTA5 46280,3454,17,3437,0.004921829762594094,-9.325302226719964
ZCTA5 43202,9445,153,9292,0.016199047114875596,-9.32575887316978
ZCTA5 56320,3244,13,3231,0.004007398273736128,-9.327009734683744
ZCTA5 73801,5653,63,5590,0.011144525030957014,-9.328178410332988
ZCTA5 99218,6054,72,5982,0.011892963330029732,-9.329513905596722
ZCTA5 64034,3138,11,3127,0.003505417463352454,-9.3297392239232
ZCTA5 02067,6274,77,6197,0.012272872170863883,-9.3301708905527
ZCTA5 49938,3509,18,3491,0.005129666571672842,-9.330788659023122
ZCTA5 59401,6579,84,6495,0.012767897856817145,-9.330974235476209
ZCTA5 75126,13398,254,13144,0.018958053440812063,-9.331193247988452
ZCTA5 01524,2517,0,2517,0,-9.333747427955146
ZCTA5 23141,2517,0,2517,0,-9.333747427955146
ZCTA5 32407,4503,38,4465,0.008438818565400843,-9.335167330154086
ZCTA5 60031,13706,262,13444,0.019115715744929228,-9.335191891007256
ZCTA5 33180,14729,289,14440,0.01962115554348564,-9.33617751077364
ZCTA5 95818,9774,161,9613,0.016472273378350725,-9.336573849926118
ZCTA5 82901,10372,176,10196,0.016968762051677595,-9.336759891997263
ZCTA5 38544,2810,5,2805,0.0017793594306049821,-9.3375173439468
ZCTA5 32456,3356,15,3341,0.004469606674612634,-9.337746382499986
ZCTA5 32222,3304,14,3290,0.00423728813559322,-9.339383534453564
ZCTA5 55398,5391,57,5334,0.010573177518085699,-9.342738166127521
ZCTA5 33771,13867,266,13601,0.019182231196365473,-9.346301668691966
ZCTA5 46040,4075,29,4046,0.007116564417177914,-9.349848027861315
ZCTA5 73717,2526,0,2526,0,-9.350419809378
ZCTA5 15626,2526,0,2526,0,-9.350419809378
ZCTA5 68136,5979,70,5909,0.011707643418631878,-9.351233657189546
ZCTA5 11021,7949,116,7833,0.014593030569883004,-9.351669469759832
ZCTA5 33316,5077,50,5027,0.009848335631278314,-9.353788470896404
ZCTA5 11791,8241,123,8118,0.014925373134328358,-9.354103789477724
ZCTA5 45387,2528,0,2528,0,-9.354120747504071
ZCTA5 31032,5402,57,5345,0.010551647537948908,-9.361064975052944
ZCTA5 44907,6729,87,6642,0.012929112795363353,-9.3632035905579
ZCTA5 37312,13195,248,12947,0.018794998105342933,-9.364393026408386
ZCTA5 25813,2535,0,2535,0,-9.367062515770764
ZCTA5 46239,9836,162,9674,0.016470109800732005,-9.367332948582332
ZCTA5 25071,4618,40,4578,0.0086617583369424,-9.369367547919818
ZCTA5 31014,4379,35,4344,0.007992692395524092,-9.3699133957612
ZCTA5 49837,3991,27,3964,0.006765221748935104,-9.376413727256118
ZCTA5 72903,11308,199,11109,0.017598160594269545,-9.376745212102824
ZCTA5 34446,7632,108,7524,0.014150943396226415,-9.378081926232445
ZCTA5 26181,2541,0,2541,0,-9.378141245267662
ZCTA5 55372,11895,214,11681,0.017990752416981927,-9.378925433759473
ZCTA5 18080,4529,38,4491,0.008390373150805918,-9.380209634828336
ZCTA5 33328,10166,170,9996,0.016722408026755852,-9.381708553601607
ZCTA5 95683,2543,0,2543,0,-9.381831247867769
ZCTA5 21219,3486,17,3469,0.004876649454962708,-9.383234935336903
ZCTA5 19963,8178,121,8057,0.01479579359256542,-9.383446830969296
ZCTA5 07023,2544,0,2544,0,-9.383675705026624
ZCTA5 48837,8137,120,8017,0.01474744992011798,-9.384146846969038
ZCTA5 07663,5371,56,5315,0.010426363805622788,-9.385227094485144
ZCTA5 75460,9366,150,9216,0.016015374759769378,-9.385527327432008
ZCTA5 18444,5234,53,5181,0.010126098586167366,-9.385562797492595
ZCTA5 21550,5867,67,5800,0.01141980569285836,-9.385842905933032
ZCTA5 77094,3277,13,3264,0.003967043027158987,-9.387176779167403
ZCTA5 44302,2546,0,2546,0,-9.38736353213108
ZCTA5 66083,3224,12,3212,0.0037220843672456576,-9.3883051668661
ZCTA5 98020,8758,135,8623,0.015414478191367893,-9.388509321404877
ZCTA5 17222,4912,46,4866,0.009364820846905538,-9.388988850053538
ZCTA5 61072,4439,36,4403,0.008109934669970714,-9.390447134014403
ZCTA5 02081,7090,95,6995,0.013399153737658674,-9.390981861671325
ZCTA5 13152,3493,17,3476,0.004866876610363584,-9.395863187714443
ZCTA5 23005,6228,75,6153,0.012042389210019268,-9.397056698016144
ZCTA5 72022,6880,90,6790,0.01308139534883721,-9.397433027749953
ZCTA5 34240,3954,26,3928,0.0065756196256954984,-9.399150516129126
ZCTA5 39465,7478,104,7374,0.013907461888205403,-9.400073913428653
ZCTA5 70520,6925,91,6834,0.013140794223826715,-9.40062730843705
ZCTA5 12803,3651,20,3631,0.005477951246233908,-9.400680893130795
ZCTA5 48081,8849,137,8712,0.01548197536444796,-9.40184908168839
ZCTA5 07066,5788,65,5723,0.011230131306150656,-9.402686227147523
ZCTA5 11971,2556,0,2556,0,-9.40578097877962
ZCTA5 49097,4254,32,4222,0.007522331922896097,-9.405816898222616
ZCTA5 01532,5429,57,5372,0.010499171118069627,-9.405932230531812
ZCTA5 48429,3807,23,3784,0.006041502495403204,-9.406046930600562
ZCTA5 33486,9097,143,8954,0.015719467956469165,-9.406717123412372
ZCTA5 19070,2849,5,2844,0.001755001755001755,-9.409321892197514
ZCTA5 19462,5971,69,5902,0.011555853290906045,-9.410202932433316
ZCTA5 06878,2559,0,2559,0,-9.411299184580676
ZCTA5 70444,4011,27,3984,0.006731488406881077,-9.411759149300153
ZCTA5 98569,3074,9,3065,0.0029277813923227064,-9.412210607393325
ZCTA5 16150,3020,8,3012,0.0026490066225165563,-9.414369807855897
ZCTA5 12043,2910,6,2904,0.002061855670103093,-9.417466280069258
ZCTA5 83712,4064,28,4036,0.006889763779527559,-9.41762529775442
ZCTA5 02190,7150,96,7054,0.013426573426573427,-9.417740585386781
ZCTA5 44705,7279,99,7180,0.013600769336447315,-9.419669167541084
ZCTA5 85012,3560,18,3542,0.0050561797752808986,-9.422734734004854
ZCTA5 39565,6639,84,6555,0.012652507907817443,-9.425712210911383
ZCTA5 27244,4887,45,4842,0.009208103130755065,-9.425991346602714
ZCTA5 46818,7706,109,7597,0.014144822216454711,-9.426425491210232
ZCTA5 35475,5398,56,5342,0.010374212671359764,-9.430095308090012
ZCTA5 70339,2570,0,2570,0,-9.431504983390282
ZCTA5 06825,7287,99,7188,0.013585837793330589,-9.431932401687584
ZCTA5 53168,3355,14,3341,0.004172876304023845,-9.431936041537686
ZCTA5 15236,12440,227,12213,0.0182475884244373,-9.432074008132414
ZCTA5 22443,3669,20,3649,0.005451076587626056,-9.432878551576742
ZCTA5 40701,11587,205,11382,0.017692241304910677,-9.435397381500323
ZCTA5 84025,6515,81,6434,0.012432847275518036,-9.435871900215448
ZCTA5 78231,3304,13,3291,0.003934624697336562,-9.436131786637162
ZCTA5 18433,2691,2,2689,7.432181345224824e-4,-9.436571430593276
ZCTA5 06333,2573,0,2573,0,-9.437008147322546
ZCTA5 01775,2575,0,2575,0,-9.440675141106682
ZCTA5 32778,9082,142,8940,0.015635322616163842,-9.443553352281768
ZCTA5 06335,2578,0,2578,0,-9.446172962677853
ZCTA5 11967,8054,117,7937,0.014526943133846535,-9.446213745028851
ZCTA5 21783,3256,12,3244,0.0036855036855036856,-9.446390202251404
ZCTA5 37355,10214,170,10044,0.01664382220481692,-9.447998657288716
ZCTA5 43235,18177,379,17798,0.020850525389228144,-9.44981124714571
ZCTA5 12158,2580,0,2580,0,-9.449836400070835
ZCTA5 45417,12066,217,11849,0.01798441902867562,-9.44996843875616
ZCTA5 02896,4430,35,4395,0.007900677200902935,-9.458377194298755
ZCTA5 21619,2586,0,2586,0,-9.46081820087124
ZCTA5 38343,6268,75,6193,0.011965539246968731,-9.461020602489594
ZCTA5 45885,5371,55,5316,0.010240178737665239,-9.461108535745478
ZCTA5 64014,9013,140,8873,0.015533118828359036,-9.461570630434002
ZCTA5 30108,2879,5,2874,0.0017367141368530739,-9.464189127928428
ZCTA5 07446,5512,58,5454,0.010522496371552975,-9.467929308784852
ZCTA5 45817,2591,0,2591,0,-9.469959973417549
ZCTA5 19041,2592,0,2592,0,-9.471787269136133
ZCTA5 58503,13588,256,13332,0.018840153076243746,-9.473552810920973
ZCTA5 60202,13436,252,13184,0.018755582018457874,-9.4749320859043
ZCTA5 01879,4440,35,4405,0.007882882882882882,-9.475640349098747
ZCTA5 34614,2596,0,2596,0,-9.479092929512007
ZCTA5 07465,2596,0,2596,0,-9.479092929512007
ZCTA5 16127,5337,54,5283,0.01011804384485666,-9.48073460196119
ZCTA5 77550,9837,160,9677,0.016265121480126054,-9.480872918323797
ZCTA5 02739,2597,0,2597,0,-9.480918464999228
ZCTA5 37601,15302,301,15001,0.019670631290027447,-9.482011475398176
ZCTA5 60431,7405,101,7304,0.013639432815665091,-9.482344605133301
ZCTA5 45875,4493,36,4457,0.008012463832628533,-9.483724812836916
ZCTA5 47129,8208,120,8088,0.014619883040935672,-9.489270657170962
ZCTA5 10990,7453,102,7351,0.013685764121830136,-9.49078424074008
ZCTA5 21158,7496,103,7393,0.013740661686232657,-9.491691290855721
ZCTA5 07432,2604,0,2604,0,-9.493687384543211
ZCTA5 06787,3174,10,3164,0.00315059861373661,-9.494269613269381
ZCTA5 21131,2605,0,2605,0,-9.49551011421049
ZCTA5 49457,3757,21,3736,0.005589566143199361,-9.49812443053784
ZCTA5 14513,5802,64,5738,0.011030679076180628,-9.498538153836634
ZCTA5 08332,13876,263,13613,0.01895358893052753,-9.499113462462898
ZCTA5 35757,5895,66,5829,0.011195928753180661,-9.503803438929044
ZCTA5 07730,5895,66,5829,0.011195928753180661,-9.503803438929044
ZCTA5 30339,12263,221,12042,0.018021691266411156,-9.50384690281181
ZCTA5 07436,4311,32,4279,0.007422871723498028,-9.504938497849096
ZCTA5 25311,4934,45,4889,0.009120389136603162,-9.505472917126703
ZCTA5 28657,4015,26,3989,0.006475716064757161,-9.506578905724945
ZCTA5 24101,2612,0,2612,0,-9.508259438222398
ZCTA5 27513,17861,369,17492,0.020659537539891384,-9.509256033632372
ZCTA5 61241,2731,2,2729,7.323324789454412e-4,-9.509610612781678
ZCTA5 29210,16413,330,16083,0.020106013525863643,-9.510010640099098
ZCTA5 95949,8347,123,8224,0.014735833233497064,-9.510370836015673
ZCTA5 30144,20285,435,19850,0.021444417056938624,-9.512345067467558
ZCTA5 19560,3293,12,3281,0.0036440935317339812,-9.513126215017543
ZCTA5 08502,3561,17,3544,0.004773939904521202,-9.51772093696678
ZCTA5 15853,2852,4,2848,0.001402524544179523,-9.518955864005664
ZCTA5 23507,3350,13,3337,0.003880597014925373,-9.51898218159894
ZCTA5 85297,9706,156,9550,0.01607253245415207,-9.52304777075039
ZCTA5 17872,4273,31,4242,0.007254856073016616,-9.524031602549647
ZCTA5 53037,3874,23,3851,0.005937016004130098,-9.524621411216238
ZCTA5 23462,25266,573,24693,0.02267869864640228,-9.525129042583846
ZCTA5 49323,3514,16,3498,0.004553215708594195,-9.527465863857513
ZCTA5 73116,4424,34,4390,0.0076853526220614825,-9.531615865424675
ZCTA5 11740,3140,9,3131,0.0028662420382165603,-9.531892959071953
ZCTA5 11001,9144,142,9002,0.01552930883639545,-9.532108543819012
ZCTA5 21202,8611,129,8482,0.014980838462431773,-9.533163288857615
ZCTA5 44106,10995,188,10807,0.017098681218735787,-9.537320969774457
ZCTA5 24588,3780,21,3759,0.005555555555555556,-9.538781867839905
ZCTA5 39702,8408,124,8284,0.014747859181731684,-9.538926165730658
ZCTA5 06370,2630,0,2630,0,-9.540965185453917
ZCTA5 80232,9232,144,9088,0.01559792027729636,-9.541204978888652
ZCTA5 76502,14826,287,14539,0.01935788479697828,-9.545139237367996
ZCTA5 48301,5468,56,5412,0.010241404535479151,-9.545655753304617
ZCTA5 21620,5052,47,5005,0.009303246239113222,-9.546188200681044
ZCTA5 28645,18448,384,18064,0.020815264527320035,-9.546627664619658
ZCTA5 46383,16108,321,15787,0.019927986093866402,-9.546887248840973
ZCTA5 39452,8950,137,8813,0.015307262569832402,-9.547269628404596
ZCTA5 32712,15659,309,15350,0.019733060859569575,-9.548538196978877
ZCTA5 64078,3736,20,3716,0.0053533190578158455,-9.551845269957079
ZCTA5 28334,9727,156,9571,0.016037832836434666,-9.552375973089285
ZCTA5 97321,10450,174,10276,0.016650717703349284,-9.552605896077736
ZCTA5 35057,4773,41,4732,0.008589985334171381,-9.552883316648783
ZCTA5 53536,3476,15,3461,0.00431530494821634,-9.553815410272177
ZCTA5 60453,21415,465,20950,0.02171375204296054,-9.55451573446153
ZCTA5 29127,3634,18,3616,0.0049532195927352776,-9.554680305598193
ZCTA5 01007,5475,56,5419,0.010228310502283105,-9.557151869847411
ZCTA5 80816,2639,0,2639,0,-9.55727608855122
ZCTA5 27850,3266,11,3255,0.0033680342927127987,-9.561781011256516
ZCTA5 31405,13965,264,13701,0.01890440386680988,-9.561851586873589
ZCTA5 95969,11762,207,11555,0.017599047780989627,-9.562589270589385
ZCTA5 55328,3429,14,3415,0.004082822980460776,-9.564712659847036
ZCTA5 60119,3588,17,3571,0.004738015607580825,-9.56570193451102
ZCTA5 85650,6424,77,6347,0.011986301369863013,-9.568777313495607
ZCTA5 98368,7420,100,7320,0.013477088948787063,-9.569711751697241
ZCTA5 37642,6249,73,6176,0.01168186909905585,-9.571374742450644
ZCTA5 33917,12471,225,12246,0.0180418571084917,-9.571584552167634
ZCTA5 03903,2647,0,2647,0,-9.571751335147779
ZCTA5 02052,4153,28,4125,0.006742114134360703,-9.573102683673687
ZCTA5 10514,3953,24,3929,0.006071338224133569,-9.574281037679123
ZCTA5 16412,4204,29,4175,0.006898192197906755,-9.575425807678995
ZCTA5 98332,6779,85,6694,0.01253872252544623,-9.576675512510798
ZCTA5 77385,8600,128,8472,0.014883720930232559,-9.577157609880343
ZCTA5 14905,3853,22,3831,0.0057098364910459385,-9.577191916790566
ZCTA5 74801,8435,124,8311,0.014700652045050385,-9.578340616346509
ZCTA5 70446,2651,0,2651,0,-9.578980755615834
ZCTA5 19018,9787,157,9630,0.01604168795340758,-9.579671179119014
ZCTA5 70116,5987,67,5920,0.011190913646233506,-9.579834611322688
ZCTA5 43935,3649,18,3631,0.004932858317347218,-9.58121932793267
ZCTA5 20905,5808,63,5745,0.01084710743801653,-9.581248664850492
ZCTA5 55305,9829,158,9671,0.01607488045579408,-9.581904024351081
ZCTA5 54914,13022,239,12783,0.018353555521425282,-9.582942781201313
ZCTA5 40505,10992,187,10805,0.017012372634643377,-9.586341468390481
ZCTA5 25951,2656,0,2656,0,-9.588009865694366
ZCTA5 43713,2657,0,2657,0,-9.589814667567422
ZCTA5 07417,3758,20,3738,0.005321979776476849,-9.590611648662309
ZCTA5 14063,5175,49,5126,0.009468599033816425,-9.59554888345689
ZCTA5 47302,11158,191,10967,0.017117763039971323,-9.596546654819907
ZCTA5 70601,14033,265,13768,0.01888405900377681,-9.598505882873134
ZCTA5 28705,2839,3,2836,0.0010567101091933778,-9.599704575834973
ZCTA5 19317,3608,17,3591,0.0047117516629711755,-9.601098313894248
ZCTA5 55301,4562,36,4526,0.00789127575624726,-9.60178902436621
ZCTA5 49319,6313,74,6239,0.011721843814351339,-9.602600088323806
ZCTA5 69361,7228,95,7133,0.01314333148865523,-9.602885909686739
ZCTA5 15136,9602,152,9450,0.01583003540928973,-9.604035445281495
ZCTA5 18512,5320,52,5268,0.009774436090225564,-9.604997068694939
ZCTA5 18640,7444,100,7344,0.013433637829124127,-9.606024019248618
ZCTA5 45662,12576,227,12349,0.01805025445292621,-9.606557305114084
ZCTA5 08618,13004,238,12766,0.018302060904337128,-9.608973389848426
ZCTA5 49201,15673,308,15365,0.01965163019205002,-9.609498409192078
ZCTA5 26847,2670,0,2670,0,-9.613246257929509
ZCTA5 32536,8459,124,8335,0.0146589431374867,-9.613290481087617
ZCTA5 14870,4077,26,4051,0.006377238165317636,-9.61466656089774
ZCTA5 78750,11724,205,11519,0.017485499829409758,-9.615501965669512
ZCTA5 75034,35506,862,34644,0.024277586886723372,-9.616095758848115
ZCTA5 30102,14658,281,14377,0.01917041888388593,-9.61712349543969
ZCTA5 14068,2673,0,2673,0,-9.618645441875488
ZCTA5 08721,7453,100,7353,0.013417415805715819,-9.619617377930105
ZCTA5 49512,7540,102,7438,0.013527851458885942,-9.622271757676934
ZCTA5 74012,22458,492,21966,0.021907560780122896,-9.622903674974012
ZCTA5 12211,4082,26,4056,0.006369426751592357,-9.62333585293364
ZCTA5 94523,13863,260,13603,0.018754959244030873,-9.624720359392223
ZCTA5 02061,3674,18,3656,0.004899292324442025,-9.62529910846256
ZCTA5 27577,9046,138,8908,0.015255361485739553,-9.625787901923422
ZCTA5 17032,3193,9,3184,0.0028186658315064203,-9.626951045507793
ZCTA5 66215,11028,187,10841,0.01695683714182082,-9.634459422676587
ZCTA5 19004,3886,22,3864,0.005661348430262481,-9.634926913529393
ZCTA5 13905,11268,193,11075,0.017128150514731984,-9.637602007434236
ZCTA5 17921,2802,2,2800,7.137758743754461e-4,-9.63789450892974
ZCTA5 15501,6380,75,6305,0.011755485893416929,-9.638478260830606
ZCTA5 03904,3418,13,3405,0.0038033937975424223,-9.640208025358046
ZCTA5 67235,4292,30,4262,0.006989748369058714,-9.641768798009414
ZCTA5 85215,7425,99,7326,0.013333333333333334,-9.64182233425018
ZCTA5 06260,3942,23,3919,0.005834601725012684,-9.643608937320561
ZCTA5 23503,13610,253,13357,0.018589272593681115,-9.64398318285947
ZCTA5 15658,4044,25,4019,0.006181998021760633,-9.644721938511529
ZCTA5 20015,6473,77,6396,0.011895566198053454,-9.645798394755627
ZCTA5 08060,8857,133,8724,0.015016371231794062,-9.649779938477726
ZCTA5 60041,3424,13,3411,0.003796728971962617,-9.650834382848664
ZCTA5 83669,3690,18,3672,0.004878048780487805,-9.653411419556274
ZCTA5 46221,9719,154,9565,0.01584525156909147,-9.654028511803658
ZCTA5 37398,6034,67,5967,0.011103745442492543,-9.655018700370011
ZCTA5 06762,2694,0,2694,0,-9.656355201779132
ZCTA5 92651,11126,189,10937,0.01698723710228294,-9.659340679182357
ZCTA5 07004,2696,0,2696,0,-9.659938929941767
ZCTA5 49008,6702,82,6620,0.012235153685467026,-9.660335951194
ZCTA5 18509,4837,41,4796,0.008476328302666942,-9.660675166825408
ZCTA5 27932,5169,48,5121,0.009286128845037725,-9.662940182936133
ZCTA5 13148,4501,34,4467,0.007553876916240835,-9.66325995540035
ZCTA5 32796,8202,117,8085,0.014264813460131675,-9.664630125028697
ZCTA5 23435,10972,185,10787,0.016861100984323734,-9.665734088166168
ZCTA5 01606,8120,115,8005,0.01416256157635468,-9.667437797559899
ZCTA5 23168,2701,0,2701,0,-9.668892439074835
ZCTA5 36203,6970,88,6882,0.012625538020086082,-9.670344312163913
ZCTA5 12010,11571,200,11371,0.01728459078731311,-9.672738426474211
ZCTA5 74011,10298,168,10130,0.016313847348999804,-9.6729867853108
ZCTA5 44827,2996,5,2991,0.0016688918558077437,-9.675226754149527
ZCTA5 33901,8876,133,8743,0.01498422712933754,-9.67696593017804
ZCTA5 28786,9573,150,9423,0.015669069257286117,-9.677104791977358
ZCTA5 33063,22261,485,21776,0.021786981716904002,-9.680652756680045
ZCTA5 50801,3965,23,3942,0.005800756620428752,-9.68355302734975
ZCTA5 27863,4803,40,4763,0.0083281282531751,-9.683779437579956
ZCTA5 38008,3497,14,3483,0.004003431512725193,-9.685193969361833
ZCTA5 28467,4852,41,4811,0.008450123660346249,-9.685793746174546
ZCTA5 48334,7838,108,7730,0.013779025261546313,-9.68691445021109
ZCTA5 53703,16041,316,15725,0.01969951998005112,-9.6879283150815
ZCTA5 27103,15590,304,15286,0.019499679281590764,-9.689528972026556
ZCTA5 27983,3396,12,3384,0.0035335689045936395,-9.69657707709506
ZCTA5 19003,5607,57,5550,0.010165864098448368,-9.697678947974088
ZCTA5 60025,14991,288,14703,0.01921152691614969,-9.697760628135681
ZCTA5 33715,3769,19,3750,0.0050411249668347044,-9.700524314442466
ZCTA5 68502,11277,192,11085,0.017025804735301943,-9.701890876029355
ZCTA5 19015,6511,77,6434,0.011826140377822147,-9.70522356558117
ZCTA5 28779,7681,104,7577,0.013539903658377815,-9.705950489233294
ZCTA5 65301,13005,236,12769,0.018146866589773165,-9.707765286149074
ZCTA5 12144,8861,132,8729,0.014896738517097392,-9.71458468134435
ZCTA5 34229,3407,12,3395,0.0035221602582917524,-9.715971748195546
ZCTA5 20124,5061,45,5016,0.00889152341434499,-9.717574491900365
ZCTA5 60201,15088,290,14798,0.019220572640509012,-9.722905897190978
ZCTA5 06379,3732,18,3714,0.00482315112540193,-9.726844471936575
ZCTA5 47122,3785,19,3766,0.005019815059445178,-9.728383478577864
ZCTA5 60563,15208,293,14915,0.019266175697001578,-9.730219413102358
ZCTA5 46394,4880,41,4839,0.008401639344262295,-9.73253638734597
ZCTA5 43617,2737,0,2737,0,-9.733114570855276
ZCTA5 10024,28751,665,28086,0.02312963027372961,-9.735621074457615
ZCTA5 55447,8627,126,8501,0.014605308913875044,-9.735987068341478
ZCTA5 06415,6220,70,6150,0.011254019292604502,-9.736790252827221
ZCTA5 29631,5814,61,5753,0.010491916064671482,-9.73680959141698
ZCTA5 72753,3310,10,3300,0.0030211480362537764,-9.736959329498807
ZCTA5 26101,12523,223,12300,0.01780723468817376,-9.737530413591475
ZCTA5 46701,3200,8,3192,0.0025,-9.737745349295249
ZCTA5 34653,14609,277,14332,0.018960914504757342,-9.741856272374948
ZCTA5 29488,8591,125,8466,0.014550110580840414,-9.744103840654327
ZCTA5 70126,9987,159,9828,0.01592069690597777,-9.744298715180044
ZCTA5 59635,2744,0,2744,0,-9.745553061005152
ZCTA5 02152,8006,111,7895,0.013864601548838371,-9.747597057106553
ZCTA5 12572,3587,15,3572,0.004181767493727348,-9.749635537545256
ZCTA5 21222,20581,437,20144,0.021233176230503862,-9.750024930686175
ZCTA5 99577,9503,147,9356,0.015468799326528464,-9.750229112827043
ZCTA5 60442,3482,13,3469,0.003733486502010339,-9.752983355425501
ZCTA5 49015,11078,186,10892,0.01679003430222062,-9.753908768441129
ZCTA5 53533,2985,4,2981,0.001340033500837521,-9.757366929533644
ZCTA5 13212,8891,132,8759,0.014846473962433921,-9.757373005330342
ZCTA5 44223,7631,102,7529,0.013366531254095138,-9.758531741881825
ZCTA5 19087,12033,210,11823,0.017452006980802792,-9.761823467023564
ZCTA5 30241,8607,125,8482,0.014523062623446032,-9.767128195233054
ZCTA5 49418,10770,178,10592,0.016527390900649953,-9.768938182472345
ZCTA5 83501,14441,272,14169,0.018835260716016898,-9.769652350124877
ZCTA5 76052,7209,92,7117,0.012761825495907892,-9.770392839260643
ZCTA5 17754,5046,44,5002,0.008719778042013475,-9.771008752000819
ZCTA5 12009,2993,4,2989,0.0013364517206815904,-9.771523100496683
ZCTA5 11933,3165,7,3158,0.0022116903633491313,-9.77454618346491
ZCTA5 94065,5192,47,5145,0.009052388289676425,-9.778076691700338
ZCTA5 92691,16759,333,16426,0.019869920639656303,-9.779696557531015
ZCTA5 72714,5193,47,5146,0.009050645099171962,-9.779716876363402
ZCTA5 64086,8658,126,8532,0.014553014553014554,-9.78052382051199
ZCTA5 37067,11337,192,11145,0.01693569727441122,-9.7810211376592
ZCTA5 02459,6605,78,6527,0.011809235427706283,-9.782670543302677
ZCTA5 19512,7131,90,7041,0.012620950778291964,-9.78354852796611
ZCTA5 43615,17922,364,17558,0.020310233232898114,-9.785532570149284
ZCTA5 28314,23124,506,22618,0.021882027330911605,-9.786139108788849
ZCTA5 11951,4327,29,4298,0.0067021030737231336,-9.78622564683536
ZCTA5 49720,3974,22,3952,0.0055359838953195776,-9.787358831188927
ZCTA5 63701,14111,263,13848,0.018637942031039613,-9.787730906249774
ZCTA5 35222,4077,24,4053,0.005886681383370125,-9.78885638765582
ZCTA5 03045,5105,45,5060,0.00881488736532811,-9.7901755311586
ZCTA5 98239,3396,11,3385,0.0032391048292108363,-9.79200584277674
ZCTA5 24015,6877,84,6793,0.012214628471717318,-9.79511230947004
ZCTA5 61856,3177,7,3170,0.0022033364809568774,-9.795677143546351
ZCTA5 37763,6168,68,6100,0.011024643320363165,-9.796184934018942
ZCTA5 34119,12767,228,12539,0.017858541552439884,-9.799697413492217
ZCTA5 11714,7915,108,7807,0.013644977890082122,-9.800700333199583
ZCTA5 47396,2776,0,2776,0,-9.80221373064822
ZCTA5 90277,15724,305,15419,0.01939709997456118,-9.802614520321704
ZCTA5 25427,5580,55,5525,0.00985663082437276,-9.802761194857755
ZCTA5 68467,3880,20,3860,0.005154639175257732,-9.803010398069231
ZCTA5 44663,10273,165,10108,0.016061520490606444,-9.803463089558745
ZCTA5 19333,2778,0,2778,0,-9.805744151699354
ZCTA5 02780,19753,413,19340,0.02090821647344707,-9.805869302653145
ZCTA5 44216,3566,14,3552,0.003925967470555244,-9.806002389725153
ZCTA5 24175,3127,6,3121,0.0019187719859290054,-9.806781461024565
ZCTA5 27596,6622,78,6544,0.011778918755662941,-9.80897134042455
ZCTA5 48505,8469,121,8348,0.014287401109930334,-9.809117073552432
ZCTA5 07450,8344,118,8226,0.01414189837008629,-9.810371207858648
ZCTA5 78634,9300,141,9159,0.015161290322580645,-9.810442196622851
ZCTA5 37650,5070,44,5026,0.008678500986193294,-9.81056248968786
ZCTA5 66085,2781,0,2781,0,-9.811037401289553
ZCTA5 72543,5023,43,4980,0.00856062114274338,-9.81144413436044
ZCTA5 20136,8597,124,8473,0.014423636152146098,-9.812719688105945
ZCTA5 54981,6581,77,6504,0.011700349490958821,-9.81400370736367
ZCTA5 94131,13284,241,13043,0.0181421258657031,-9.814383035179747
ZCTA5 18969,5865,61,5804,0.01040068201193521,-9.818277298185617
ZCTA5 34731,5682,57,5625,0.01003167898627244,-9.818571663709985
ZCTA5 08318,4495,32,4463,0.007119021134593994,-9.818950746931447
ZCTA5 93636,4044,23,4021,0.0056874381800197825,-9.819621036422777
ZCTA5 07732,2787,0,2787,0,-9.82161534226093
ZCTA5 38237,6231,69,6162,0.011073663938372653,-9.824568050779723
ZCTA5 85138,11451,194,11257,0.016941751812068816,-9.82647198949836
ZCTA5 68949,2792,0,2792,0,-9.830421598259623
ZCTA5 66226,4453,31,4422,0.006961598922075006,-9.831389534797292
ZCTA5 70739,4844,39,4805,0.00805119735755574,-9.832209226497213
ZCTA5 78681,17105,341,16764,0.019935691318327974,-9.832298531776742
ZCTA5 34652,10538,171,10367,0.016226988043271967,-9.834640421524732
ZCTA5 37813,6816,82,6734,0.012030516431924883,-9.836103358870487
ZCTA5 30039,14497,272,14225,0.018762502586742086,-9.837293993363328
ZCTA5 65201,16434,323,16111,0.019654375076061822,-9.83807022705215
ZCTA5 48138,4157,25,4132,0.0060139523694972335,-9.838796249316353
ZCTA5 34222,5182,46,5136,0.00887688151292937,-9.83891528063766
ZCTA5 46163,4507,32,4475,0.0071000665631240295,-9.839125047178705
ZCTA5 56701,5510,53,5457,0.009618874773139746,-9.83922581755202
ZCTA5 46635,2798,0,2798,0,-9.840978703429963
ZCTA5 50003,2798,0,2798,0,-9.840978703429963
ZCTA5 17961,2798,0,2798,0,-9.840978703429963
ZCTA5 00678,9033,134,8899,0.014834495737850105,-9.841313852956263
ZCTA5 49083,2975,3,2972,0.0010084033613445378,-9.84160056741221
ZCTA5 10022,18049,366,17683,0.020278131752451658,-9.844126413886597
ZCTA5 70047,4610,34,4576,0.00737527114967462,-9.847005518772697
ZCTA5 53555,3643,15,3628,0.0041174855888004395,-9.847022642974386
ZCTA5 01569,4805,38,4767,0.007908428720083247,-9.847584175295841
ZCTA5 17551,4010,22,3988,0.005486284289276808,-9.84909217761134
ZCTA5 87113,5793,59,5734,0.010184705679268082,-9.849241314872895
ZCTA5 01536,2803,0,2803,0,-9.849767647490781
ZCTA5 48917,14547,273,14274,0.01876675603217158,-9.851390825160252
ZCTA5 55318,10229,163,10066,0.015935086518721282,-9.853558193611358
ZCTA5 08736,4857,39,4818,0.008029647930821495,-9.853745750396284
ZCTA5 02341,3806,18,3788,0.004729374671571204,-9.854978517167815
ZCTA5 06511,21266,453,20813,0.02130160820088404,-9.855456061675154
ZCTA5 22611,3323,9,3314,0.002708396027685826,-9.85632167648525
ZCTA5 35212,4859,39,4820,0.008026342868903066,-9.857055511456645
ZCTA5 44108,9498,145,9353,0.015266371867761634,-9.857374351455128
ZCTA5 22201,19063,393,18670,0.0206158526989456,-9.85756298427328
ZCTA5 54482,3912,20,3892,0.005112474437627812,-9.858018184953034
ZCTA5 16504,6299,70,6229,0.01111287505953326,-9.860724745027674
ZCTA5 32277,11913,205,11708,0.017208092000335767,-9.86107753210792
ZCTA5 25508,3914,20,3894,0.005109862033725089,-9.86144670160615
ZCTA5 92629,11439,193,11246,0.016872104204913016,-9.86274692866117
ZCTA5 31211,6302,70,6232,0.011107584893684545,-9.865408085539366
ZCTA5 74133,19403,402,19001,0.020718445601195692,-9.865610094069247
ZCTA5 45406,9051,134,8917,0.014804993923323389,-9.866722797588205
ZCTA5 98942,6303,70,6233,0.011105822624147232,-9.866968827820708
ZCTA5 44090,4720,36,4684,0.007627118644067797,-9.867572070100586
ZCTA5 62294,5203,46,5157,0.008841053238516241,-9.873203132097501
ZCTA5 07081,6972,85,6887,0.01219162363740677,-9.873218103713112
ZCTA5 37617,5438,51,5387,0.009378447958808385,-9.873326547420335
ZCTA5 03773,3165,6,3159,0.0018957345971563982,-9.8733960961681
ZCTA5 18302,5900,61,5839,0.010338983050847458,-9.873884761002877
ZCTA5 29620,4966,41,4925,0.008256141763995167,-9.874939209879724
ZCTA5 45502,6354,71,6283,0.011174063581995594,-9.876556673594944
ZCTA5 37743,9962,156,9806,0.01565950612326842,-9.877070226913617
ZCTA5 33981,4530,32,4498,0.00706401766004415,-9.877691346198306
ZCTA5 37914,8475,120,8355,0.01415929203539823,-9.878177436408643
ZCTA5 53403,10450,168,10282,0.016076555023923446,-9.879010482429136
ZCTA5 05753,3665,15,3650,0.004092769440654843,-9.885031973150275
ZCTA5 83201,13767,252,13515,0.01830464153410329,-9.885171167101312
ZCTA5 29118,6360,71,6289,0.011163522012578616,-9.885893891001876
ZCTA5 80513,4780,37,4743,0.007740585774058577,-9.886465453710706
ZCTA5 17201,10979,181,10798,0.016486018763093177,-9.887377075439897
ZCTA5 48855,5587,54,5533,0.009665294433506354,-9.888441446821634
ZCTA5 02762,3560,13,3547,0.003651685393258427,-9.888758593893375
ZCTA5 32136,3721,16,3705,0.00429991937651169,-9.889994434702109
ZCTA5 24540,13734,251,13483,0.018275811853793504,-9.89210540738516
ZCTA5 33778,6003,63,5940,0.010494752623688156,-9.892582551747854
ZCTA5 39154,3399,10,3389,0.0029420417769932335,-9.892643524011937
ZCTA5 17345,3454,11,3443,0.0031847133757961785,-9.893047112831628
ZCTA5 34639,9606,147,9459,0.015302935665209244,-9.893330115910677
ZCTA5 52317,7679,101,7578,0.01315275426487824,-9.893352959394276
ZCTA5 28207,3776,17,3759,0.004502118644067797,-9.89372126534797
ZCTA5 76801,9155,136,9019,0.014855270344074276,-9.896495370620848
ZCTA5 02494,3672,15,3657,0.004084967320261438,-9.897096694427733
ZCTA5 68901,10625,172,10453,0.016188235294117646,-9.89736773744409
ZCTA5 62203,2832,0,2832,0,-9.900589666534072
ZCTA5 14216,10507,169,10338,0.016084515085181307,-9.901379074151837
ZCTA5 67530,7728,102,7626,0.013198757763975156,-9.902377799289598
ZCTA5 76182,11071,183,10888,0.01652967211633999,-9.90317381860292
ZCTA5 45327,3569,13,3556,0.0036424768842813113,-9.90430986484363
ZCTA5 77703,4984,41,4943,0.008226324237560192,-9.904526020623596
ZCTA5 18407,5783,58,5725,0.010029396507003286,-9.906417218213106
ZCTA5 35756,4890,39,4851,0.007975460122699387,-9.908236472088651
ZCTA5 11792,2837,0,2837,0,-9.909325739588708
ZCTA5 16866,3572,13,3559,0.003639417693169093,-9.909488407656424
ZCTA5 22310,11437,192,11245,0.01678761913089097,-9.912130421594604
ZCTA5 64024,6377,71,6306,0.011133761957033087,-9.91231350747388
ZCTA5 16502,6869,82,6787,0.011937691075848012,-9.917054720024524
ZCTA5 46617,3684,15,3669,0.004071661237785016,-9.917746541819575
ZCTA5 03743,5652,55,5597,0.009731068648266101,-9.918297728068591
ZCTA5 30030,11800,201,11599,0.017033898305084744,-9.919427064403466
ZCTA5 01473,2844,0,2844,0,-9.921543318896857
ZCTA5 98021,10724,174,10550,0.016225289071242075,-9.922031916661254
ZCTA5 62208,7006,85,6921,0.012132457893234371,-9.92480322893764
ZCTA5 67230,3847,18,3829,0.004678970626462178,-9.925303129363352
ZCTA5 38340,4510,31,4479,0.006873614190687362,-9.926971446444186
ZCTA5 02571,4461,30,4431,0.006724949562878279,-9.928115955419816
ZCTA5 48207,11609,196,11413,0.016883452493754846,-9.92896423177046
ZCTA5 53963,5144,44,5100,0.008553654743390357,-9.931694338971571
ZCTA5 28574,6345,70,6275,0.01103230890464933,-9.932353207568399
ZCTA5 55424,3478,11,3467,0.0031627372052903968,-9.934565783904278
ZCTA5 08205,10412,166,10246,0.015943142527852477,-9.936737665257267
ZCTA5 01588,3534,12,3522,0.003395585738539898,-9.937247076813186
ZCTA5 68007,3589,13,3576,0.003622178879910839,-9.938784470685992
ZCTA5 61114,6529,74,6455,0.01133404809312299,-9.939752157394842
ZCTA5 32641,4715,35,4680,0.007423117709437964,-9.940243982956515
ZCTA5 61356,4666,34,4632,0.007286755250750107,-9.940257834385031
ZCTA5 45430,2855,0,2855,0,-9.94071203379183
ZCTA5 20695,2855,0,2855,0,-9.94071203379183
ZCTA5 90048,12054,207,11847,0.01717272274763564,-9.940857859730434
ZCTA5 39759,16562,324,16238,0.019562854727689892,-9.941808335346114
ZCTA5 27870,10739,174,10565,0.016202625942825215,-9.942029276836978
ZCTA5 11720,8855,128,8727,0.01445511010728402,-9.942402842557389
ZCTA5 01504,3428,10,3418,0.0029171528588098016,-9.942859334054363
ZCTA5 61523,4420,29,4391,0.006561085972850679,-9.942970987971224
ZCTA5 91711,11938,204,11734,0.017088289495727927,-9.9442129546181
ZCTA5 30643,6173,66,6107,0.010691722015227605,-9.945617809418513
ZCTA5 14622,5623,54,5569,0.009603414547394629,-9.946053098379217
ZCTA5 60517,12689,223,12466,0.017574276932776422,-9.947789567435262
ZCTA5 70607,11145,184,10961,0.016509645580978016,-9.94797308364766
ZCTA5 80227,15087,285,14802,0.018890435474249352,-9.948090157825106
ZCTA5 28043,8440,118,8322,0.013981042654028436,-9.948826204675191
ZCTA5 49048,9933,154,9779,0.015503875968992248,-9.948940915831065
ZCTA5 02719,6491,73,6418,0.011246341087659836,-9.950080781384392
ZCTA5 07932,3966,20,3946,0.005042864346949067,-9.950202230405203
ZCTA5 67002,5108,43,5065,0.008418167580266249,-9.950730241553416
ZCTA5 55433,13514,244,13270,0.018055350007399735,-9.955080696023671
ZCTA5 50325,6539,74,6465,0.011316715094051077,-9.95515582350085
ZCTA5 15906,4919,39,4880,0.007928440739987802,-9.955912411955016
ZCTA5 40509,16348,318,16030,0.019451920724247614,-9.95624850427607
ZCTA5 16226,3381,9,3372,0.0026619343389529724,-9.956990063167098
ZCTA5 48374,5112,43,5069,0.008411580594679186,-9.957244673675028
ZCTA5 08096,13749,250,13499,0.018183140592043057,-9.95793468647361
ZCTA5 92270,9406,141,9265,0.01499043163937912,-9.958344318790457
ZCTA5 26836,2867,0,2867,0,-9.961581291262911
ZCTA5 61607,4230,25,4205,0.00591016548463357,-9.962346963004986
ZCTA5 57785,4025,21,4004,0.0052173913043478265,-9.962365249149032
ZCTA5 52627,5165,44,5121,0.008518877057115199,-9.965845889042038
ZCTA5 62034,5589,53,5536,0.009482912864555377,-9.96603596863487
ZCTA5 64138,10313,163,10150,0.01580529428876176,-9.967233981666698
ZCTA5 52804,10799,175,10624,0.01620520418557274,-9.968274234637049
ZCTA5 17015,7988,107,7881,0.013395092638958437,-9.969992846458478
ZCTA5 31401,8031,108,7923,0.013447889428464699,-9.970479340041134
ZCTA5 32534,6144,65,6079,0.010579427083333334,-9.971178231314125
ZCTA5 32333,4735,35,4700,0.007391763463569166,-9.97330213948627
ZCTA5 33458,21197,448,20749,0.02113506628296457,-9.974296090740795
ZCTA5 34120,10156,159,9997,0.015655769988184326,-9.974873408712597
ZCTA5 89117,23095,500,22595,0.021649707728945658,-9.976340382386432
ZCTA5 30318,21677,461,21216,0.021266780458550537,-9.978752620094212
ZCTA5 27377,3339,8,3331,0.002395926924228811,-9.980432253224908
ZCTA5 10589,3722,15,3707,0.004030091348737238,-9.982869081446493
ZCTA5 04412,3669,14,3655,0.0038157536113382394,-9.983737668795708
ZCTA5 29078,6290,68,6222,0.010810810810810811,-9.98690336827881
ZCTA5 37072,12681,222,12459,0.017506505796072866,-9.987094102997473
ZCTA5 18055,4793,36,4757,0.007510953473815982,-9.988309947682296
ZCTA5 87048,3938,19,3919,0.004824784154393093,-9.991121459192579
ZCTA5 22546,6157,65,6092,0.010557089491635537,-9.99146888658274
ZCTA5 23072,4648,33,4615,0.0070998278829604135,-9.991937158815189
ZCTA5 08619,8597,121,8476,0.014074677212981272,-9.992652736865299
ZCTA5 32766,5134,43,5091,0.008375535644721465,-9.9930103476152
ZCTA5 43619,2886,0,2886,0,-9.994535162856574
ZCTA5 97302,15851,304,15547,0.01917860071919753,-9.995104299360206
ZCTA5 22307,4504,30,4474,0.0066607460035523975,-9.999812136418443
ZCTA5 13057,6164,65,6099,0.01054510058403634,-10.002381496610534
ZCTA5 48895,4507,30,4477,0.006656312402928777,-10.00479714209664
ZCTA5 63755,9357,139,9218,0.014855188628834028,-10.00512397343414
ZCTA5 28516,5094,42,5052,0.008244994110718492,-10.005818783595547
ZCTA5 08833,3242,6,3236,0.001850709438618137,-10.007034181253502
ZCTA5 53220,11470,191,11279,0.016652136006974717,-10.007112134798637
ZCTA5 47167,5849,58,5791,0.009916224995725765,-10.01091942469121
ZCTA5 03842,7108,86,7022,0.012099043331457513,-10.012456042103764
ZCTA5 32132,3302,7,3295,0.0021199273167777106,-10.01317910141605
ZCTA5 68048,4954,39,4915,0.007872426322163908,-10.013194188805997
ZCTA5 48360,4463,29,4434,0.006497871386959444,-10.014704236666914
ZCTA5 48206,6218,66,6152,0.01061434544869733,-10.015733919788559
ZCTA5 60410,4160,23,4137,0.005528846153846154,-10.016344771895612
ZCTA5 36526,12665,221,12444,0.0174496644295302,-10.016365405145233
ZCTA5 15139,3192,5,3187,0.0015664160401002505,-10.018889801232792
ZCTA5 55038,7809,102,7707,0.013061851709565886,-10.021417366753006
ZCTA5 18657,4862,37,4825,0.007610037021801728,-10.021527555953055
ZCTA5 51012,2902,0,2902,0,-10.022201749106694
ZCTA5 32117,9823,150,9673,0.015270284027282907,-10.022448050690972
ZCTA5 37725,6586,74,6512,0.011235955056179775,-10.027316553498475
ZCTA5 28326,7208,88,7120,0.01220865704772475,-10.030887958439974
ZCTA5 29302,6724,77,6647,0.011451516954193932,-10.033526833140293
ZCTA5 35068,3315,7,3308,0.0021116138763197585,-10.03553258445131
ZCTA5 01028,5957,60,5897,0.010072183985227464,-10.035980703602407
ZCTA5 60523,4477,29,4448,0.006477551932097387,-10.037960335037054
ZCTA5 49006,10204,159,10045,0.015582124656997256,-10.039788364680163
ZCTA5 17870,5544,51,5493,0.0091991341991342,-10.043338465755882
ZCTA5 91011,6597,74,6523,0.011217219948461421,-10.044149300930053
ZCTA5 18644,3207,5,3202,0.0015590894917368258,-10.044710177154004
ZCTA5 54971,4483,29,4454,0.006468882444791434,-10.047912490647656
ZCTA5 53563,4282,25,4257,0.005838393274170948,-10.049512377775548
ZCTA5 61727,4078,21,4057,0.005149583128984796,-10.051822150942886
ZCTA5 60605,13865,251,13614,0.01810313739632167,-10.052241719668823
ZCTA5 34236,7003,83,6920,0.011852063401399401,-10.053167315233647
ZCTA5 43906,3437,9,3428,0.002618562700029095,-10.053251263613461
ZCTA5 75087,11746,197,11549,0.01677166695045122,-10.054753411946107
ZCTA5 45044,19988,413,19575,0.020662397438463077,-10.057296198159932
ZCTA5 90254,8979,129,8850,0.014366855997327097,-10.058280819644278
ZCTA5 98550,4738,34,4704,0.007176023638666104,-10.059044145239058
ZCTA5 70471,7879,103,7776,0.013072724965097093,-10.060865900567098
ZCTA5 33594,12663,220,12443,0.017373450209271106,-10.063268912053003
ZCTA5 84010,15185,285,14900,0.018768521567336188,-10.06389319843532
ZCTA5 53146,3161,4,3157,0.0012654223347042075,-10.064229836616668
ZCTA5 53085,4986,39,4947,0.007821901323706379,-10.065322059147368
ZCTA5 16428,4986,39,4947,0.007821901323706379,-10.065322059147368
ZCTA5 35062,2928,0,2928,0,-10.066997785556827
ZCTA5 66618,3557,11,3546,0.003092493674444757,-10.070057746928704
ZCTA5 32246,20148,417,19731,0.020696843359142347,-10.070278818177995
ZCTA5 14502,4141,22,4119,0.005312726394590679,-10.07078581076951
ZCTA5 19522,5420,48,5372,0.008856088560885609,-10.070833748234648
ZCTA5 49009,18741,379,18362,0.02022304039272184,-10.073005147084288
ZCTA5 01460,3559,11,3548,0.0030907558302894073,-10.073464954028621
ZCTA5 49224,5185,43,5142,0.008293153326904532,-10.075511030836664
ZCTA5 28804,8740,123,8617,0.014073226544622426,-10.076171627216008
ZCTA5 80026,12041,204,11837,0.016942114442322066,-10.076220292968646
ZCTA5 74105,12160,207,11953,0.017023026315789475,-10.076270680585425
ZCTA5 60950,4501,29,4472,0.006443012663852477,-10.077716159569093
ZCTA5 54409,5707,54,5653,0.009462064131768004,-10.079451258858324
ZCTA5 02382,5379,47,5332,0.00873768358430935,-10.080963613066128
ZCTA5 13041,4250,24,4226,0.005647058823529412,-10.08125789578733
ZCTA5 60619,26234,584,25650,0.022261187771594113,-10.081944386454664
ZCTA5 32095,3784,15,3769,0.003964059196617336,-10.088260406457275
ZCTA5 35652,3514,10,3504,0.0028457598178713715,-10.090342884590351
ZCTA5 35759,2942,0,2942,0,-10.091036361313403
ZCTA5 80831,8158,109,8049,0.013361117921059084,-10.092589811414383
ZCTA5 75115,18722,378,18344,0.020190150624933234,-10.092924242965793
ZCTA5 06035,2946,0,2946,0,-10.097894015085743
ZCTA5 21617,3628,12,3616,0.0033076074972436605,-10.098008408365121
ZCTA5 53182,3409,8,3401,0.0023467292461132297,-10.100480589828758
ZCTA5 70003,15942,304,15638,0.019069125580228326,-10.100622791322039
ZCTA5 54656,7167,86,7081,0.011999441886423887,-10.10081625908156
ZCTA5 63080,5721,54,5667,0.009438909281594127,-10.101546376263743
ZCTA5 00703,8464,116,8348,0.013705103969754254,-10.104138288414623
ZCTA5 26041,6093,62,6031,0.010175611357295257,-10.104999654663345
ZCTA5 01562,4865,36,4829,0.0073997944501541625,-10.106169108298472
ZCTA5 29835,2951,0,2951,0,-10.106459538735534
ZCTA5 21793,3633,12,3621,0.0033030553261767133,-10.106490256681866
ZCTA5 99026,3469,9,3460,0.0025944076102623233,-10.107854733011555
ZCTA5 39563,5206,43,5163,0.008259700345754899,-10.109317066050847
ZCTA5 15003,5110,41,5069,0.00802348336594912,-10.109578267022924
ZCTA5 48079,4917,37,4880,0.007524913565182021,-10.111245224886465
ZCTA5 15214,6006,60,5946,0.00999000999000999,-10.112587478977195
ZCTA5 08550,6507,71,6436,0.01091132626402336,-10.11262213772379
ZCTA5 33556,7958,104,7854,0.013068610203568736,-10.113219818510972
ZCTA5 32073,15574,294,15280,0.018877616540387825,-10.116270801179812
ZCTA5 50702,8388,114,8274,0.013590844062947067,-10.116867500471798
ZCTA5 35180,5164,42,5122,0.008133230054221533,-10.118996560724256
ZCTA5 02649,6240,65,6175,0.010416666666666666,-10.120275821940785
ZCTA5 33455,9854,149,9705,0.01512076314187132,-10.120791604559487
ZCTA5 20653,9441,139,9302,0.014723016629594323,-10.121351459116187
ZCTA5 05452,8816,124,8692,0.014065335753176044,-10.124006454433223
ZCTA5 02465,4227,23,4204,0.005441211260941566,-10.128368246377264
ZCTA5 64151,11203,182,11021,0.016245648487012408,-10.129217041238093
ZCTA5 03901,2966,0,2966,0,-10.13211266284976
ZCTA5 44505,7672,97,7575,0.012643378519290928,-10.136959188856215
ZCTA5 28138,3760,14,3746,0.003723404255319149,-10.138280991359098
ZCTA5 98908,14556,267,14289,0.018342951360263808,-10.138785629229112
ZCTA5 27040,4589,30,4559,0.006537371976465461,-10.140207734452881
ZCTA5 33301,7675,97,7578,0.012638436482084691,-10.141348667643108
ZCTA5 44857,9540,141,9399,0.014779874213836478,-10.143396764005372
ZCTA5 67114,8620,119,8501,0.013805104408352668,-10.145195875288218
ZCTA5 48356,3266,5,3261,0.0015309246785058174,-10.145637763942629
ZCTA5 33980,5796,55,5741,0.009489302967563838,-10.146208844655154
ZCTA5 36111,4841,35,4806,0.007229911175376988,-10.146943106674689
ZCTA5 01949,2975,0,2975,0,-10.147473408461323
ZCTA5 19609,4031,19,4012,0.004713470602828083,-10.147710707481405
ZCTA5 19702,19444,396,19048,0.020366179798395393,-10.149193853121758
ZCTA5 95831,18587,373,18214,0.020067789315112713,-10.149240470279167
ZCTA5 59501,5139,41,5098,0.007978205876629695,-10.156274667386429
ZCTA5 78628,11546,190,11356,0.01645591546856054,-10.157463708364991
ZCTA5 32317,5333,45,5288,0.008438027376711045,-10.159460847365288
ZCTA5 03052,2983,0,2983,0,-10.161107910289116
ZCTA5 60007,13411,237,13174,0.017672060249049288,-10.163913757696918
ZCTA5 44805,12704,219,12485,0.01723866498740554,-10.164031302004354
ZCTA5 32607,11911,199,11712,0.016707245403408615,-10.164227623183894
ZCTA5 70809,11069,178,10891,0.016080946788327763,-10.164820740692004
ZCTA5 62568,6587,72,6515,0.010930620919993927,-10.165888294583132
ZCTA5 12095,4903,36,4867,0.007342443401998776,-10.167893846975792
ZCTA5 40514,5996,59,5937,0.009839893262174782,-10.16880846428725
ZCTA5 43725,8212,109,8103,0.013273258645884072,-10.17021420255388
ZCTA5 78737,5341,45,5296,0.008425388504025463,-10.172214746814678
ZCTA5 11764,4100,20,4080,0.004878048780487805,-10.175589092159044
ZCTA5 53086,3284,5,3279,0.0015225334957369061,-10.176231484515663
ZCTA5 43113,9398,137,9261,0.014577569695679932,-10.176688313708365
ZCTA5 08048,4662,31,4631,0.006649506649506649,-10.177964334244546
ZCTA5 18034,2993,0,2993,0,-10.178125352977732
ZCTA5 07078,4050,19,4031,0.004691358024691358,-10.179423883872294
ZCTA5 40601,21211,443,20768,0.020885389656310406,-10.17980824931225
ZCTA5 33990,11404,186,11218,0.01631006664328306,-10.1814243333729
ZCTA5 51031,5010,38,4972,0.007584830339321357,-10.182834503457016
ZCTA5 38004,3458,8,3450,0.002313475997686524,-10.183686831690551
ZCTA5 31302,3346,6,3340,0.0017931858936043037,-10.18477909734871
ZCTA5 33543,8944,126,8818,0.014087656529516995,-10.185497916378372
ZCTA5 23430,6914,79,6835,0.0114260919872722,-10.186054727368143
ZCTA5 37406,5683,52,5631,0.009150096779869787,-10.189021019250108
ZCTA5 46615,5495,48,5447,0.008735213830755232,-10.190101672967868
ZCTA5 28144,9491,139,9352,0.014645453587609315,-10.19013938835286
ZCTA5 10598,10521,164,10357,0.015587871875297026,-10.19126660623868
ZCTA5 78163,3738,13,3725,0.0034777956126270733,-10.192085298260453
ZCTA5 02093,4162,21,4141,0.005045651129264777,-10.192107364187008
ZCTA5 07405,6242,64,6178,0.01025312399871836,-10.193752384499584
ZCTA5 48912,7799,99,7700,0.012693935119887164,-10.19568783934582
ZCTA5 53406,10932,174,10758,0.015916575192096598,-10.19729435097811
ZCTA5 32726,8657,119,8538,0.013746101420815525,-10.197475474861085
ZCTA5 63031,17544,344,17200,0.0196078431372549,-10.199162822519586
ZCTA5 50138,4974,37,4937,0.007438681141938078,-10.203504340780775
ZCTA5 56501,7281,87,7194,0.011948908117016894,-10.204811826985816
ZCTA5 72012,4729,32,4697,0.006766758299851977,-10.205999695628176
ZCTA5 50112,4681,31,4650,0.006622516556291391,-10.208952618778735
ZCTA5 04105,4633,30,4603,0.006475285991797971,-10.212205739497103
ZCTA5 99019,4533,28,4505,0.006176924773880432,-10.213104563088164
ZCTA5 40272,14232,257,13975,0.018057897695334457,-10.214425301026019
ZCTA5 62258,3364,6,3358,0.0017835909631391202,-10.215231959184626
ZCTA5 01863,3860,15,3845,0.0038860103626943004,-10.216032348199901
ZCTA5 89130,12549,214,12335,0.017053151645549446,-10.217405338197112
ZCTA5 47620,5322,44,5278,0.008267568583239383,-10.218132267936536
ZCTA5 83404,8715,120,8595,0.013769363166953529,-10.219502426380517
ZCTA5 30904,10174,155,10019,0.015234912522115196,-10.219780752108997
ZCTA5 35173,9430,137,9293,0.014528101802757157,-10.220713513635244
ZCTA5 33777,7115,83,7032,0.011665495432185523,-10.220755364801404
ZCTA5 02536,7990,103,7887,0.012891113892365457,-10.221764556084363
ZCTA5 65721,11234,181,11053,0.016111803453800963,-10.222113655381564
ZCTA5 78756,4336,24,4312,0.005535055350553505,-10.223760342545322
ZCTA5 15425,8164,107,8057,0.013106320431161195,-10.224329973574548
ZCTA5 13323,4077,19,4058,0.004660289428501349,-10.224330954551016
ZCTA5 54022,8165,107,8058,0.013104715248009798,-10.225762752401302
ZCTA5 40330,7994,103,7891,0.012884663497623218,-10.22753011575916
ZCTA5 35986,3142,2,3140,6.365372374283895e-4,-10.22997420379462
ZCTA5 29526,16287,310,15977,0.01903358506784552,-10.23455494684169
ZCTA5 33759,7785,98,7687,0.012588310854206808,-10.238359589847368
ZCTA5 36874,3029,0,3029,0,-10.239153966609003
ZCTA5 75071,16901,326,16575,0.01928879947932075,-10.241173405012715
ZCTA5 28262,15950,301,15649,0.018871473354231973,-10.24197463002708
ZCTA5 23120,3032,0,3032,0,-10.244223273281447
ZCTA5 78108,11655,191,11464,0.016387816387816386,-10.246181517413211
ZCTA5 30673,3034,0,3034,0,-10.247601417898672
ZCTA5 17368,3034,0,3034,0,-10.247601417898672
ZCTA5 85233,12613,215,12398,0.017045905018631572,-10.247952561845716
ZCTA5 28431,3035,0,3035,0,-10.249290072671261
ZCTA5 02347,3987,17,3970,0.004263857536995234,-10.250054853986903
ZCTA5 15227,11739,193,11546,0.016440923417667605,-10.251039824062463
ZCTA5 08035,3037,0,3037,0,-10.252666547832092
ZCTA5 53925,3215,3,3212,9.331259720062209e-4,-10.254610634991293
ZCTA5 18106,3039,0,3039,0,-10.256041911396075
ZCTA5 18643,5203,41,5162,0.007880069190851432,-10.258687027233458
ZCTA5 43021,3940,16,3924,0.0040609137055837565,-10.260301721819332
ZCTA5 58075,3994,17,3977,0.004256384576865298,-10.261675343393097
ZCTA5 42501,7143,83,7060,0.011619767604647908,-10.262339088227309
ZCTA5 06357,4714,31,4683,0.006576156130674586,-10.262576139746384
ZCTA5 28532,8191,107,8084,0.01306311805640337,-10.262966971543937
ZCTA5 77479,28469,641,27828,0.022515718852084723,-10.263801293977354
ZCTA5 04240,15779,296,15483,0.018759110209772483,-10.265416811812274
ZCTA5 24901,4464,26,4438,0.005824372759856631,-10.266069153704041
ZCTA5 74604,5015,37,4978,0.007377866400797607,-10.269421188495444
ZCTA5 27892,5829,54,5775,0.009264024704065878,-10.27070076920867
ZCTA5 97211,13302,232,13070,0.017440986317846942,-10.27073340430318
ZCTA5 85710,25061,546,24515,0.02178684011013128,-10.271568737591577
ZCTA5 35960,4158,20,4138,0.00481000481000481,-10.271710307463549
ZCTA5 37087,17006,328,16678,0.01928731036104904,-10.274016486325072
ZCTA5 48879,6794,75,6719,0.011039152193111568,-10.274638345984547
ZCTA5 16901,4055,18,4037,0.0044389642416769425,-10.275084898437038
ZCTA5 30309,14400,260,14140,0.018055555555555554,-10.27609892460394
ZCTA5 11795,7899,100,7799,0.0126598303582732,-10.277701370776947
ZCTA5 23664,4004,17,3987,0.004245754245754246,-10.27825441139327
ZCTA5 55387,4775,32,4743,0.006701570680628272,-10.280567963045964
ZCTA5 14032,3054,0,3054,0,-10.281321816424912
ZCTA5 30028,8376,111,8265,0.01325214899713467,-10.282009617680421
ZCTA5 38109,16523,315,16208,0.019064334563941174,-10.286457140720175
ZCTA5 55316,8976,125,8851,0.01392602495543672,-10.288861617064272
ZCTA5 01880,10556,163,10393,0.01544145509662751,-10.29186134236018
ZCTA5 22508,5420,45,5375,0.008302583025830259,-10.297446716162028
ZCTA5 50677,4586,28,4558,0.006105538595726123,-10.299521074641703
ZCTA5 19131,17446,339,17107,0.0194313882838473,-10.300248740757185
ZCTA5 18252,4637,29,4608,0.006254043562648264,-10.300395134218794
ZCTA5 40242,4588,28,4560,0.006102877070619006,-10.302769239949907
ZCTA5 47501,6858,76,6782,0.011081948089822106,-10.303209876717709
ZCTA5 75032,10973,173,10800,0.015765971019775813,-10.30413168590718
ZCTA5 70818,3641,10,3631,0.0027464982147761604,-10.304371293660061
ZCTA5 61704,14773,269,14504,0.018208894605022678,-10.304692358968843
ZCTA5 40222,9952,148,9804,0.01487138263665595,-10.309344275042003
ZCTA5 94930,3810,13,3797,0.0034120734908136482,-10.312335151840273
ZCTA5 08840,5997,57,5940,0.009504752376188095,-10.313986718484488
ZCTA5 72205,10696,166,10530,0.015519820493642483,-10.314813857554034
ZCTA5 44047,3424,6,3418,0.0017523364485981308,-10.316098821822893
ZCTA5 49546,12866,220,12646,0.01709933157158402,-10.316521461548257
ZCTA5 54304,12311,206,12105,0.01673300300544229,-10.317594566417458
ZCTA5 08312,3076,0,3076,0,-10.318286975702335
ZCTA5 16055,3311,4,3307,0.0012080942313500453,-10.31859760300991
ZCTA5 30328,16437,312,16125,0.018981565979193284,-10.31866434964134
ZCTA5 07874,3078,0,3078,0,-10.32164088021987
ZCTA5 48328,11030,174,10856,0.015775158658204894,-10.32549372846673
ZCTA5 25560,3081,0,3081,0,-10.326669694588979
ZCTA5 01907,5535,47,5488,0.008491418247515809,-10.327989749933844
ZCTA5 75054,3082,0,3082,0,-10.328345421933816
ZCTA5 11501,7586,92,7494,0.012127603480094912,-10.32980501865467
ZCTA5 85086,14642,265,14377,0.018098620407048217,-10.333107742408565
ZCTA5 06498,3086,0,3086,0,-10.335045614284265
ZCTA5 20646,7281,85,7196,0.011674220574096965,-10.33515780272168
ZCTA5 08848,3087,0,3087,0,-10.336719983775087
ZCTA5 16063,3088,0,3088,0,-10.338394082090993
ZCTA5 92037,17064,328,16736,0.01922175339896859,-10.339145271567533
ZCTA5 53098,4661,29,4632,0.006221840806693842,-10.339243238688464
ZCTA5 43023,4041,17,4024,0.004206879485275922,-10.339377445279812
ZCTA5 28012,8631,116,8515,0.013439925848684973,-10.340335282005647
ZCTA5 34243,13399,233,13166,0.017389357414732444,-10.341347915002542
ZCTA5 01226,3090,0,3090,0,-10.341741465724796
ZCTA5 60022,3091,0,3091,0,-10.3434147513058
ZCTA5 25302,6795,74,6721,0.010890360559234731,-10.343602642352188
ZCTA5 08505,6930,77,6853,0.011111111111111112,-10.343652866343788
ZCTA5 12306,9058,126,8932,0.013910355486862442,-10.344044993916349
ZCTA5 55947,3210,2,3208,6.230529595015577e-4,-10.344330137002576
ZCTA5 29588,16993,326,16667,0.019184370034720177,-10.34471371329819
ZCTA5 15215,5403,44,5359,0.008143623912641125,-10.346262859378681
ZCTA5 11949,5014,36,4978,0.007179896290386917,-10.346354234538026
ZCTA5 34275,9229,130,9099,0.014086033156354968,-10.34737275616852
ZCTA5 60148,20300,414,19886,0.02039408866995074,-10.348077828633855
ZCTA5 33896,3097,0,3097,0,-10.353448785760389
ZCTA5 43566,3097,0,3097,0,-10.353448785760389
ZCTA5 69001,3781,12,3769,0.003173763554615181,-10.35450457521074
ZCTA5 26241,5742,51,5691,0.008881922675026124,-10.354783470709075
ZCTA5 02476,7250,84,7166,0.011586206896551723,-10.354808199573654
ZCTA5 48359,3616,9,3607,0.002488938053097345,-10.35506450452865
ZCTA5 48134,7910,99,7811,0.012515802781289507,-10.356090741593684
ZCTA5 01060,6486,67,6419,0.010329941412272586,-10.356675371484094
ZCTA5 32904,11824,193,11631,0.016322733423545333,-10.3595562336285
ZCTA5 31820,3787,12,3775,0.0031687351465540005,-10.364437849029413
ZCTA5 32043,9032,125,8907,0.013839681133746678,-10.366540865480736
ZCTA5 84029,3106,0,3106,0,-10.368481630504654
ZCTA5 20736,3106,0,3106,0,-10.368481630504654
ZCTA5 48638,5562,47,5515,0.00845019777058612,-10.370245211280352
ZCTA5 18801,3457,6,3451,0.0017356089094590686,-10.3711615896325
ZCTA5 13850,8653,116,8537,0.013405755229400207,-10.371182026181625
ZCTA5 83706,13700,240,13460,0.017518248175182483,-10.372961930331055
ZCTA5 38732,6452,66,6386,0.01022938623682579,-10.37441196289201
ZCTA5 44004,13151,226,12925,0.017185004942589916,-10.375521141619037
ZCTA5 29203,15033,274,14759,0.018226568216590168,-10.382925795076831
ZCTA5 06614,12722,215,12507,0.016899858512812452,-10.38374578795602
ZCTA5 75230,13237,228,13009,0.017224446626879202,-10.384155254099838
ZCTA5 63025,4989,35,4954,0.007015433954700341,-10.38512890920573
ZCTA5 44026,4438,24,4414,0.005407841369986481,-10.39044250407835
ZCTA5 35901,7540,90,7450,0.011936339522546418,-10.390798033210043
ZCTA5 64801,14847,269,14578,0.01811813834444669,-10.39196666557561
ZCTA5 62629,5190,39,5151,0.007514450867052023,-10.392341848940266
ZCTA5 99338,5336,42,5294,0.007871064467766116,-10.392634819185007
ZCTA5 46808,8159,104,8055,0.012746660129917882,-10.401863613115978
ZCTA5 51360,4030,16,4014,0.003970223325062035,-10.408842958569593
ZCTA5 97338,8121,103,8018,0.012683167097648072,-10.40943189434376
ZCTA5 71635,4756,30,4726,0.006307821698906644,-10.411103327311295
ZCTA5 06234,3132,0,3132,0,-10.411787926995116
ZCTA5 16701,7334,85,7249,0.011589855467684755,-10.412884293630759
ZCTA5 07005,5495,45,5450,0.00818926296633303,-10.41516283331467
ZCTA5 14220,9907,145,9762,0.014636115877662259,-10.416235094555935
ZCTA5 47408,8856,120,8736,0.013550135501355014,-10.416571479500472
ZCTA5 06076,5009,35,4974,0.0069874226392493514,-10.416948978856533
ZCTA5 53597,7159,81,7078,0.01131442938957955,-10.417497704376096
ZCTA5 80424,3136,0,3136,0,-10.418434456830663
ZCTA5 92120,11387,181,11206,0.01589531922367612,-10.419955356386636
ZCTA5 03766,4250,20,4230,0.004705882352941176,-10.422473334864936
ZCTA5 40047,7653,92,7561,0.012021429504769372,-10.42697464479217
ZCTA5 44017,7167,81,7086,0.011301799916282964,-10.429262616223397
ZCTA5 08028,6489,66,6423,0.010171058714748035,-10.430245446045625
ZCTA5 15042,3774,11,3763,0.0029146793852676206,-10.43342774068608
ZCTA5 48040,4205,19,4186,0.004518430439952438,-10.434747036480847
ZCTA5 45243,5508,45,5463,0.008169934640522876,-10.435452855198799
ZCTA5 26105,5122,37,5085,0.007223740726278798,-10.439739122258114
ZCTA5 02056,3149,0,3149,0,-10.440006455389808
ZCTA5 53018,3150,0,3150,0,-10.44166399393409
ZCTA5 60540,16048,299,15749,0.01863160518444666,-10.44237506978658
ZCTA5 02828,3151,0,3151,0,-10.443321269397893
ZCTA5 38261,6682,70,6612,0.010475905417539658,-10.445641306597784
ZCTA5 20147,22097,460,21637,0.020817305516585963,-10.446525299728446
ZCTA5 44132,6638,69,6569,0.01039469719795119,-10.447987390785729
ZCTA5 59937,5897,53,5844,0.008987620824147871,-10.4484733510782
ZCTA5 50327,4266,20,4246,0.0046882325363338025,-10.448484500907277
ZCTA5 99212,8624,114,8510,0.013218923933209647,-10.450274881676709
ZCTA5 76354,4883,32,4851,0.006553348351423305,-10.453779506799215
ZCTA5 25303,3158,0,3158,0,-10.454914841897567
ZCTA5 07945,3159,0,3159,0,-10.456570017217349
ZCTA5 29485,19697,395,19302,0.02005381530182261,-10.458804749674083
ZCTA5 15417,3453,5,3448,0.0014480162177816392,-10.459140590758091
ZCTA5 14228,9437,133,9304,0.014093461905266504,-10.459312571279924
ZCTA5 46036,4736,29,4707,0.006123310810810811,-10.459803833404758
ZCTA5 29180,5574,46,5528,0.008252601363473269,-10.463466075931215
ZCTA5 43056,7101,79,7022,0.011125193634699338,-10.463892299763438
ZCTA5 02563,3902,13,3889,0.0033316248077908763,-10.464044755334147
ZCTA5 23114,6967,76,6891,0.010908568967991961,-10.46524496499219
ZCTA5 04092,8031,100,7931,0.012451749470800648,-10.466921116855511
ZCTA5 45177,9065,124,8941,0.013678985107556536,-10.470546428993385
ZCTA5 15204,3630,8,3622,0.0022038567493112946,-10.470608889363225
ZCTA5 15931,3630,8,3622,0.0022038567493112946,-10.470608889363225
ZCTA5 28166,3576,7,3569,0.0019574944071588368,-10.474365245064844
ZCTA5 15332,3633,8,3625,0.002202036884117809,-10.475544701020773
ZCTA5 21221,16155,301,15854,0.01863200247601362,-10.47684867098506
ZCTA5 18705,6383,63,6320,0.009869967100109666,-10.47847865963924
ZCTA5 32141,7379,85,7294,0.011519176040113837,-10.478545238739002
ZCTA5 18052,11070,172,10898,0.015537488708220415,-10.483262232577632
ZCTA5 14843,5298,40,5258,0.007550018875047188,-10.485516300378215
ZCTA5 03820,13202,225,12977,0.017042872292076957,-10.48643900798879
ZCTA5 07760,3179,0,3179,0,-10.489618677423161
ZCTA5 19970,3809,11,3798,0.002887897085849304,-10.490887926234656
ZCTA5 30606,17656,340,17316,0.019256909832351607,-10.490985231502517
ZCTA5 55041,3357,3,3354,8.936550491510277e-4,-10.491344331269572
ZCTA5 94550,18036,350,17686,0.01940563317808827,-10.492205975739546
ZCTA5 08530,3183,0,3183,0,-10.496215922526558
ZCTA5 72023,14118,248,13870,0.01756622751097889,-10.498314145896131
ZCTA5 18708,3362,3,3359,8.92325996430696e-4,-10.49958301257154
ZCTA5 91403,11491,182,11309,0.015838482290488207,-10.501313369791168
ZCTA5 06019,4035,15,4020,0.0037174721189591076,-10.504582983753512
ZCTA5 73110,13928,243,13685,0.017446869615163698,-10.505767225569784
ZCTA5 63028,9849,142,9707,0.014417707381460046,-10.506239014296035
ZCTA5 60618,35091,820,34271,0.02336781510928728,-10.507482638936578
ZCTA5 34211,3191,0,3191,0,-10.509397988534378
ZCTA5 36301,14049,246,13803,0.01751014307068119,-10.509596304058585
ZCTA5 13601,15299,278,15021,0.018171122295574875,-10.51252140815684
ZCTA5 54880,13264,226,13038,0.01703860072376357,-10.513769499882832
ZCTA5 08742,9980,145,9835,0.014529058116232466,-10.51401747676548
ZCTA5 80534,5847,51,5796,0.008722421754746024,-10.516855446652114
ZCTA5 46373,5270,39,5231,0.007400379506641366,-10.51818231092819
ZCTA5 16059,3315,2,3313,6.033182503770739e-4,-10.518470591155232
ZCTA5 78258,16079,298,15781,0.01853349088873686,-10.521643069894205
ZCTA5 18428,4725,28,4697,0.005925925925925926,-10.523102867126305
ZCTA5 37381,3718,9,3709,0.002420656266810113,-10.52325032250571
ZCTA5 71119,4417,22,4395,0.00498075616934571,-10.52367911911317
ZCTA5 45209,5947,53,5894,0.008912056499075165,-10.525081828759065
ZCTA5 20112,8072,100,7972,0.012388503468780971,-10.525205036221587
ZCTA5 12566,3885,12,3873,0.003088803088803089,-10.525393152917466
ZCTA5 54452,8203,103,8100,0.012556381811532366,-10.525711813242092
ZCTA5 30548,6461,64,6397,0.009905587370376103,-10.526385084081923
ZCTA5 13492,4881,31,4850,0.006351157549682442,-10.530194360461447
ZCTA5 05602,5424,42,5382,0.007743362831858407,-10.530282909809104
ZCTA5 73025,4051,15,4036,0.00370278943470748,-10.53058627287693
ZCTA5 60155,3204,0,3204,0,-10.530783652640237
ZCTA5 48503,11435,180,11255,0.015741145605596852,-10.533577576897155
ZCTA5 98391,17316,330,16986,0.019057519057519057,-10.535394550607759
ZCTA5 54961,5764,49,5715,0.008501040943789036,-10.535412079717092
ZCTA5 17406,9201,126,9075,0.013694163677861103,-10.54070079738933
ZCTA5 87059,4271,19,4252,0.004448606883633809,-10.541694409937792
ZCTA5 71459,3504,5,3499,0.0014269406392694063,-10.543034848516537
ZCTA5 17756,4377,21,4356,0.004797806716929404,-10.543230403947502
ZCTA5 20878,22635,472,22163,0.020852661806936162,-10.543350821653998
ZCTA5 61938,9374,130,9244,0.013868145935566461,-10.545657569758278
ZCTA5 97408,5579,45,5534,0.008065961641871303,-10.545683651196875
ZCTA5 02777,6149,57,6092,0.009269799967474386,-10.546335862281142
ZCTA5 06517,6061,55,6006,0.009074410163339383,-10.555191717058456
ZCTA5 08086,3219,0,3219,0,-10.555405579289543
ZCTA5 80919,11208,174,11034,0.015524625267665952,-10.55597596196098
ZCTA5 58072,3627,7,3620,0.0019299696719051558,-10.558010679004495
ZCTA5 48322,12303,201,12102,0.01633747866374055,-10.558214765666964
ZCTA5 12831,6297,60,6237,0.009528346831824679,-10.558405151485912
ZCTA5 21713,3797,10,3787,0.002633658151171978,-10.561471001846616
ZCTA5 14519,5051,34,5017,0.006731340328647793,-10.561742249332385
ZCTA5 80128,14054,245,13809,0.017432759356766758,-10.562483044272115
ZCTA5 35127,3745,9,3736,0.002403204272363151,-10.567330245927701
ZCTA5 41005,8536,110,8426,0.01288659793814433,-10.567568061792214
ZCTA5 71037,7307,82,7225,0.011222115779389627,-10.568511979236188
ZCTA5 91436,5594,45,5549,0.008044333214158027,-10.568846978997142
ZCTA5 68434,3228,0,3228,0,-10.570151205448576
ZCTA5 84094,9225,126,9099,0.013658536585365854,-10.573468561367541
ZCTA5 38060,3860,11,3849,0.002849740932642487,-10.574070648111526
ZCTA5 20774,17846,343,17503,0.019219993275804103,-10.574707565529609
ZCTA5 32720,12478,205,12273,0.016428914890206765,-10.576239825970967
ZCTA5 17340,4240,18,4222,0.0042452830188679245,-10.576994139310285
ZCTA5 15220,8065,99,7966,0.01227526348419095,-10.577194577858794
ZCTA5 48161,10570,158,10412,0.014947965941343426,-10.580832753029433
ZCTA5 41653,4190,17,4173,0.004057279236276849,-10.58212115945977
ZCTA5 23666,21788,448,21340,0.020561777125022947,-10.582981454826818
ZCTA5 00725,30216,680,29536,0.022504633306857293,-10.58474802325731
ZCTA5 40965,5317,39,5278,0.007334963325183374,-10.59150751558356
ZCTA5 97223,19486,386,19100,0.0198090937083034,-10.592610183564684
ZCTA5 32063,4512,23,4489,0.005097517730496454,-10.592631536542843
ZCTA5 68845,8120,100,8020,0.012315270935960592,-10.593150859494303
ZCTA5 31721,7901,95,7806,0.012023794456397924,-10.59340479632463
ZCTA5 61081,8813,116,8697,0.01316237376602746,-10.59368909936669
ZCTA5 22932,3244,0,3244,0,-10.59631498608204
ZCTA5 00610,8858,117,8741,0.013208399187175434,-10.596611290630962
ZCTA5 62712,4146,16,4130,0.003859141341051616,-10.597360917389418
ZCTA5 34689,10624,159,10465,0.014966114457831326,-10.597423238848735
ZCTA5 22657,4253,18,4235,0.00423230660710087,-10.597902607819389
ZCTA5 77027,9245,126,9119,0.013628988642509464,-10.600723628933249
ZCTA5 95032,9836,140,9696,0.014233428222854819,-10.600939218570794
ZCTA5 35907,3247,0,3247,0,-10.601213506254046
ZCTA5 86315,3247,0,3247,0,-10.601213506254046
ZCTA5 60586,13377,227,13150,0.01696942513269044,-10.602952879063544
ZCTA5 21218,18443,358,18085,0.019411158705199806,-10.605755956671414
ZCTA5 00680,18557,361,18196,0.01945357547017298,-10.606350402543534
ZCTA5 16117,7244,80,7164,0.011043622308117063,-10.60733723079042
ZCTA5 38401,22332,462,21870,0.020687802256851157,-10.609551046377243
ZCTA5 04210,10262,150,10112,0.01461703371662444,-10.611966290261208
ZCTA5 32920,5380,40,5340,0.007434944237918215,-10.61328872504721
ZCTA5 80230,4157,16,4141,0.0038489295164782296,-10.615071328995551
ZCTA5 15085,3256,0,3256,0,-10.61589550475759
ZCTA5 15656,4212,17,4195,0.004036087369420703,-10.617514517712495
ZCTA5 30009,6477,63,6414,0.009726725335803613,-10.619462054915378
ZCTA5 38053,10101,146,9955,0.014454014454014454,-10.619505714464855
ZCTA5 06111,12394,202,12192,0.01629820881071486,-10.621502533310457
ZCTA5 50263,9219,125,9094,0.013558954333441805,-10.623201965664022
ZCTA5 56345,6153,56,6097,0.009101251422070534,-10.623289986182147
ZCTA5 55391,6756,69,6687,0.010213143872113677,-10.623429728019824
ZCTA5 19510,3261,0,3261,0,-10.624043403343494
ZCTA5 08734,3262,0,3262,0,-10.625672233311418
ZCTA5 03833,8923,118,8805,0.01322425193320632,-10.627091529985249
ZCTA5 43076,3498,4,3494,0.0011435105774728416,-10.62722652718933
ZCTA5 60613,26449,574,25875,0.02170214374834587,-10.628781052791753
ZCTA5 35406,6576,65,6511,0.009884428223844282,-10.629194061383506
ZCTA5 32955,15167,272,14895,0.017933671787433242,-10.62969661050235
ZCTA5 19132,13756,236,13520,0.01715615004361733,-10.630316389247339
ZCTA5 49601,8711,113,8598,0.01297210423602342,-10.630962664663544
ZCTA5 14206,8883,117,8766,0.013171225937183385,-10.631037995716566
ZCTA5 44111,17672,337,17335,0.019069714803078317,-10.634126258440116
ZCTA5 98312,13045,218,12827,0.016711383671904945,-10.634448737354267
ZCTA5 52806,10859,164,10695,0.015102679804770237,-10.634847771558691
ZCTA5 48375,8542,109,8433,0.01276047763989698,-10.636104229338807
ZCTA5 30512,8325,104,8221,0.012492492492492492,-10.636113118718596
ZCTA5 06470,5878,50,5828,0.008506294658046955,-10.636846324667598
ZCTA5 54451,4949,31,4918,0.006263891695291978,-10.637431940484667
ZCTA5 61701,15213,273,14940,0.01794517846578584,-10.637911203923672
ZCTA5 85143,12086,194,11892,0.016051629985106734,-10.639447197646327
ZCTA5 60042,3271,0,3271,0,-10.640320482603634
ZCTA5 35077,4951,31,4920,0.006261361341143203,-10.640571260783492
ZCTA5 11735,11479,179,11300,0.015593692830385922,-10.641679189229805
ZCTA5 55804,5738,47,5691,0.008191007319623562,-10.642226603198647
ZCTA5 15238,5302,38,5264,0.007167106752168993,-10.644527542632803
ZCTA5 60514,3849,10,3839,0.002598077422707197,-10.645820728884493
ZCTA5 80027,12775,211,12564,0.016516634050880625,-10.646230537621802
ZCTA5 21157,13854,238,13616,0.017179154034935758,-10.653057709255872
ZCTA5 27278,10001,143,9858,0.014298570142985701,-10.653257302236645
ZCTA5 65742,4909,30,4879,0.006111224281931147,-10.653841318469015
ZCTA5 26726,5259,37,5222,0.007035558090891804,-10.65432725373636
ZCTA5 13209,5651,45,5606,0.007963192355335338,-10.656476828795395
ZCTA5 77433,24884,530,24354,0.021298826555216203,-10.66334137585075
ZCTA5 48198,15937,291,15646,0.018259396373219553,-10.6675069852
ZCTA5 59803,6603,65,6538,0.009844010298349234,-10.669257092103276
ZCTA5 19703,5852,49,5803,0.008373205741626795,-10.66991376224256
ZCTA5 21774,4509,22,4487,0.004879130627633622,-10.670660644912772
ZCTA5 02368,12274,198,12076,0.01613166042040085,-10.672569862254749
ZCTA5 43964,3811,9,3802,0.0023615848858567303,-10.67432844859591
ZCTA5 33708,8310,103,8207,0.012394705174488568,-10.676099827952191
ZCTA5 76308,8048,97,7951,0.012052683896620278,-10.677084329742096
ZCTA5 94505,5473,41,5432,0.00749132103051343,-10.68143361487644
ZCTA5 44024,9262,125,9137,0.01349600518246599,-10.681638280921414
ZCTA5 72076,14233,247,13986,0.017354036394294947,-10.681764341450705
ZCTA5 19103,15097,269,14828,0.017818109558190368,-10.684101847945298
ZCTA5 46953,8450,106,8344,0.012544378698224851,-10.689142038875003
ZCTA5 62966,6431,61,6370,0.0094853055512362,-10.689350045449059
ZCTA5 43085,10363,151,10212,0.014571070153430473,-10.6900813686465
ZCTA5 28036,6009,52,5957,0.008653686137460476,-10.691183727494353
ZCTA5 34607,4043,13,4030,0.003215434083601286,-10.692513070593074
ZCTA5 31791,4731,26,4705,0.00549566687803847,-10.694359268881554
ZCTA5 07722,3305,0,3305,0,-10.69547726266732
ZCTA5 85118,6436,61,6375,0.009477936606587942,-10.696792218699096
ZCTA5 19026,11930,189,11741,0.015842414082145852,-10.697640122912382
ZCTA5 06903,4937,30,4907,0.006076564715414219,-10.69772494786096
ZCTA5 36054,5823,48,5775,0.00824317362184441,-10.698623868421656
ZCTA5 94939,3307,0,3307,0,-10.698712923689055
ZCTA5 33875,4631,24,4607,0.005182465990066941,-10.69926001868112
ZCTA5 29492,5189,35,5154,0.006745037579495085,-10.69956334315986
ZCTA5 55092,3993,12,3981,0.003005259203606311,-10.700047264222828
ZCTA5 19081,3309,0,3309,0,-10.701947606430748
ZCTA5 35401,11118,169,10949,0.015200575643101278,-10.703523458227533
ZCTA5 27301,3311,0,3311,0,-10.70518131177919
ZCTA5 48074,3548,4,3544,0.0011273957158962795,-10.70824723554827
ZCTA5 37405,7360,81,7279,0.011005434782608696,-10.710147872240134
ZCTA5 95135,7450,83,7367,0.011140939597315436,-10.71038982346811
ZCTA5 91362,13506,228,13278,0.016881386050644157,-10.710853227026536
ZCTA5 84014,5541,42,5499,0.007579859231185706,-10.710934026213865
ZCTA5 06831,4996,31,4965,0.006204963971176942,-10.71098668452096
ZCTA5 07746,5975,51,5924,0.008535564853556485,-10.711670711097392
ZCTA5 37683,4896,29,4867,0.005923202614379085,-10.712888271994121
ZCTA5 60653,14575,255,14320,0.017495711835334476,-10.714218969103092
ZCTA5 49306,3892,10,3882,0.0025693730729701952,-10.715080274959913
ZCTA5 34239,6912,71,6841,0.010271990740740741,-10.718172894017115
ZCTA5 35806,10343,150,10193,0.014502562119307744,-10.718506855348673
ZCTA5 13039,6544,63,6481,0.009627139364303178,-10.719046678735378
ZCTA5 20017,7724,89,7635,0.0115225271879855,-10.719067736224064
ZCTA5 37825,3784,8,3776,0.0021141649048625794,-10.721088314373608
ZCTA5 38632,9507,130,9377,0.013674134848006732,-10.725404878559525
ZCTA5 97212,10888,163,10725,0.01497060984570169,-10.725676478560722
ZCTA5 21054,4227,16,4211,0.003785190442394133,-10.727117608007202
ZCTA5 97232,6689,66,6623,0.009866945731798474,-10.728080969236155
ZCTA5 84106,14469,252,14217,0.01741654571843251,-10.728143878057733
ZCTA5 48827,6270,57,6213,0.00909090909090909,-10.72837013094872
ZCTA5 66224,4650,24,4626,0.005161290322580645,-10.72921614405399
ZCTA5 50273,3331,0,3331,0,-10.737464802775488
ZCTA5 35150,6971,72,6899,0.010328503801463204,-10.737580468431174
ZCTA5 94707,4861,28,4833,0.005760131660152232,-10.737755018129565
ZCTA5 01864,5412,39,5373,0.007206208425720621,-10.73838414065217
ZCTA5 04086,3796,8,3788,0.002107481559536354,-10.740364388859495
ZCTA5 43004,9774,136,9638,0.013914466953140987,-10.742838269380652
ZCTA5 21074,5513,41,5472,0.007436967168510793,-10.742839092251996
ZCTA5 13066,5168,34,5134,0.006578947368421052,-10.744290761115561
ZCTA5 24477,4451,20,4431,0.004493372275893057,-10.744931587257701
ZCTA5 32218,21429,434,20995,0.020252928274767837,-10.746857581800064
ZCTA5 07834,6794,68,6726,0.010008831321754489,-10.746917107874626
ZCTA5 07456,3914,10,3904,0.0025549310168625446,-10.75034635453499
ZCTA5 34242,3860,9,3851,0.00233160621761658,-10.75308979806734
ZCTA5 22314,17629,333,17296,0.018889330081116342,-10.754372323275756
ZCTA5 46809,3917,10,3907,0.0025529742149604288,-10.755146586601244
ZCTA5 32561,3974,11,3963,0.0027679919476597888,-10.75773897447922
ZCTA5 18360,9575,131,9444,0.013681462140992168,-10.759706655833812
ZCTA5 63136,18208,348,17860,0.019112478031634447,-10.7621009883379
ZCTA5 54751,9620,132,9488,0.013721413721413722,-10.76316954882899
ZCTA5 37721,4979,30,4949,0.006025306286402892,-10.763246421464947
ZCTA5 31088,20999,422,20577,0.020096195056907473,-10.764792389479807
ZCTA5 71115,6991,72,6919,0.01029895580031469,-10.766711833087115
ZCTA5 44028,3352,0,3352,0,-10.771258331191264
ZCTA5 54487,4469,20,4449,0.004475274110539271,-10.773364367622793
ZCTA5 44074,3876,9,3867,0.0023219814241486067,-10.778685265864715
ZCTA5 13669,6115,53,6062,0.00866721177432543,-10.77918692303308
ZCTA5 78006,11466,176,11290,0.015349729635443921,-10.7809274673185
ZCTA5 53572,3989,11,3978,0.0027575833542241163,-10.781678420779903
ZCTA5 30517,4685,24,4661,0.005122732123799359,-10.784196129293795
ZCTA5 80549,3880,9,3871,0.0023195876288659794,-10.785074801623153
ZCTA5 30025,3361,0,3361,0,-10.785708859412367
ZCTA5 01826,11224,170,11054,0.015146115466856735,-10.786512621691193
ZCTA5 26330,6025,51,5974,0.008464730290456432,-10.786972482402364
ZCTA5 36066,7950,93,7857,0.01169811320754717,-10.787690536217761
ZCTA5 43074,4531,21,4510,0.004634738468329287,-10.788145227479571
ZCTA5 33704,7372,80,7292,0.010851871947911014,-10.792198702970035
ZCTA5 02723,6642,64,6578,0.009635651912074676,-10.795152138973942
ZCTA5 06013,3367,0,3367,0,-10.795331798598838
ZCTA5 45410,7104,74,7030,0.010416666666666666,-10.798204067699821
ZCTA5 08004,3945,10,3935,0.0025348542458808617,-10.799847922388349
ZCTA5 02632,4433,19,4414,0.00428603654410106,-10.799952187234775
ZCTA5 08723,13062,215,12847,0.016459960189863728,-10.801174702729288
ZCTA5 80120,13702,231,13471,0.01685885272223033,-10.802959933542708
ZCTA5 54650,9906,138,9768,0.013930950938824955,-10.806013396510881
ZCTA5 44706,7155,75,7080,0.010482180293501049,-10.80607753938564
ZCTA5 03063,6975,71,6904,0.010179211469534051,-10.809998900035055
ZCTA5 67206,7113,74,7039,0.010403486573878814,-10.811223682597165
ZCTA5 53024,7024,72,6952,0.010250569476082005,-10.814644900438736
ZCTA5 33498,5165,33,5132,0.0063891577928363984,-10.817024436702173
ZCTA5 15129,4444,19,4425,0.004275427542754276,-10.817276336238447
ZCTA5 61065,3383,0,3383,0,-10.820951132874598
ZCTA5 62221,12151,192,11959,0.015801168628096454,-10.821554845349533
ZCTA5 19036,5318,36,5282,0.006769462203836028,-10.8218387075787
ZCTA5 02019,6430,59,6371,0.009175738724727838,-10.826564685823513
ZCTA5 45068,4290,16,4274,0.0037296037296037296,-10.827008532338377
ZCTA5 63088,3851,8,3843,0.002077382498052454,-10.82828010181703
ZCTA5 25064,4504,20,4484,0.004440497335701598,-10.828448440021125
ZCTA5 61021,8943,115,8828,0.012859219501285922,-10.830965897621402
ZCTA5 30248,8158,97,8061,0.011890169159107624,-10.831433457539285
ZCTA5 60305,3965,10,3955,0.0025220680958385876,-10.831666739314661
ZCTA5 20871,6199,54,6145,0.008711082432650428,-10.833760996294307
ZCTA5 24084,4405,18,4387,0.004086265607264473,-10.839524586004211
ZCTA5 28075,6203,54,6149,0.00870546509753345,-10.8397160937147
ZCTA5 78209,17823,336,17487,0.0188520451102508,-10.841065527350025
ZCTA5 41051,9848,136,9712,0.01380991064175467,-10.841130716038263
ZCTA5 04102,7811,89,7722,0.011394187684035335,-10.842344152648483
ZCTA5 00603,19233,373,18860,0.019393750324962305,-10.843947286229008
ZCTA5 14701,16830,310,16520,0.0184194890077243,-10.846802063177357
ZCTA5 48238,10274,146,10128,0.01421062877165661,-10.84725159497777
ZCTA5 83843,11314,171,11143,0.015114018030758352,-10.848658626120764
ZCTA5 70769,14849,259,14590,0.01744225200350192,-10.850687610921051
ZCTA5 61103,10319,147,10172,0.014245566430855703,-10.851244301975521
ZCTA5 02478,9771,134,9637,0.013714051785897042,-10.851359428892293
ZCTA5 00685,14025,238,13787,0.01696969696969697,-10.85654760741359
ZCTA5 49002,8484,104,8380,0.012258368694012258,-10.857127620318527
ZCTA5 70737,15756,282,15474,0.0178979436405179,-10.859069248090016
ZCTA5 43078,8310,100,8210,0.012033694344163659,-10.859113649674173
ZCTA5 31523,5395,37,5358,0.006858202038924931,-10.86365508774612
ZCTA5 46012,8094,95,7999,0.011737089201877934,-10.865451593106275
ZCTA5 17363,3591,3,3588,8.35421888053467e-4,-10.870241566813723
ZCTA5 84108,7787,88,7699,0.011300886092204957,-10.871460782404109
ZCTA5 20186,5648,42,5606,0.007436260623229462,-10.873871900937491
ZCTA5 27370,5795,45,5750,0.007765314926660914,-10.87516757171915
ZCTA5 34949,4048,11,4037,0.002717391304347826,-10.875340682528488
ZCTA5 01450,4048,11,4037,0.002717391304347826,-10.875340682528488
ZCTA5 02748,4693,23,4670,0.004900916258256978,-10.877904359054133
ZCTA5 84302,8543,105,8438,0.012290764368488822,-10.878162317845636
ZCTA5 53129,5943,48,5895,0.008076728924785462,-10.87965686821851
ZCTA5 70380,8590,106,8484,0.012339930151338767,-10.882703877324316
ZCTA5 24014,7526,82,7444,0.01089556205155461,-10.883261854100683
ZCTA5 07045,3942,9,3933,0.00228310502283105,-10.883640881299087
ZCTA5 27534,13131,215,12916,0.01637346736729876,-10.884783553697444
ZCTA5 54235,8064,94,7970,0.011656746031746032,-10.885419220950022
ZCTA5 68133,3659,4,3655,0.0010931948619841486,-10.885967082640295
ZCTA5 17702,4328,16,4312,0.0036968576709796672,-10.886834847143547
ZCTA5 38558,4594,21,4573,0.00457117979973879,-10.886843721834522
ZCTA5 48033,7574,83,7491,0.010958542381832585,-10.887431708562769
ZCTA5 11742,4436,18,4418,0.0040577096483318306,-10.88817589643758
ZCTA5 35810,11387,172,11215,0.015104944234653552,-10.888985760890876
ZCTA5 06896,3426,0,3426,0,-10.889504437141683
ZCTA5 50131,8205,97,8108,0.01182205971968312,-10.896898894407778
ZCTA5 60069,3432,0,3432,0,-10.899035733878534
ZCTA5 11554,12217,192,12025,0.015715805844315298,-10.90337485865946
ZCTA5 61073,6995,70,6925,0.010007147962830594,-10.905514715035768
ZCTA5 36527,5620,41,5579,0.007295373665480427,-10.905620456554644
ZCTA5 20003,12829,207,12622,0.016135318419206485,-10.908891696860929
ZCTA5 15211,5524,39,5485,0.007060101375814627,-10.909318705101976
ZCTA5 14424,11856,183,11673,0.015435222672064777,-10.91097525685138
ZCTA5 68008,4871,26,4845,0.005337712995278177,-10.912745612879165
ZCTA5 47394,3441,0,3441,0,-10.913317070950995
ZCTA5 01590,3441,0,3441,0,-10.913317070950995
ZCTA5 85602,4129,12,4117,0.00290627270525551,-10.916113400794202
ZCTA5 38305,20021,392,19629,0.01957944158633435,-10.917746465720048
ZCTA5 48174,11575,176,11399,0.015205183585313175,-10.918532808648283
ZCTA5 13350,4020,10,4010,0.0024875621890547263,-10.918699672694139
ZCTA5 31906,8711,108,8603,0.012398117322925038,-10.928882311693291
ZCTA5 90808,13967,235,13732,0.016825374096083624,-10.928928614323825
ZCTA5 48653,4677,22,4655,0.004703870002138123,-10.934285557350675
ZCTA5 25177,9621,129,9492,0.0134081696289367,-10.934595143873567
ZCTA5 45309,5343,35,5308,0.006550626988583193,-10.936201226877591
ZCTA5 80111,12652,202,12450,0.015965855200758772,-10.939379069337145
ZCTA5 27282,6835,66,6769,0.009656181419166058,-10.941430514515849
ZCTA5 07512,3460,0,3460,0,-10.943405356206432
ZCTA5 36604,4036,10,4026,0.002477700693756194,-10.943890877417308
ZCTA5 48193,6274,54,6220,0.008606949314631815,-10.94497083622501
ZCTA5 41011,11890,183,11707,0.015391084945332211,-10.953373812939557
ZCTA5 19072,4098,11,4087,0.0026842362127867253,-10.9541026414297
ZCTA5 42748,3469,0,3469,0,-10.957628865452453
ZCTA5 04530,5105,30,5075,0.005876591576885406,-10.957674573856998
ZCTA5 82414,6520,59,6461,0.009049079754601227,-10.95894570235922
ZCTA5 61401,13714,228,13486,0.016625346361382527,-10.959759567356517
ZCTA5 85083,6332,55,6277,0.00868603916614024,-10.960445953133997
ZCTA5 40291,14708,253,14455,0.01720152298069078,-10.961403921931787
ZCTA5 06883,3473,0,3473,0,-10.963944502210506
ZCTA5 55418,13197,215,12982,0.016291581420019702,-10.964417278161607
ZCTA5 61944,5263,33,5230,0.006270188105643169,-10.967159819380583
ZCTA5 06479,3995,9,3986,0.0022528160200250315,-10.967208100846316
ZCTA5 33483,6051,49,6002,0.008097835068583706,-10.968937516735945
ZCTA5 98229,12961,209,12752,0.016125298973844612,-10.971213352832212
ZCTA5 23701,9091,116,8975,0.012759872401275987,-10.972897735539872
ZCTA5 53405,10035,138,9897,0.013751868460388639,-10.975910230918092
ZCTA5 27106,19510,377,19133,0.019323423885187083,-10.976384562216937
ZCTA5 38058,3481,0,3481,0,-10.976564874160879
ZCTA5 40165,13167,214,12953,0.01625275309485836,-10.976725161087835
ZCTA5 87501,8130,94,8036,0.011562115621156211,-10.977324751406043
ZCTA5 06117,5422,36,5386,0.0066396163777203985,-10.980314029759237
ZCTA5 14618,8222,96,8126,0.011675991243006568,-10.98183777875446
ZCTA5 15904,6394,56,6338,0.008758210822646231,-10.98188160464046
ZCTA5 34228,3835,6,3829,0.0015645371577574967,-10.982379103723416
ZCTA5 12571,3895,7,3888,0.001797175866495507,-10.987215497852768
ZCTA5 16508,6867,66,6801,0.009611183923110528,-10.987749797545286
ZCTA5 70605,14375,244,14131,0.01697391304347826,-10.988366694553386
ZCTA5 36093,3896,7,3889,0.0017967145790554414,-10.988785952455462
ZCTA5 70128,7007,69,6938,0.009847295561581275,-10.989277896360143
ZCTA5 00730,11961,184,11777,0.015383329153080846,-10.99074572777862
ZCTA5 53213,11509,173,11336,0.015031714310539578,-10.99085133602351
ZCTA5 48609,5127,30,5097,0.005851375073142188,-10.991301305203576
ZCTA5 60404,6449,57,6392,0.008838579624748023,-10.99312058982319
ZCTA5 53074,5432,36,5396,0.0066273932253313695,-10.99544493748398
ZCTA5 60422,3495,0,3495,0,-10.998615679602848
ZCTA5 39426,6453,57,6396,0.008833100883310088,-10.998976821214251
ZCTA5 17111,12701,202,12499,0.015904259507125422,-10.99914620216854
ZCTA5 48036,9156,117,9039,0.012778505897771953,-11.002140179810038
ZCTA5 60108,8765,108,8657,0.012321734169994296,-11.002472636803544
ZCTA5 19526,4617,20,4597,0.004331817197314273,-11.004510439204882
ZCTA5 52748,3499,0,3499,0,-11.0049077943507
ZCTA5 46208,8504,102,8402,0.011994355597365945,-11.005311524608755
ZCTA5 15232,6174,51,6123,0.00826044703595724,-11.008804951549422
ZCTA5 59602,10145,140,10005,0.013799901429275506,-11.008998502710895
ZCTA5 19154,12426,195,12231,0.015692901979719943,-11.01044140632559
ZCTA5 46201,12711,202,12509,0.01589174730548344,-11.011320269662411
ZCTA5 36360,7664,83,7581,0.010829853862212944,-11.014578418885428
ZCTA5 22025,6226,52,6174,0.008352071956312239,-11.0148629989586
ZCTA5 29902,5937,46,5891,0.007748020885969345,-11.01501352613182
ZCTA5 00612,22589,458,22131,0.02027535526141042,-11.015155130486239
ZCTA5 32563,9770,131,9639,0.013408393039918117,-11.018818821163865
ZCTA5 06032,7305,75,7230,0.01026694045174538,-11.021066049105919
ZCTA5 62298,6660,61,6599,0.00915915915915916,-11.026020041341653
ZCTA5 46074,11289,167,11122,0.014793161484631057,-11.026250165057062
ZCTA5 23220,13128,212,12916,0.016148689823278488,-11.026763928849832
ZCTA5 63841,5404,35,5369,0.006476683937823834,-11.028680913894163
ZCTA5 17003,4256,13,4243,0.0030545112781954886,-11.028940624021446
ZCTA5 72211,9651,128,9523,0.013262874313542639,-11.031008027045004
ZCTA5 29745,11706,177,11529,0.015120451050743208,-11.031126281918203
ZCTA5 68127,10163,140,10023,0.013775460001967922,-11.032463186306602
ZCTA5 60187,9825,132,9693,0.013435114503816794,-11.035060836330521
ZCTA5 31632,4371,15,4356,0.0034317089910775567,-11.038269364876847
ZCTA5 03062,11340,168,11172,0.014814814814814815,-11.03830545010561
ZCTA5 59840,6098,49,6049,0.008035421449655624,-11.03855886780029
ZCTA5 64119,10968,159,10809,0.01449671772428884,-11.041006292089246
ZCTA5 24333,7183,72,7111,0.010023666991507727,-11.043307455811128
ZCTA5 98230,7275,74,7201,0.010171821305841924,-11.043530006945883
ZCTA5 01742,6772,63,6709,0.009303012404016538,-11.052512145171512
ZCTA5 47304,13351,217,13134,0.016253464159988015,-11.052698352473746
ZCTA5 06518,6726,62,6664,0.009217960154623847,-11.053700795400463
ZCTA5 02364,4859,24,4835,0.004939287919324964,-11.053743568571265
ZCTA5 33702,13070,210,12860,0.016067329762815608,-11.0541050294514
ZCTA5 33701,8629,104,8525,0.012052381504229923,-11.055924386484003
ZCTA5 30677,6728,62,6666,0.009215219976218787,-11.056594029799276
ZCTA5 21666,4598,19,4579,0.004132231404958678,-11.057106329905379
ZCTA5 23223,21211,420,20791,0.019801046626750272,-11.058042582837617
ZCTA5 33510,10310,143,10167,0.013870029097963142,-11.058564738401259
ZCTA5 35235,8191,94,8097,0.0114760102551581,-11.061766935552743
ZCTA5 15613,5920,45,5875,0.007601351351351352,-11.061989282802159
ZCTA5 53546,12348,192,12156,0.015549076773566569,-11.064708297811071
ZCTA5 30622,4551,18,4533,0.003955174686882004,-11.066873815765796
ZCTA5 33473,3540,0,3540,0,-11.069195755851082
ZCTA5 73034,16449,295,16154,0.01793422092528421,-11.06943386654794
ZCTA5 97140,8772,107,8665,0.012197902416780666,-11.071362954897134
ZCTA5 02664,4007,8,3999,0.001996506114299975,-11.073894503269452
ZCTA5 18938,6122,49,6073,0.008003920287487748,-11.073966666176277
ZCTA5 29926,10871,156,10715,0.014350105786036243,-11.077084490120065
ZCTA5 44303,3547,0,3547,0,-11.080134471062307
ZCTA5 15218,6792,63,6729,0.009275618374558304,-11.081376045006563
ZCTA5 92887,6792,63,6729,0.009275618374558304,-11.081376045006563
ZCTA5 15024,3668,2,3666,5.452562704471102e-4,-11.083895055479479
ZCTA5 50211,4984,26,4958,0.00521669341894061,-11.086112164592965
ZCTA5 76227,10543,148,10395,0.014037750165986912,-11.08705442518071
ZCTA5 13790,7671,82,7589,0.01068961022031026,-11.087915532912206
ZCTA5 02132,11421,169,11252,0.014797303213378863,-11.088065194491763
ZCTA5 08094,14743,251,14492,0.017025028827240045,-11.0936137058394
ZCTA5 64507,5145,29,5116,0.005636540330417881,-11.096274629029303
ZCTA5 01886,8350,97,8253,0.011616766467065867,-11.097086278425088
ZCTA5 89815,4783,22,4761,0.004599623667154506,-11.097592727824427
ZCTA5 78230,18638,351,18287,0.018832492756733554,-11.10100634811413
ZCTA5 24201,7132,70,7062,0.00981491867638811,-11.102070741431824
ZCTA5 53226,8180,93,8087,0.01136919315403423,-11.108062325006072
ZCTA5 48840,5707,40,5667,0.007008936393902225,-11.110044397387655
ZCTA5 17325,10477,146,10331,0.013935286818745824,-11.110621415980301
ZCTA5 56377,7186,71,7115,0.009880322849986084,-11.113188449892276
ZCTA5 63117,4369,14,4355,0.0032043945983062485,-11.11930040033209
ZCTA5 44260,4903,24,4879,0.004894962267999185,-11.120938933604606
ZCTA5 07463,3574,0,3574,0,-11.122225882667138
ZCTA5 20152,10571,148,10423,0.014000567590577996,-11.123026982789268
ZCTA5 30087,14333,240,14093,0.016744575455243146,-11.124991096073929
ZCTA5 35976,6825,63,6762,0.009230769230769232,-11.128868539889728
ZCTA5 01803,9942,133,9809,0.013377590022128344,-11.132468537865012
ZCTA5 30642,5015,26,4989,0.00518444666001994,-11.133235437732603
ZCTA5 03878,4964,25,4939,0.005036261079774376,-11.13454216908771
ZCTA5 16214,4271,12,4259,0.002809646452821353,-11.137351618043647
ZCTA5 68124,6549,57,6492,0.008703618873110398,-11.13876159586449
ZCTA5 34145,8515,100,8415,0.011743981209630064,-11.140909871561014
ZCTA5 20639,4706,20,4686,0.004249893752656183,-11.141322267788665
ZCTA5 37416,6408,54,6354,0.008426966292134831,-11.141357356529452
ZCTA5 60045,7437,76,7361,0.010219174398278876,-11.143102254236261
ZCTA5 08002,8517,100,8417,0.011741223435481977,-11.143633535398253
ZCTA5 44112,9825,130,9695,0.013231552162849873,-11.147269622258078
ZCTA5 60190,4389,14,4375,0.003189792663476874,-11.150101466644614
ZCTA5 60449,3592,0,3592,0,-11.150198550275649
ZCTA5 02769,4114,9,4105,0.0021876519202722413,-11.152594527711525
ZCTA5 63144,4336,13,4323,0.0029981549815498157,-11.152750677471099
ZCTA5 76063,23178,470,22708,0.020277849685046166,-11.15572720914018
ZCTA5 48076,9790,129,9661,0.013176710929519919,-11.157572722781929
ZCTA5 44301,6228,50,6178,0.00802825947334618,-11.158744121706672
ZCTA5 71291,12917,204,12713,0.01579314082217233,-11.162511938912932
ZCTA5 48623,4721,20,4701,0.004236390595212879,-11.164223773171972
ZCTA5 07642,3602,0,3602,0,-11.165708640608404
ZCTA5 11757,14488,243,14245,0.01677250138045279,-11.166290482418997
ZCTA5 44830,7819,84,7735,0.010743061772605193,-11.16808210536967
ZCTA5 49464,9843,130,9713,0.013207355481052525,-11.17082623316751
ZCTA5 98292,8493,99,8394,0.011656658424584953,-11.17126122413158
ZCTA5 16323,6765,61,6704,0.0090169992609017,-11.177621032937079
ZCTA5 02127,16976,306,16670,0.01802544769085768,-11.179259225561422
ZCTA5 14830,8635,102,8533,0.011812391430225826,-11.183786295719756
ZCTA5 89014,16083,283,15800,0.017596219610769136,-11.183967754889096
ZCTA5 35146,3616,0,3616,0,-11.187386642013424
ZCTA5 61111,9813,129,9684,0.013145826964231121,-11.187685112548428
ZCTA5 60174,12491,193,12298,0.015451124809863102,-11.189473119430371
ZCTA5 46714,5958,44,5914,0.007385028533064787,-11.190292729382827
ZCTA5 76177,3618,0,3618,0,-11.190480071256014
ZCTA5 27574,5861,42,5819,0.0071660126258317695,-11.192071215185758
ZCTA5 28304,14353,239,14114,0.016651571100118442,-11.19471395425707
ZCTA5 44041,6011,45,5966,0.007486275162202629,-11.196301428420503
ZCTA5 34476,9693,126,9567,0.012999071494893221,-11.19941953152651
ZCTA5 11780,5468,34,5434,0.006217995610826628,-11.200174053592198
ZCTA5 47630,13959,229,13730,0.016405186617952577,-11.201877258711644
ZCTA5 45833,4147,9,4138,0.0021702435495538942,-11.203469152891602
ZCTA5 50428,4147,9,4138,0.0021702435495538942,-11.203469152891602
ZCTA5 32225,19956,383,19573,0.01919222289035879,-11.204207229527597
ZCTA5 60097,4370,13,4357,0.002974828375286041,-11.204966904926923
ZCTA5 77706,13034,206,12828,0.01580481816786865,-11.205538158847968
ZCTA5 11050,11058,158,10900,0.014288298064749502,-11.208095430808045
ZCTA5 13045,10514,145,10369,0.013791135628685561,-11.212421735526437
ZCTA5 48082,7258,71,7187,0.009782309176081565,-11.2151602588727
ZCTA5 46544,12760,199,12561,0.015595611285266457,-11.218552383653444
ZCTA5 30528,9536,122,9414,0.012793624161073826,-11.21991915469507
ZCTA5 30650,4380,13,4367,0.0029680365296803654,-11.220279607963562
ZCTA5 67460,6559,56,6503,0.008537886872998933,-11.221905392592607
ZCTA5 77705,10775,151,10624,0.014013921113689095,-11.22213219049175
ZCTA5 06468,6703,59,6644,0.008802028942264657,-11.224158709305852
ZCTA5 12828,3640,0,3640,0,-11.22445152536335
ZCTA5 11733,5486,34,5452,0.006197593875318994,-11.226997182336232
ZCTA5 93312,19560,372,19188,0.01901840490797546,-11.227673272494034
ZCTA5 94507,5335,31,5304,0.005810684161199625,-11.228569008855981
ZCTA5 45895,7361,73,7288,0.00991713082461622,-11.230131727584562
ZCTA5 46122,5887,42,5845,0.007134363852556481,-11.23037247918647
ZCTA5 46259,3644,0,3644,0,-11.230617113043557
ZCTA5 60655,10231,138,10093,0.013488417554491252,-11.230771666803772
ZCTA5 30813,13744,223,13521,0.016225261932479626,-11.232578810686723
ZCTA5 49001,8583,100,8483,0.01165093790050099,-11.233243216051115
ZCTA5 02481,4768,20,4748,0.0041946308724832215,-11.23569469341057
ZCTA5 53214,15858,276,15582,0.01740446462353386,-11.239747778953573
ZCTA5 71118,9681,125,9556,0.01291188926763764,-11.2401885126196
ZCTA5 76008,5796,40,5756,0.006901311249137336,-11.241905202282588
ZCTA5 63050,5895,42,5853,0.0071246819338422395,-11.242134475711383
ZCTA5 41091,6717,59,6658,0.008783683191901146,-11.244235620385679
ZCTA5 02492,7093,67,7026,0.009445932609615114,-11.24449198745446
ZCTA5 35204,4397,13,4384,0.0029565612917898565,-11.246264620932454
ZCTA5 85622,3655,0,3655,0,-11.247555052090812
ZCTA5 78613,26122,547,25575,0.0209402036597504,-11.247709632368972
ZCTA5 07950,7002,65,6937,0.009283061982290773,-11.24791913560074
ZCTA5 63132,5348,31,5317,0.005796559461480928,-11.247985540988404
ZCTA5 07438,4288,11,4277,0.0025652985074626866,-11.248476185297463
ZCTA5 37841,3833,3,3830,7.826767545003914e-4,-11.248706775661768
ZCTA5 11767,5092,26,5066,0.005106048703849175,-11.249490228363427
ZCTA5 68137,10416,142,10274,0.013632872503840246,-11.249868639702829
ZCTA5 26104,7144,68,7076,0.009518477043673012,-11.250745873202707
ZCTA5 56007,9082,111,8971,0.012221977537987228,-11.25253471432721
ZCTA5 48820,6535,55,6480,0.008416220351951033,-11.256051756155887
ZCTA5 43410,3956,5,3951,0.0012639029322548028,-11.259443842104913
ZCTA5 60051,8648,101,8547,0.01167900092506938,-11.261185337508769
ZCTA5 16686,5408,32,5376,0.005917159763313609,-11.261585184408917
ZCTA5 17315,10342,140,10202,0.013537033455811255,-11.264036393875438
ZCTA5 18018,13327,212,13115,0.015907556089142343,-11.264829694435855
ZCTA5 55419,10472,143,10329,0.01365546218487395,-11.267214210614677
ZCTA5 41094,5361,31,5330,0.005782503264316359,-11.267371527917307
ZCTA5 20194,5412,32,5380,0.005912786400591279,-11.267538396438372
ZCTA5 38852,3669,0,3669,0,-11.269075608973292
ZCTA5 37379,11151,159,10992,0.01425881086898036,-11.272444153332772
ZCTA5 02458,4951,23,4928,0.004645526156332054,-11.272847222911688
ZCTA5 80121,7346,72,7274,0.009801252382248844,-11.273915760902952
ZCTA5 61115,8660,101,8559,0.011662817551963049,-11.277370784306457
ZCTA5 07836,4197,9,4188,0.002144388849177984,-11.280121163242054
ZCTA5 17837,6603,56,6547,0.008480993487808572,-11.28519226920608
ZCTA5 35004,4533,15,4518,0.0033090668431502318,-11.286880432693742
ZCTA5 48114,7632,78,7554,0.010220125786163521,-11.287782247516716
ZCTA5 22152,10362,140,10222,0.013510905230650454,-11.289713587338074
ZCTA5 55125,16335,287,16048,0.017569635751453934,-11.290141151330998
ZCTA5 48823,19890,379,19511,0.019054801407742586,-11.293443435052648
ZCTA5 37620,16500,291,16209,0.017636363636363638,-11.29935238293763
ZCTA5 14468,6756,59,6697,0.008732978093546477,-11.300008436744005
ZCTA5 13165,4379,12,4367,0.002740351678465403,-11.302787246694802
ZCTA5 15131,3691,0,3691,0,-11.302810840707297
ZCTA5 22206,10288,138,10150,0.013413685847589424,-11.304166717621923
ZCTA5 15217,11719,172,11547,0.014677020223568564,-11.304202537551417
ZCTA5 24605,3695,0,3695,0,-11.30893370726726
ZCTA5 29630,6717,58,6659,0.008634807205597736,-11.312089623305484
ZCTA5 37415,10804,150,10654,0.013883746760459089,-11.312469309499624
ZCTA5 01890,7879,83,7796,0.010534331767990861,-11.313884716779357
ZCTA5 04107,3700,0,3700,0,-11.316582631853116
ZCTA5 87110,17104,306,16798,0.017890551917680075,-11.319435536217146
ZCTA5 60521,6048,44,6004,0.007275132275132275,-11.32202302804235
ZCTA5 17851,3705,0,3705,0,-11.324226389990336
ZCTA5 15012,6584,55,6529,0.008353584447144593,-11.326436232644026
ZCTA5 75013,13663,219,13444,0.016028690624313842,-11.327208470556316
ZCTA5 98028,8699,101,8598,0.011610529945970801,-11.329856306480991
ZCTA5 44833,6969,63,6906,0.009040034438226431,-11.334207072481142
ZCTA5 43215,9188,112,9076,0.012189812799303439,-11.33515648777998
ZCTA5 55068,10398,140,10258,0.013464127716868628,-11.335834338698964
ZCTA5 13215,5511,33,5478,0.005988023952095809,-11.339067289501639
ZCTA5 98321,5562,34,5528,0.006112909025530385,-11.339618408162252
ZCTA5 37757,3717,0,3717,0,-11.342550392897497
ZCTA5 77802,10958,153,10805,0.013962401898156599,-11.347019447429403
ZCTA5 85212,9944,129,9815,0.012972646822204344,-11.358151023309961
ZCTA5 83634,7268,69,7199,0.00949367088607595,-11.359727285954117
ZCTA5 72206,9077,109,8968,0.012008372810399912,-11.362610416942875
ZCTA5 13206,7597,76,7521,0.01000394892720811,-11.366653504294062
ZCTA5 49017,8862,104,8758,0.011735499887158655,-11.37008825458548
ZCTA5 15132,9911,128,9783,0.012914942992634447,-11.371235609997948
ZCTA5 64012,10558,143,10415,0.013544231862095094,-11.376943927910478
ZCTA5 45431,12070,179,11891,0.014830157415078708,-11.378680134691574
ZCTA5 89138,5790,38,5752,0.0065630397236614854,-11.379227164517205
ZCTA5 06450,15551,265,15286,0.017040704777827792,-11.382684196507796
ZCTA5 19518,5642,35,5607,0.00620347394540943,-11.383047617707701
ZCTA5 97330,17746,321,17425,0.01808858334272512,-11.383210708540014
ZCTA5 08204,7747,79,7668,0.010197495804827676,-11.383583982919806
ZCTA5 45403,5893,40,5853,0.006787714237230613,-11.384080487664145
ZCTA5 44044,4433,12,4421,0.0027069704489059328,-11.384624221867748
ZCTA5 87122,7054,64,6990,0.00907286645874681,-11.387783705917805
ZCTA5 11754,6534,53,6481,0.008111417202326294,-11.392206787383152
ZCTA5 48346,8969,106,8863,0.01181848589586353,-11.394817763638336
ZCTA5 37804,9277,113,9164,0.012180661851891775,-11.394824993447356
ZCTA5 56031,5293,28,5265,0.005290005667863216,-11.394943799655428
ZCTA5 24060,18185,332,17853,0.018256805059114655,-11.396995061648468
ZCTA5 37865,8349,92,8257,0.011019283746556474,-11.400024530925116
ZCTA5 07110,10831,149,10682,0.013756809158895763,-11.400062063633456
ZCTA5 21613,7350,70,7280,0.009523809523809525,-11.40926053673772
ZCTA5 46218,11721,170,11551,0.01450388192133777,-11.4094081169116
ZCTA5 53073,6256,47,6209,0.007512787723785166,-11.410533736109377
ZCTA5 66067,6109,44,6065,0.0072024881322638725,-11.4105520190358
ZCTA5 29401,3765,0,3765,0,-11.415552275298886
ZCTA5 53089,7313,69,7244,0.00943525229044168,-11.422621940882706
ZCTA5 80125,3770,0,3770,0,-11.423129808343928
ZCTA5 15037,4514,13,4501,0.0028799291094373063,-11.423540738757122
ZCTA5 22553,4786,18,4768,0.0037609694943585457,-11.42372305380592
ZCTA5 46013,7914,82,7832,0.010361384887541066,-11.424546689506986
ZCTA5 54935,17596,316,17280,0.01795862696067288,-11.430866391043306
ZCTA5 80528,7367,70,7297,0.009501832496267137,-11.43293734609221
ZCTA5 60487,8866,103,8763,0.011617414843221294,-11.434487223333775
ZCTA5 07843,4468,12,4456,0.0026857654431512983,-11.437360940021097
ZCTA5 11545,4245,8,4237,0.001884570082449941,-11.438581326530166
ZCTA5 24141,8781,101,8680,0.011502106821546522,-11.439631887988755
ZCTA5 77707,6714,56,6658,0.008340780458742925,-11.44354340356565
ZCTA5 63141,8652,98,8554,0.011326860841423949,-11.44594260626445
ZCTA5 40422,9142,109,9033,0.01192299278057318,-11.44861977021618
ZCTA5 30038,14252,231,14021,0.016208251473477406,-11.44957542648691
ZCTA5 15071,4532,13,4519,0.0028684907325684027,-11.450576555198198
ZCTA5 98177,8658,98,8560,0.01131901131901132,-11.453972460420717
ZCTA5 08009,5020,22,4998,0.004382470119521913,-11.454776446811003
ZCTA5 29170,8435,93,8342,0.01102548903378779,-11.45541852132772
ZCTA5 60526,5126,24,5102,0.0046820132657042525,-11.45581689364097
ZCTA5 46819,4086,5,4081,0.0012236906510034262,-11.457244003035736
ZCTA5 33187,5127,24,5103,0.004681100058513751,-11.457297895490278
ZCTA5 22554,17584,315,17269,0.017914012738853503,-11.459867909383151
ZCTA5 02720,13047,201,12846,0.015405840423085767,-11.46456024556839
ZCTA5 02155,22972,456,22516,0.01985025248128156,-11.466452450288362
ZCTA5 31220,5598,33,5565,0.005894962486602358,-11.466940783102995
ZCTA5 45030,7625,75,7550,0.009836065573770493,-11.469106060868292
ZCTA5 07840,11477,163,11314,0.014202317678835933,-11.469689199750073
ZCTA5 15065,4925,20,4905,0.0040609137055837565,-11.47136605982308
ZCTA5 05446,6830,58,6772,0.00849194729136164,-11.472501767066914
ZCTA5 62052,4926,20,4906,0.004060089321965083,-11.472852372072001
ZCTA5 38242,8404,92,8312,0.010947168015230843,-11.474277517670735
ZCTA5 91302,9513,117,9396,0.01229895931882687,-11.474687831803116
ZCTA5 57108,8451,93,8358,0.011004614838480652,-11.476949563215493
ZCTA5 53566,6546,52,6494,0.007943782462572564,-11.478088126495368
ZCTA5 34677,8810,101,8709,0.011464245175936435,-11.478269392258527
ZCTA5 78665,14639,240,14399,0.016394562470114078,-11.478626068933606
ZCTA5 48135,10681,144,10537,0.013481883718752925,-11.478856134671604
ZCTA5 30097,16232,280,15952,0.01724987678659438,-11.481044071951667
ZCTA5 17070,6884,59,6825,0.008570598489250436,-11.481474810077376
ZCTA5 80023,8047,84,7963,0.01043867279731577,-11.481589265512536
ZCTA5 45434,4663,15,4648,0.0032168132103795838,-11.482615411423957
ZCTA5 06029,7122,64,7058,0.008986239820275204,-11.483195876987406
ZCTA5 99516,7028,62,6966,0.008821855435401251,-11.483800648042639
ZCTA5 44057,7357,69,7288,0.00937882288976485,-11.483850076512692
ZCTA5 49849,5093,23,5070,0.004516002356175142,-11.48476741637985
ZCTA5 76248,12983,199,12784,0.015327736270507587,-11.48589771912965
ZCTA5 24503,7731,77,7654,0.009959901694476782,-11.487998623152126
ZCTA5 14215,16278,281,15997,0.01726256296842364,-11.488299596305376
ZCTA5 06096,5253,26,5227,0.004949552636588616,-11.489027586583612
ZCTA5 30033,13194,204,12990,0.015461573442473852,-11.493363557612284
ZCTA5 30276,5412,29,5383,0.0053584626755358465,-11.494318791775314
ZCTA5 80923,10310,135,10175,0.013094083414161009,-11.496715732763576
ZCTA5 32934,7132,64,7068,0.0089736399326977,-11.497172288686176
ZCTA5 01247,6752,56,6696,0.008293838862559242,-11.49733237175175
ZCTA5 45504,6657,54,6603,0.00811176205497972,-11.498777307295109
ZCTA5 19806,5156,24,5132,0.004654771140418929,-11.500168956680508
ZCTA5 22602,10699,144,10555,0.01345920179456024,-11.501571470173177
ZCTA5 35040,6275,46,6229,0.007330677290836653,-11.508072074209748
ZCTA5 89144,7328,68,7260,0.009279475982532752,-11.508488524837196
ZCTA5 19060,3827,0,3827,0,-11.509161069152135
ZCTA5 78259,9101,107,8994,0.011756949785737832,-11.511008897914326
ZCTA5 77059,5832,37,5795,0.0063443072702331965,-11.513317855709845
ZCTA5 81050,3950,2,3948,5.063291139240507e-4,-11.51568299452708
ZCTA5 50022,3835,0,3835,0,-11.521184223195007
ZCTA5 89005,6481,50,6431,0.007714858818083629,-11.523447228734751
ZCTA5 93449,4245,7,4238,0.0016489988221436984,-11.523935409359419
ZCTA5 78255,4360,9,4351,0.0020642201834862386,-11.526517425679359
ZCTA5 16407,4472,11,4461,0.0024597495527728087,-11.526532434075383
ZCTA5 35124,9292,111,9181,0.011945759793370642,-11.529956287965378
ZCTA5 32128,7854,79,7775,0.010058568882098294,-11.530397435521108
ZCTA5 06812,5019,21,4998,0.0041841004184100415,-11.531788733420246
ZCTA5 90803,16947,297,16650,0.017525225703664365,-11.53184294576743
ZCTA5 19010,7347,68,7279,0.009255478426568667,-11.534837365028977
ZCTA5 66610,3846,0,3846,0,-11.537695602451313
ZCTA5 02840,10600,141,10459,0.01330188679245283,-11.538305877933727
ZCTA5 85340,10558,140,10418,0.013260087137715476,-11.53930936020765
ZCTA5 23061,8319,89,8230,0.010698401250150258,-11.542283456812319
ZCTA5 23238,10818,146,10672,0.01349602514327972,-11.544058874001315
ZCTA5 62035,6788,56,6732,0.008249852681202121,-11.54809558928933
ZCTA5 29651,17473,310,17163,0.017741658558919477,-11.550337805154658
ZCTA5 27530,15741,266,15475,0.01689854520043199,-11.551196285644993
ZCTA5 44137,9485,115,9370,0.012124406958355299,-11.552326675791587
ZCTA5 31406,13452,209,13243,0.015536723163841809,-11.55672088675186
ZCTA5 28079,12635,189,12446,0.014958448753462604,-11.56175880385728
ZCTA5 90272,9008,104,8904,0.011545293072824156,-11.56375880708086
ZCTA5 57078,7880,79,7801,0.010025380710659898,-11.565850476600794
ZCTA5 71909,7510,71,7439,0.009454061251664448,-11.566388118238855
ZCTA5 40351,7419,69,7350,0.009300444803881924,-11.569680887512984
ZCTA5 34746,12766,192,12574,0.015039949866833777,-11.570330631446744
ZCTA5 77581,16904,295,16609,0.01745149077141505,-11.570516413954483
ZCTA5 44089,6563,51,6512,0.007770836507694652,-11.570898453874813
ZCTA5 92014,5924,38,5886,0.006414584740040513,-11.573693385968793
ZCTA5 75022,7933,80,7853,0.010084457330139922,-11.57541904125223
ZCTA5 34103,6126,42,6084,0.0068560235063663075,-11.577220709436839
ZCTA5 80007,4282,7,4275,0.0016347501167678655,-11.579233702513491
ZCTA5 43040,11903,171,11732,0.014366126186675628,-11.581227493572179
ZCTA5 06066,13105,200,12905,0.015261350629530714,-11.582000031412452
ZCTA5 45237,9288,110,9178,0.011843238587424634,-11.582420562759586
ZCTA5 33647,24218,486,23732,0.020067718226112807,-11.585114670557129
ZCTA5 27006,5781,35,5746,0.006054315862307559,-11.585482901315858
ZCTA5 44052,11571,163,11408,0.014086941491660185,-11.585581860617172
ZCTA5 10512,9335,111,9224,0.011890733797536154,-11.586169422835678
ZCTA5 94960,6380,47,6333,0.007366771159874608,-11.587922598262319
ZCTA5 44054,5004,20,4984,0.003996802557953637,-11.588224485946816
ZCTA5 19145,18329,331,17998,0.01805881390146762,-11.591096194331572
ZCTA5 02482,3886,0,3886,0,-11.597538823404573
ZCTA5 89521,11875,170,11705,0.01431578947368421,-11.5981024970478
ZCTA5 49858,5741,34,5707,0.005922313185856122,-11.600953196814865
ZCTA5 63084,7301,66,7235,0.009039857553759759,-11.601128339543811
ZCTA5 00784,14143,225,13918,0.015908930212826133,-11.60366521374585
ZCTA5 33414,19617,364,19253,0.01855533465871438,-11.60470425127056
ZCTA5 55436,5642,32,5610,0.005671747607231478,-11.605157489332171
ZCTA5 52101,5123,22,5101,0.004294358774155768,-11.606765634228637
ZCTA5 48336,10873,146,10727,0.013427756828842086,-11.61295475799851
ZCTA5 07762,3897,0,3897,0,-11.61394165089541
ZCTA5 15137,4644,13,4631,0.0027993109388458224,-11.617420274106959
ZCTA5 21704,5236,24,5212,0.004583651642475172,-11.617662114899234
ZCTA5 44139,8784,98,8686,0.011156648451730419,-11.621640812977683
ZCTA5 18031,3904,0,3904,0,-11.624367762845202
ZCTA5 29650,13346,205,13141,0.01536040761276787,-11.624371871878648
ZCTA5 79606,10108,128,9980,0.012663237039968342,-11.624422850582246
ZCTA5 21811,9979,125,9854,0.012526305241006112,-11.62607781517495
ZCTA5 53589,7925,79,7846,0.00996845425867508,-11.627010112559814
ZCTA5 37203,7694,74,7620,0.009617884065505589,-11.627310509179638
ZCTA5 23453,12403,182,12221,0.014673869225187455,-11.6313707085581
ZCTA5 02818,7466,69,7397,0.009241896597910528,-11.634403792326665
ZCTA5 47240,8570,93,8477,0.010851808634772461,-11.636138908295973
ZCTA5 15226,6320,45,6275,0.007120253164556962,-11.642291119631885
ZCTA5 81007,11365,157,11208,0.013814342278926528,-11.643600494725407
ZCTA5 21044,17952,320,17632,0.017825311942959002,-11.645255431834316
ZCTA5 50125,7805,76,7729,0.009737347853939782,-11.652189818664846
ZCTA5 21136,12877,193,12684,0.01498796303486837,-11.653330403970868
ZCTA5 63052,9870,122,9748,0.012360688956433637,-11.6539087804714
ZCTA5 63108,10778,143,10635,0.0132677676748933,-11.65447913817999
ZCTA5 14467,3925,0,3925,0,-11.65559014088474
ZCTA5 12118,6624,51,6573,0.007699275362318841,-11.65693634116043
ZCTA5 70454,11295,155,11140,0.013722886232846392,-11.661739983857014
ZCTA5 45152,4108,3,4105,7.302823758519961e-4,-11.663914042951557
ZCTA5 97056,4510,10,4500,0.0022172949002217295,-11.66594978020795
ZCTA5 48167,8908,100,8808,0.01122586439155815,-11.667052736325182
ZCTA5 03301,13178,200,12978,0.015176809834572773,-11.668183603989654
ZCTA5 21012,7724,74,7650,0.009580528223718281,-11.6682142868985
ZCTA5 33770,11686,164,11522,0.014033886702036626,-11.674906839912508
ZCTA5 31516,5381,26,5355,0.004831815647649135,-11.676191291238085
ZCTA5 15057,5949,37,5912,0.006219532694570516,-11.68175229667292
ZCTA5 80908,6050,39,6011,0.006446280991735537,-11.682418253498797
ZCTA5 75218,10417,134,10283,0.012863588365172315,-11.687046381955005
ZCTA5 02771,6004,38,5966,0.006329113924050633,-11.688409114078036
ZCTA5 32224,15868,266,15602,0.016763297201915807,-11.69244552660427
ZCTA5 16823,10982,147,10835,0.013385539974503733,-11.695621656666479
ZCTA5 92103,18118,323,17795,0.01782757478750414,-11.697278839050842
ZCTA5 13088,10035,125,9910,0.01245640259093174,-11.69759545104996
ZCTA5 14214,7978,79,7899,0.009902231135622963,-11.698718524909328
ZCTA5 13210,7979,79,7900,0.009900990099009901,-11.700068172338815
ZCTA5 11803,9556,114,9442,0.011929677689409795,-11.701343690973415
ZCTA5 15210,11072,149,10923,0.013457369942196531,-11.701415841553642
ZCTA5 30161,13454,206,13248,0.015311431544522075,-11.702902809184453
ZCTA5 94708,4812,15,4797,0.003117206982543641,-11.703053616695826
ZCTA5 92118,8396,88,8308,0.010481181515007145,-11.706265162566051
ZCTA5 35213,5559,29,5530,0.005216765605324698,-11.708128444953164
ZCTA5 63105,6563,49,6514,0.007466097821118391,-11.708189413562028
ZCTA5 19454,11421,157,11264,0.013746607127221784,-11.712507513014048
ZCTA5 53121,7288,64,7224,0.008781558726673985,-11.713423414231318
ZCTA5 08648,11846,167,11679,0.014097585682930947,-11.716004113351373
ZCTA5 02767,5198,22,5176,0.004232397075798384,-11.716260677337846
ZCTA5 49525,11299,154,11145,0.013629524736702363,-11.718993539958904
ZCTA5 78738,5977,37,5940,0.006190396519993308,-11.721737839164222
ZCTA5 44691,18065,321,17744,0.01776916689731525,-11.723814448728504
ZCTA5 32931,7155,61,7094,0.008525506638714186,-11.72649821110238
ZCTA5 31210,13967,218,13749,0.015608219374239278,-11.728874302980882
ZCTA5 72802,7629,71,7558,0.009306593262550794,-11.729295742775244
ZCTA5 14223,9886,121,9765,0.012239530649403196,-11.73034345068418
ZCTA5 42071,11943,169,11774,0.014150548438415808,-11.731686351612653
ZCTA5 80465,6085,39,6046,0.006409202958093673,-11.732246235470393
ZCTA5 53045,8508,90,8418,0.010578279266572637,-11.734278941748556
ZCTA5 63010,13931,217,13714,0.015576771229631756,-11.734390822803457
ZCTA5 21742,13235,200,13035,0.01511144692104269,-11.735208453783672
ZCTA5 32301,12947,193,12754,0.014906928245925696,-11.736238112072261
ZCTA5 49660,5631,30,5601,0.005327650506126798,-11.737433104035773
ZCTA5 53558,4671,12,4659,0.002569043031470777,-11.73866172865149
ZCTA5 98110,9857,120,9737,0.012174089479557676,-11.749257226954098
ZCTA5 97225,11537,159,11378,0.01378174568778712,-11.750848537411436
ZCTA5 22066,5796,33,5763,0.005693581780538302,-11.75323016917539
ZCTA5 60462,15364,252,15112,0.016401978651392868,-11.754320137496997
ZCTA5 20603,10944,145,10799,0.013249269005847953,-11.754647819943642
ZCTA5 22308,4458,8,4450,0.001794526693584567,-11.755477793926945
ZCTA5 02917,4683,12,4671,0.0025624599615631004,-11.756235885385582
ZCTA5 07480,5951,36,5915,0.006049403461603092,-11.756701361868188
ZCTA5 15005,3995,0,3995,0,-11.75906602103269
ZCTA5 19050,10991,146,10845,0.013283595669183877,-11.75984842579937
ZCTA5 37615,9116,103,9013,0.0112988152698552,-11.76374410873924
ZCTA5 98029,11251,152,11099,0.01350991023020176,-11.76463234555348
ZCTA5 32233,9518,112,9406,0.011767177978566926,-11.766218425271136
ZCTA5 20007,11888,167,11721,0.014047779273216689,-11.766954996734578
ZCTA5 18960,4801,14,4787,0.0029160591543428453,-11.76717726587923
ZCTA5 15632,4003,0,4003,0,-11.770833915917596
ZCTA5 50014,12311,177,12134,0.014377386077491673,-11.771092703678578
ZCTA5 02351,6413,45,6368,0.007016996725401528,-11.773621997182966
ZCTA5 60805,6998,57,6941,0.008145184338382395,-11.774059272108495
ZCTA5 33469,6805,53,6752,0.007788390889052168,-11.774243335297074
ZCTA5 16803,10400,132,10268,0.012692307692307692,-11.774643944178802
ZCTA5 06413,5451,26,5425,0.004769767015226564,-11.777368259335004
ZCTA5 31024,8175,82,8093,0.010030581039755352,-11.777739316393477
ZCTA5 30019,14134,221,13913,0.01563605490307061,-11.780382308197536
ZCTA5 44714,4010,0,4010,0,-11.781121181432077
ZCTA5 45415,5616,29,5587,0.005163817663817663,-11.79006695187691
ZCTA5 80132,7106,59,7047,0.008302842668167746,-11.790657620617994
ZCTA5 40220,14393,227,14166,0.01577155561731397,-11.797425268421057
ZCTA5 23692,7303,63,7240,0.00862659181158428,-11.799117986532991
ZCTA5 85715,7731,72,7659,0.009313154831199068,-11.804237540843696
ZCTA5 42420,15411,252,15159,0.016351956394782947,-11.806818823013124
ZCTA5 19146,16967,291,16676,0.017150940060116696,-11.809770142248789
ZCTA5 60050,12470,180,12290,0.014434643143544507,-11.811305286563472
ZCTA5 03909,4441,7,4434,0.0015762215717180816,-11.813945924004894
ZCTA5 03031,4036,0,4036,0,-11.819252633148864
ZCTA5 37917,11127,148,10979,0.013300979599173183,-11.822183860706824
ZCTA5 46322,9473,110,9363,0.011611949751926528,-11.822389833306056
ZCTA5 14031,4039,0,4039,0,-11.823644502737416
ZCTA5 55033,11724,162,11562,0.013817809621289662,-11.823983121774305
ZCTA5 19438,9520,111,9409,0.011659663865546219,-11.825791971177345
ZCTA5 99352,12775,187,12588,0.014637964774951077,-11.827078364234158
ZCTA5 62002,13397,202,13195,0.015078002537881616,-11.82833841046886
ZCTA5 45342,15632,257,15375,0.016440634595701126,-11.829517067578925
ZCTA5 35660,4045,0,4045,0,-11.83242335149252
ZCTA5 70461,10098,124,9974,0.012279659338482869,-11.833026596166885
ZCTA5 42718,9659,114,9545,0.011802464023190807,-11.83376506066141
ZCTA5 28557,6897,54,6843,0.0078294910830796,-11.834585114132432
ZCTA5 53094,7569,68,7501,0.008984013740256308,-11.8391507589947
ZCTA5 07052,16281,273,16008,0.016768011792887415,-11.840283679085246
ZCTA5 43545,5859,33,5826,0.0056323604710701485,-11.84299396630159
ZCTA5 54017,6662,49,6613,0.007355148604022816,-11.846525819441204
ZCTA5 22205,6711,50,6661,0.007450454477723141,-11.846593820369707
ZCTA5 02053,4691,11,4680,0.0023449157962055,-11.849132918303802
ZCTA5 27030,15090,243,14847,0.01610337972166998,-11.853019906922766
ZCTA5 23235,13047,193,12854,0.014792672645052502,-11.854051582996785
ZCTA5 73071,17167,295,16872,0.01718413234694472,-11.854985496093507
ZCTA5 29340,7297,62,7235,0.008496642455803755,-11.856001902490092
ZCTA5 11576,4585,9,4576,0.0019629225736095966,-11.85833665819863
ZCTA5 47274,12006,168,11838,0.013993003498250875,-11.858587321976914
ZCTA5 60118,6474,45,6429,0.006950880444856348,-11.859068468542917
ZCTA5 44710,4066,0,4066,0,-11.86309816259481
ZCTA5 01095,5353,23,5330,0.00429665608070241,-11.863516606545836
ZCTA5 63143,4977,16,4961,0.0032147880249146074,-11.863723551643124
ZCTA5 14625,4361,5,4356,0.0011465260261407934,-11.864858021061922
ZCTA5 23601,10519,133,10386,0.012643787432265425,-11.869490986124847
ZCTA5 92660,15268,247,15021,0.016177626408173957,-11.871704498545538
ZCTA5 04038,5982,35,5947,0.005850885991307255,-11.872668829797652
ZCTA5 97202,18402,326,18076,0.017715465710248887,-11.873173817271452
ZCTA5 72118,8522,88,8434,0.010326214503637644,-11.873332918916597
ZCTA5 18411,8796,94,8702,0.010686675761709868,-11.874696174994986
ZCTA5 32951,5310,22,5288,0.004143126177024482,-11.87798762128023
ZCTA5 15120,8486,87,8399,0.010252180061277398,-11.886154756535214
ZCTA5 01002,9877,118,9759,0.011946947453680268,-11.88670830720628
ZCTA5 02343,4085,0,4085,0,-11.890783376821627
ZCTA5 43201,12412,177,12235,0.01426039316790203,-11.891763599415267
ZCTA5 80516,8991,98,8893,0.010899788677566455,-11.89322384065188
ZCTA5 16301,6598,47,6551,0.007123370718399515,-11.894184042146652
ZCTA5 32935,17006,290,16716,0.01705280489239092,-11.894503878808372
ZCTA5 44113,9441,108,9333,0.011439466158245948,-11.89560566053654
ZCTA5 27517,10805,139,10666,0.012864414622859787,-11.902231511439643
ZCTA5 32459,6356,42,6314,0.006607929515418502,-11.902545530469855
ZCTA5 45103,12425,177,12248,0.014245472837022133,-11.907238422673839
ZCTA5 03087,5010,16,4994,0.0031936127744510976,-11.911324877015364
ZCTA5 38017,18871,337,18534,0.01785808913147157,-11.914567791622531
ZCTA5 78660,29945,631,29314,0.021071965269661045,-11.915878591628953
ZCTA5 28037,8048,77,7971,0.009567594433399603,-11.916877270214233
ZCTA5 78260,8692,91,8601,0.010469397146801656,-11.91693914657932
ZCTA5 30082,11504,155,11349,0.013473574408901252,-11.917845150708901
ZCTA5 49504,15189,244,14945,0.01606425702811245,-11.918651702726722
ZCTA5 19425,5178,19,5159,0.0036693704132869836,-11.919005208792994
ZCTA5 07922,4107,0,4107,0,-11.92275962747514
ZCTA5 40206,9691,113,9578,0.011660303374264781,-11.931177702141813
ZCTA5 05495,4113,0,4113,0,-11.931465550232458
ZCTA5 80113,10395,129,10266,0.01240981240981241,-11.931985158952799
ZCTA5 23851,5507,25,5482,0.004539676775013619,-11.932665385306194
ZCTA5 00956,24585,486,24099,0.01976815131177547,-11.933776509714782
ZCTA5 98026,14474,226,14248,0.015614204780986596,-11.93585038978105
ZCTA5 38834,11221,148,11073,0.013189555298101773,-11.937653797867066
ZCTA5 23693,8892,95,8797,0.010683760683760684,-11.940849516622478
ZCTA5 53150,9521,109,9412,0.011448377271295032,-11.941063668142677
ZCTA5 97217,14480,226,14254,0.015607734806629834,-11.94265367779648
ZCTA5 16505,7599,67,7532,0.008816949598631399,-11.943578737952999
ZCTA5 98221,9523,109,9414,0.011445972907697154,-11.943622602688649
ZCTA5 26554,17052,290,16762,0.017006802721088437,-11.943986260085703
ZCTA5 47303,10405,129,10276,0.012397885631907737,-11.944488685558017
ZCTA5 95747,22670,435,22235,0.019188354653727393,-11.945048607437021
ZCTA5 92106,7461,64,7397,0.008577938614126793,-11.949442405494807
ZCTA5 44126,7126,57,7069,0.007998877350547292,-11.949933938481335
ZCTA5 48001,5308,21,5287,0.003956292388847023,-11.951448434978875
ZCTA5 19350,4127,0,4127,0,-11.951754708298157
ZCTA5 02026,9974,119,9855,0.01193102065369962,-11.953779748672101
ZCTA5 72715,7179,58,7121,0.008079119654547988,-11.956481456704664
ZCTA5 20855,5042,16,5026,0.0031733439111463705,-11.95730824498784
ZCTA5 56649,4132,0,4132,0,-11.9589924941661
ZCTA5 78261,5735,29,5706,0.005056669572798605,-11.959449428633292
ZCTA5 61615,9802,115,9687,0.011732299530708019,-11.959672920135292
ZCTA5 90740,12515,178,12337,0.014222932481022773,-11.964308366883332
ZCTA5 14092,4827,12,4815,0.002486016159105034,-11.965152143549172
ZCTA5 63042,8823,93,8730,0.010540632437946278,-11.96919479005603
ZCTA5 32976,4662,9,4653,0.0019305019305019305,-11.969806257799123
ZCTA5 23221,7382,62,7320,0.008398807911135195,-11.971600797000574
ZCTA5 47119,4142,0,4142,0,-11.973454940488526
ZCTA5 85718,12569,179,12390,0.014241387540774923,-11.978586393297064
ZCTA5 45405,8234,80,8154,0.009715812484819043,-11.979003634123595
ZCTA5 31411,4147,0,4147,0,-11.980679616787318
ZCTA5 14227,10392,128,10264,0.012317167051578136,-11.982784658077533
ZCTA5 45805,9286,103,9183,0.011091966401033814,-11.983774417112599
ZCTA5 26201,7536,65,7471,0.008625265392781316,-11.986504149879524
ZCTA5 08085,6813,50,6763,0.007338910905621606,-11.987482889267135
ZCTA5 23451,19992,364,19628,0.018207282913165267,-11.988772337346179
ZCTA5 68123,11521,154,11367,0.013366895234788647,-11.990325454170984
ZCTA5 19008,7252,59,7193,0.00813568670711528,-11.990328779567538
ZCTA5 25404,8428,84,8344,0.009966777408637873,-11.991173451739579
ZCTA5 27539,7918,73,7845,0.009219499873705482,-11.992491812540974
ZCTA5 62220,7493,64,7429,0.008541305218203657,-11.992675088251183
ZCTA5 62234,13375,198,13177,0.014803738317757009,-11.995014542556525
ZCTA5 00927,5972,33,5939,0.005525787006028131,-12.002454610113181
ZCTA5 48381,5504,24,5480,0.00436046511627907,-12.003352872632892
ZCTA5 34465,7929,73,7856,0.00920670954723168,-12.007152793203758
ZCTA5 97035,11149,145,11004,0.013005650731007266,-12.007280476803654
ZCTA5 28387,6878,51,6827,0.007414946205292236,-12.009463060485537
ZCTA5 08077,6880,51,6829,0.007412790697674419,-12.012203278577951
ZCTA5 92692,17552,301,17251,0.01714904284412033,-12.013035375493779
ZCTA5 23226,6979,53,6926,0.0075942112050437025,-12.014035409476314
ZCTA5 33772,9934,117,9817,0.011777733038051137,-12.014749267154386
ZCTA5 46703,7319,60,7259,0.008197841235141412,-12.016019032125026
ZCTA5 02914,8769,91,8678,0.010377466073668606,-12.01748126626616
ZCTA5 45807,4919,13,4906,0.002642813579995934,-12.017482403661946
ZCTA5 21085,6238,38,6200,0.006091696056428343,-12.018283737154912
ZCTA5 15209,5674,27,5647,0.004758547761720127,-12.020558889446878
ZCTA5 46055,4175,0,4175,0,-12.021057563375592
ZCTA5 17972,4755,10,4745,0.002103049421661409,-12.02243881466045
ZCTA5 44903,9451,106,9345,0.01121574436567559,-12.02285520277532
ZCTA5 85737,9541,108,9433,0.011319568179436117,-12.023568057841258
ZCTA5 00907,8640,88,8552,0.010185185185185186,-12.028152777861168
ZCTA5 21244,13196,193,13003,0.014625644134586238,-12.028250117532341
ZCTA5 45426,7041,54,6987,0.007669365146996165,-12.032212818431509
ZCTA5 11763,9420,105,9315,0.011146496815286623,-12.040497083190834
ZCTA5 19086,4189,0,4189,0,-12.041195761756086
ZCTA5 62450,5156,17,5139,0.0032971295577967417,-12.042300569914834
ZCTA5 28607,12371,173,12198,0.01398431816344677,-12.042869142466323
ZCTA5 44147,7483,63,7420,0.00841908325537886,-12.043466168107297
ZCTA5 85390,4191,0,4191,0,-12.044069898510648
ZCTA5 89434,10705,134,10571,0.012517515179822513,-12.046625850997156
ZCTA5 91423,15305,244,15061,0.01594250245017968,-12.047842626228576
ZCTA5 83815,13837,208,13629,0.015032160150321602,-12.050997562691238
ZCTA5 45202,7915,72,7843,0.009096651926721416,-12.050999132521278
ZCTA5 19014,7868,71,7797,0.009023894255210982,-12.051055940117221
ZCTA5 71270,12167,168,11999,0.013807840881071752,-12.051415793465477
ZCTA5 48302,6364,40,6324,0.006285355122564425,-12.053139855465577
ZCTA5 73118,6365,40,6325,0.006284367635506678,-12.05452491726276
ZCTA5 33305,6466,42,6424,0.006495515001546551,-12.055368681107506
ZCTA5 74055,16680,278,16402,0.016666666666666666,-12.057279687596766
ZCTA5 98403,4201,0,4201,0,-12.05843030649505
ZCTA5 46143,20836,384,20452,0.01842964100595124,-12.060726843931338
ZCTA5 77346,20953,387,20566,0.018469908843602348,-12.062126736330587
ZCTA5 77019,10935,139,10796,0.012711476909007773,-12.062556038569634
ZCTA5 98053,8251,79,8172,0.009574597018543208,-12.062697593723477
ZCTA5 80521,13145,191,12954,0.014530239634842144,-12.065813407937002
ZCTA5 45891,6225,37,6188,0.005943775100401606,-12.070656811510094
ZCTA5 49505,13150,191,12959,0.014524714828897339,-12.071631189854262
ZCTA5 19608,8120,76,8044,0.00935960591133005,-12.074291758589348
ZCTA5 60304,6382,40,6342,0.006267627702914447,-12.078049091028637
ZCTA5 66206,4215,0,4215,0,-12.078506194374432
ZCTA5 55811,10949,139,10810,0.012695223308064663,-12.079733383793107
ZCTA5 33511,21972,413,21559,0.018796650282177318,-12.082610640945765
ZCTA5 19046,7131,55,7076,0.007712803253400645,-12.088469149341547
ZCTA5 32926,8365,81,8284,0.009683203825463239,-12.090503962880774
ZCTA5 07853,4225,0,4225,0,-12.092825708821307
ZCTA5 15801,7759,68,7691,0.008764015981440908,-12.094591879416624
ZCTA5 49037,8647,87,8560,0.010061292933965538,-12.09709213793701
ZCTA5 63034,6647,45,6602,0.006769971415676245,-12.098497585991106
ZCTA5 11790,4466,4,4462,8.956560680698612e-4,-12.100077147224669
ZCTA5 37766,7622,65,7557,0.008527945421149305,-12.101954217757875
ZCTA5 33706,8513,84,8429,0.009867261834840832,-12.102551550390585
ZCTA5 34461,4232,0,4232,0,-12.102839288340615
ZCTA5 21532,5522,23,5499,0.004165157551611735,-12.103674996888465
ZCTA5 72143,12844,183,12661,0.014247897851136717,-12.104815335527976
ZCTA5 16105,6553,43,6510,0.006561880054936671,-12.106324141921585
ZCTA5 40228,6455,41,6414,0.0063516653756777695,-12.109381714139067
ZCTA5 34109,11148,143,11005,0.012827412988876928,-12.111397290795688
ZCTA5 49286,5845,29,5816,0.004961505560307955,-12.114058816568665
ZCTA5 53022,7679,66,7613,0.0085948691235838,-12.114507916664905
ZCTA5 70563,7006,52,6954,0.007422209534684556,-12.117315439273314
ZCTA5 32086,11586,153,11433,0.01320559295701709,-12.120655848586944
ZCTA5 55350,7826,69,7757,0.00881676463071812,-12.120748419416417
ZCTA5 32114,13528,199,13329,0.01471023063276168,-12.12390860668842
ZCTA5 32258,12186,167,12019,0.013704250779583128,-12.12441526689737
ZCTA5 14606,11590,153,11437,0.013201035375323555,-12.125476558021639
ZCTA5 53158,6265,37,6228,0.005905826017557861,-12.126080111029447
ZCTA5 32903,6012,32,5980,0.0053226879574184965,-12.130158365678737
ZCTA5 47711,13160,190,12970,0.014437689969604863,-12.131738369273055
ZCTA5 11776,7929,71,7858,0.008954470929499306,-12.132058975353889
ZCTA5 33950,11210,144,11066,0.012845673505798395,-12.134277831435442
ZCTA5 37129,20608,376,20232,0.018245341614906832,-12.141688744430407
ZCTA5 50312,7607,64,7543,0.008413303536216643,-12.145645020441927
ZCTA5 84075,7750,67,7683,0.00864516129032258,-12.145762907899787
ZCTA5 32169,5448,21,5427,0.003854625550660793,-12.149765285608293
ZCTA5 43558,5235,17,5218,0.0032473734479465137,-12.154225837286246
ZCTA5 19129,4387,2,4385,4.5589240939138365e-4,-12.154561081391623
ZCTA5 80911,11573,152,11421,0.013134018836948069,-12.156673540590809
ZCTA5 53142,12217,167,12050,0.013669476958336743,-12.161201731639906
ZCTA5 48072,6643,44,6599,0.006623513472828541,-12.161239953024442
ZCTA5 33629,10454,126,10328,0.012052802754926343,-12.16879360094723
ZCTA5 85250,8614,85,8529,0.009867657302066403,-12.173929337777455
ZCTA5 18013,6703,45,6658,0.006713411905117111,-12.175106279907437
ZCTA5 16509,12103,164,11939,0.01355035941502107,-12.177205226483307
ZCTA5 26354,4285,0,4285,0,-12.178389221988986
ZCTA5 28031,11592,152,11440,0.013112491373360938,-12.179538045901849
ZCTA5 21047,4288,0,4288,0,-12.182651622827187
ZCTA5 05201,5895,29,5866,0.004919423240033927,-12.183730453968485
ZCTA5 46975,5686,25,5661,0.004396763981709462,-12.18497388613894
ZCTA5 32092,11984,161,11823,0.013434579439252336,-12.187677673264796
ZCTA5 98006,13417,195,13222,0.014533800402474473,-12.187715122567353
ZCTA5 20659,7926,70,7856,0.008831693161746153,-12.190550516476089
ZCTA5 70448,9178,97,9081,0.010568751361952495,-12.192634106952617
ZCTA5 58401,7738,66,7672,0.008529335745670715,-12.193016784134524
ZCTA5 94549,10869,135,10734,0.012420645873585427,-12.19471413253446
ZCTA5 33426,9361,101,9260,0.010789445572054268,-12.194843560564298
ZCTA5 90274,9089,95,8994,0.010452194960941798,-12.195169053976395
ZCTA5 80305,7065,52,7013,0.007360226468506723,-12.19720348785035
ZCTA5 27712,8354,79,8275,0.009456547761551352,-12.197758520284962
ZCTA5 45638,8540,83,8457,0.009718969555035128,-12.197938468666717
ZCTA5 85259,9500,104,9396,0.010947368421052631,-12.199450334689791
ZCTA5 55014,9682,108,9574,0.011154720099153068,-12.202291104282196
ZCTA5 53227,11008,138,10870,0.012536337209302325,-12.204941224120033
ZCTA5 01301,7989,71,7918,0.008887219927400176,-12.211302895934956
ZCTA5 67037,10708,131,10577,0.012233843855061636,-12.211556045954048
ZCTA5 53029,7896,69,7827,0.008738601823708206,-12.213459881620114
ZCTA5 28348,12305,168,12137,0.013652986590816742,-12.2150948372456
ZCTA5 12302,9783,110,9673,0.011243994684657059,-12.216666331039432
ZCTA5 54701,16106,260,15846,0.016143052278653917,-12.217549158507193
ZCTA5 21108,6484,40,6444,0.006169031462060457,-12.218336357642187
ZCTA5 01540,4316,0,4316,0,-12.222362350423927
ZCTA5 60473,7279,56,7223,0.007693364473141915,-12.222492622645117
ZCTA5 85382,15463,244,15219,0.015779602923106772,-12.22252009507634
ZCTA5 46168,12819,180,12639,0.01404165691551603,-12.22288590254799
ZCTA5 44906,7232,55,7177,0.007605088495575221,-12.2247167483032
ZCTA5 34683,13367,193,13174,0.014438542679733673,-12.226230826444985
ZCTA5 48059,5927,29,5898,0.0048928631685507,-12.228125640733671
ZCTA5 18104,16279,264,16015,0.01621721235948154,-12.230370753943207
ZCTA5 27608,4845,9,4836,0.0018575851393188853,-12.230698846924096
ZCTA5 40223,9435,102,9333,0.010810810810810811,-12.231408681382858
ZCTA5 48602,12234,166,12068,0.01356874284780121,-12.231621756489291
ZCTA5 49534,8798,88,8710,0.010002273243919073,-12.233044883201869
ZCTA5 19121,11980,160,11820,0.01335559265442404,-12.23372146755539
ZCTA5 64029,6395,38,6357,0.005942142298670836,-12.235092988508306
ZCTA5 01752,15718,250,15468,0.015905331467107774,-12.235229819820363
ZCTA5 36092,7441,59,7382,0.0079290417954576,-12.244698098371947
ZCTA5 44471,4334,0,4334,0,-12.247822686116857
ZCTA5 17408,9404,101,9303,0.010740110591237771,-12.249425820644745
ZCTA5 54166,7350,57,7293,0.007755102040816327,-12.252523119131538
ZCTA5 16201,7448,59,7389,0.007921589688506982,-12.254032776535698
ZCTA5 33966,4343,0,4343,0,-12.26053302729159
ZCTA5 71913,19836,353,19483,0.017795926598104455,-12.264093071796706
ZCTA5 14222,6468,39,6429,0.006029684601113173,-12.265574554394883
ZCTA5 48451,5205,15,5190,0.002881844380403458,-12.266004451265895
ZCTA5 64110,6919,48,6871,0.006937418702124584,-12.266097927092929
ZCTA5 48240,6722,44,6678,0.006545670931270455,-12.268830201811822
ZCTA5 59701,14647,223,14424,0.015224960742814228,-12.268944697290099
ZCTA5 85050,11797,155,11642,0.013138933627193355,-12.270789701283858
ZCTA5 02332,5590,22,5568,0.003935599284436494,-12.273418522824334
ZCTA5 19525,5644,23,5621,0.00407512402551382,-12.274265459578267
ZCTA5 06067,8599,83,8516,0.009652285149435981,-12.274390034856642
ZCTA5 17740,4933,10,4923,0.002027163997567403,-12.275037005902874
ZCTA5 60430,7848,67,7781,0.008537206931702344,-12.275498456542014
ZCTA5 98136,7561,61,7500,0.008067715910593836,-12.27597987681045
ZCTA5 15963,4706,6,4700,0.0012749681257968552,-12.276242195043814
ZCTA5 55057,8088,72,8016,0.008902077151335312,-12.27930085103934
ZCTA5 50401,13041,184,12857,0.014109347442680775,-12.28528190933594
ZCTA5 22182,9069,93,8976,0.010254713860403573,-12.28632891692254
ZCTA5 01721,6685,43,6642,0.006432311144353029,-12.286561238651322
ZCTA5 28540,17336,289,17047,0.016670512228887862,-12.289275070982589
ZCTA5 33903,10508,125,10383,0.011895698515416825,-12.289741372196543
ZCTA5 05468,5278,16,5262,0.0030314513073133762,-12.29127667505005
ZCTA5 63026,16579,270,16309,0.016285662585198143,-12.293537227526166
ZCTA5 85284,7090,51,7039,0.007193229901269393,-12.296962431657363
ZCTA5 97524,5977,29,5948,0.004851932407562322,-12.297193022630871
ZCTA5 19444,4370,0,4370,0,-12.298585235772263
ZCTA5 39560,7093,51,7042,0.007190187508811504,-12.30098870001611
ZCTA5 30016,18064,307,17757,0.016995128432240922,-12.302028970550285
ZCTA5 32081,4374,0,4374,0,-12.304212591470886
ZCTA5 30294,13977,206,13771,0.014738498962581384,-12.304879760380956
ZCTA5 48060,16429,266,16163,0.016190881976991905,-12.305357195444056
ZCTA5 48316,10785,131,10654,0.012146499768196569,-12.30582702374969
ZCTA5 34638,8484,80,8404,0.00942951438000943,-12.306146550129375
ZCTA5 34747,7147,52,7095,0.007275780047572408,-12.30748421435067
ZCTA5 46268,10787,131,10656,0.012144247705571522,-12.308268734370222
ZCTA5 07866,8439,79,8360,0.00936129873207726,-12.308315817710001
ZCTA5 23834,9812,109,9703,0.011108846310640033,-12.309207971851748
ZCTA5 46845,8253,75,8178,0.009087604507451835,-12.310191334620987
ZCTA5 13827,5238,15,5223,0.0028636884306987398,-12.312134035809102
ZCTA5 08844,13613,197,13416,0.014471461103357085,-12.316861921467352
ZCTA5 08755,10312,120,10192,0.011636927851047323,-12.320718382265483
ZCTA5 20175,11581,149,11432,0.012865901044814783,-12.321332712778645
ZCTA5 43952,7207,53,7154,0.0073539614263910084,-12.322127737418226
ZCTA5 70130,7596,61,7535,0.008030542390731964,-12.32237721698975
ZCTA5 44121,13785,201,13584,0.014581066376496192,-12.322864778682424
ZCTA5 02050,9779,108,9671,0.01104407403620002,-12.324111657121664
ZCTA5 46992,7012,49,6963,0.006988020536223617,-12.324694526761782
ZCTA5 42003,11972,158,11814,0.013197460741730706,-12.32585621945478
ZCTA5 03246,6967,48,6919,0.006889622506100187,-12.330757937314399
ZCTA5 54403,10542,125,10417,0.01185733257446405,-12.331514217422916
ZCTA5 45420,11762,153,11609,0.013007991838122769,-12.33154695966422
ZCTA5 01030,4394,0,4394,0,-12.332310852751268
ZCTA5 04401,18924,328,18596,0.017332487846121326,-12.333379902109133
ZCTA5 80403,8036,70,7966,0.008710801393728223,-12.335118586593726
ZCTA5 49456,7848,66,7782,0.008409785932721712,-12.33827301260601
ZCTA5 00921,13674,198,13476,0.014480035103115402,-12.338851435834156
ZCTA5 60558,4401,0,4401,0,-12.34213013155988
ZCTA5 02889,11209,140,11069,0.012489963422249978,-12.34316845795531
ZCTA5 44839,5370,17,5353,0.003165735567970205,-12.343213861526364
ZCTA5 81507,6220,33,6187,0.005305466237942123,-12.345763819674719
ZCTA5 45305,4406,0,4406,0,-12.349139121920697
ZCTA5 18337,5430,18,5412,0.0033149171270718232,-12.350845464999434
ZCTA5 32566,14019,206,13813,0.014694343391112061,-12.352427744827962
ZCTA5 18707,5914,27,5887,0.004565437943862023,-12.354736324974679
ZCTA5 38506,11393,144,11249,0.01263933994558062,-12.355397466833905
ZCTA5 29073,17399,289,17110,0.016610150008621184,-12.355863034428223
ZCTA5 17268,11913,156,11757,0.013094938302694535,-12.357675751471868
ZCTA5 97224,14563,219,14344,0.015038110279475382,-12.359108871976778
ZCTA5 80921,8151,72,8079,0.008833271991166729,-12.361577120613157
ZCTA5 53711,20946,379,20567,0.01809414685381457,-12.362542870074764
ZCTA5 01906,10436,122,10314,0.0116903027980069,-12.364251579752874
ZCTA5 45440,8993,90,8903,0.010007783831869232,-12.364963179743304
ZCTA5 40403,9131,93,9038,0.010185083780527873,-12.365256468091571
ZCTA5 83642,16727,272,16455,0.016261134692413463,-12.365928617229073
ZCTA5 63112,8390,77,8313,0.009177592371871275,-12.366107274747442
ZCTA5 44067,8204,73,8131,0.008898098488542174,-12.36904774675277
ZCTA5 44875,5819,25,5794,0.004296270836913559,-12.369289024434426
ZCTA5 45432,6393,36,6357,0.005631159080244017,-12.3714574083782
ZCTA5 34232,13538,194,13344,0.014330033978431083,-12.374396517054022
ZCTA5 67226,7972,68,7904,0.008529854490717512,-12.37574679400854
ZCTA5 44646,18928,327,18601,0.0172759932375317,-12.377907054813464
ZCTA5 20816,6090,30,6060,0.0049261083743842365,-12.38070186344411
ZCTA5 61254,4429,0,4429,0,-12.38132937314264
ZCTA5 55417,11026,135,10891,0.012243787411572647,-12.385748821301638
ZCTA5 64155,8360,76,8284,0.00909090909090909,-12.388054766138367
ZCTA5 60417,5780,24,5756,0.004152249134948097,-12.38865998830342
ZCTA5 32405,12496,169,12327,0.013524327784891165,-12.389513268149523
ZCTA5 33611,14838,225,14613,0.0151637687019814,-12.390132449293288
ZCTA5 15084,4613,3,4610,6.503360069369175e-4,-12.390263160292802
ZCTA5 55346,6201,32,6169,0.00516045799064667,-12.390395227255832
ZCTA5 29642,12327,165,12162,0.013385251886103676,-12.391318596660687
ZCTA5 54481,11467,145,11322,0.012644981250545043,-12.392098565787192
ZCTA5 08822,11727,151,11576,0.012876268440351326,-12.39251262107857
ZCTA5 46304,9428,99,9329,0.010500636402206194,-12.394356635007771
ZCTA5 68116,10991,134,10857,0.01219179328541534,-12.396388557140284
ZCTA5 66048,13222,186,13036,0.014067463318711238,-12.397026821684161
ZCTA5 37803,12375,166,12209,0.013414141414141415,-12.3975482566453
ZCTA5 29403,8510,79,8431,0.009283196239717979,-12.400051816943751
ZCTA5 11572,10155,115,10040,0.011324470704086657,-12.401670291311023
ZCTA5 30043,28171,568,27603,0.020162578538213054,-12.406345054838006
ZCTA5 34711,21224,385,20839,0.018139841688654353,-12.407291032681671
ZCTA5 45213,5687,22,5665,0.0038684719535783366,-12.407598931928279
ZCTA5 32312,12683,173,12510,0.013640305921311992,-12.409236518443384
ZCTA5 32653,5745,23,5722,0.004003481288076588,-12.413801290316583
ZCTA5 01520,5692,22,5670,0.003865073787772312,-12.414477842155822
ZCTA5 37110,13028,181,12847,0.013893153208474056,-12.416386126623667
ZCTA5 41101,7576,59,7517,0.007787750791974656,-12.423665686224533
ZCTA5 41075,6636,40,6596,0.006027727546714889,-12.424733161021825
ZCTA5 34442,6535,38,6497,0.005814843152257078,-12.425522260315931
ZCTA5 36117,22287,412,21875,0.01848611298066137,-12.426724926994929
ZCTA5 02915,7188,51,7137,0.0070951585976627716,-12.427895901823073
ZCTA5 28213,15895,250,15645,0.015728216420257943,-12.428106471814905
ZCTA5 57069,4464,0,4464,0,-12.430154589690455
ZCTA5 62521,14878,225,14653,0.015123000403280011,-12.434475755101506
ZCTA5 47591,10183,115,10068,0.011293332023961504,-12.436230209485661
ZCTA5 98115,22182,409,21773,0.018438373455955278,-12.436958008403467
ZCTA5 93012,13138,183,12955,0.013929060739838637,-12.445805620801172
ZCTA5 04330,11427,143,11284,0.012514220705346985,-12.44819928657262
ZCTA5 40383,9151,92,9059,0.010053546060539832,-12.448766900230591
ZCTA5 01778,5002,9,4993,0.001799280287884846,-12.450215951054725
ZCTA5 02474,11560,146,11414,0.012629757785467127,-12.451350863027649
ZCTA5 44109,17411,287,17124,0.01648383206019183,-12.452814721096027
ZCTA5 35126,7600,59,7541,0.0077631578947368425,-12.455251420633331
ZCTA5 60172,9018,89,8929,0.009869150587713461,-12.455350748700248
ZCTA5 02878,6710,41,6669,0.006110283159463488,-12.45620983852134
ZCTA5 77098,8130,70,8060,0.008610086100861008,-12.457554459458777
ZCTA5 39773,6201,31,6170,0.004999193678438961,-12.461015970119018
ZCTA5 30307,8884,86,8798,0.009680324178298064,-12.461442379420454
ZCTA5 24701,8279,73,8206,0.008817490035028385,-12.466245330303748
ZCTA5 29575,8187,71,8116,0.008672285330401857,-12.469851011605819
ZCTA5 06705,10031,111,9920,0.01106569634134184,-12.469851688539386
ZCTA5 63051,5186,12,5174,0.0023139220979560356,-12.471037230696373
ZCTA5 61920,9124,91,9033,0.009973695747479175,-12.472804571236281
ZCTA5 32750,9033,89,8944,0.009852762094542234,-12.474367186176385
ZCTA5 43528,6264,32,6232,0.005108556832694764,-12.47602089928286
ZCTA5 85747,8616,80,8536,0.009285051067780872,-12.476082476050147
ZCTA5 53005,7617,59,7558,0.007745831692267297,-12.477583128948242
ZCTA5 78734,7424,55,7369,0.007408405172413793,-12.48017188948465
ZCTA5 63628,5360,15,5345,0.002798507462686567,-12.481229615841455
ZCTA5 34223,8667,81,8586,0.009345794392523364,-12.48150411257341
ZCTA5 33626,11371,141,11230,0.012399964822794828,-12.485414494659235
ZCTA5 46530,10669,125,10544,0.011716187084075359,-12.486646970751272
ZCTA5 02745,10001,110,9891,0.010998900109989001,-12.488338872131669
ZCTA5 45011,24610,471,24139,0.019138561560341324,-12.48910084777527
ZCTA5 06478,4510,0,4510,0,-12.494034701047836
ZCTA5 37303,9644,102,9542,0.010576524263790958,-12.494088707351542
ZCTA5 75205,9238,93,9145,0.010067114093959731,-12.500550922870463
ZCTA5 34209,14484,214,14270,0.014774924054128693,-12.501686115017918
ZCTA5 07059,5153,11,5142,0.002134678827867262,-12.502849876914354
ZCTA5 34996,5598,19,5579,0.003394069310468024,-12.507519013461222
ZCTA5 54220,17223,281,16942,0.01631539220809383,-12.508332202213113
ZCTA5 60620,25239,487,24752,0.019295534688379096,-12.50901314004394
ZCTA5 07882,5545,18,5527,0.0032461677186654643,-12.509416966788839
ZCTA5 21212,12477,166,12311,0.013304480243648312,-12.51665577879992
ZCTA5 64133,14708,219,14489,0.014889855860756052,-12.52047262565894
ZCTA5 61107,13288,185,13103,0.013922335942203492,-12.52096343475475
ZCTA5 55016,11880,152,11728,0.012794612794612794,-12.52258662996411
ZCTA5 37745,7063,47,7016,0.006654396148945208,-12.525358514822022
ZCTA5 23150,5115,10,5105,0.0019550342130987292,-12.52811406839763
ZCTA5 64064,6612,38,6574,0.005747126436781609,-12.529132470940807
ZCTA5 48146,14265,208,14057,0.014581142656852435,-12.535522200869801
ZCTA5 94556,5949,25,5924,0.004202386955790889,-12.546964046944352
ZCTA5 18612,6265,31,6234,0.004948124501197127,-12.54763473755581
ZCTA5 32901,10722,125,10597,0.01165827271031524,-12.550972630585537
ZCTA5 01075,6682,39,6643,0.005836575875486381,-12.554617150944749
ZCTA5 50009,7037,46,6991,0.006536876509876368,-12.557106941877228
ZCTA5 01602,9695,102,9593,0.010520887055183083,-12.557546239257917
ZCTA5 07871,7039,46,6993,0.006535019178860633,-12.559757834045744
ZCTA5 71603,12728,171,12557,0.013434946574481459,-12.560073435188285
ZCTA5 44070,12987,177,12810,0.013629013629013628,-12.564231428485458
ZCTA5 37042,27938,557,27381,0.019937003364593028,-12.564610234999561
ZCTA5 30310,11309,138,11171,0.012202670439472986,-12.568008083017562
ZCTA5 01887,8028,66,7962,0.008221225710014948,-12.572919177637543
ZCTA5 07733,5758,21,5737,0.0036470996873914554,-12.578226929595813
ZCTA5 31909,15092,227,14865,0.01504108136761198,-12.579548701007562
ZCTA5 07860,9624,100,9524,0.010390689941812137,-12.582510093387109
ZCTA5 35811,10837,127,10710,0.01171911045492295,-12.582881418825645
ZCTA5 32780,15260,231,15029,0.015137614678899083,-12.58305507687534
ZCTA5 07481,5710,20,5690,0.0035026269702276708,-12.58640067896193
ZCTA5 37066,18699,316,18383,0.016899299427776886,-12.589260191017157
ZCTA5 48371,8892,84,8808,0.009446693657219974,-12.589567751069419
ZCTA5 01106,5826,22,5804,0.0037761757638173706,-12.597492102813819
ZCTA5 97415,6561,36,6525,0.0054869684499314125,-12.59790736666355
ZCTA5 15905,8948,85,8863,0.009499329459097004,-12.601459786983078
ZCTA5 72404,10274,114,10160,0.011095970410745571,-12.602923441311496
ZCTA5 60093,6871,42,6829,0.006112647358463106,-12.603671597216776
ZCTA5 46064,5283,12,5271,0.002271436683702442,-12.604300199257413
ZCTA5 23662,4590,0,4590,0,-12.604359444338751
ZCTA5 16830,5834,22,5812,0.0037709976002742542,-12.608337779876107
ZCTA5 62650,10593,121,10472,0.01142263759086189,-12.610110821555637
ZCTA5 60443,8201,69,8132,0.008413608096573589,-12.610781459313401
ZCTA5 34667,15450,235,15215,0.015210355987055016,-12.61086609536989
ZCTA5 14607,9647,100,9547,0.01036591686534674,-12.611067622489006
ZCTA5 59102,20853,370,20483,0.017743250371649165,-12.616858119808388
ZCTA5 19143,25508,491,25017,0.01924886310177199,-12.616950473602719
ZCTA5 33707,12349,161,12188,0.013037492914406024,-12.617281439030846
ZCTA5 98516,9607,99,9508,0.010304985947746434,-12.618107388194634
ZCTA5 53154,14466,211,14255,0.014585925618692106,-12.620329581192609
ZCTA5 45102,8683,79,8604,0.009098237936197167,-12.621303690082943
ZCTA5 94618,7285,50,7235,0.0068634179821551134,-12.621467147883399
ZCTA5 85234,15747,242,15505,0.01536800660443259,-12.621483867360949
ZCTA5 00716,11150,133,11017,0.011928251121076233,-12.640489179598093
ZCTA5 21078,7499,54,7445,0.007200960128017069,-12.642953689658041
ZCTA5 46112,13311,183,13128,0.013748027946810909,-12.643631998053946
ZCTA5 80301,11504,141,11363,0.012256606397774686,-12.643728352942386
ZCTA5 66221,5760,20,5740,0.003472222222222222,-12.65422003437816
ZCTA5 60013,9131,88,9043,0.009637498631037127,-12.656243731514422
ZCTA5 91784,8945,84,8861,0.009390721073225266,-12.656470907289172
ZCTA5 18049,7461,53,7408,0.00710360541482375,-12.657644672210205
ZCTA5 60154,6557,35,6522,0.005337806923898124,-12.661236109442397
ZCTA5 57783,6917,42,6875,0.006071996530287697,-12.664592230829365
ZCTA5 19136,12610,166,12444,0.01316415543219667,-12.67082077179313
ZCTA5 11783,7024,44,6980,0.006264236902050114,-12.67257310299317
ZCTA5 66205,5989,24,5965,0.004007346802471197,-12.67301424199126
ZCTA5 08062,5447,14,5433,0.0025702221406278683,-12.675811182078293
ZCTA5 20613,4643,0,4643,0,-12.676920848729312
ZCTA5 32825,20407,357,20050,0.017493997157837997,-12.679218294672829
ZCTA5 95765,12447,162,12285,0.013015184381778741,-12.681087996589183
ZCTA5 45067,5114,8,5106,0.001564333202972233,-12.682266833100169
ZCTA5 44056,4647,0,4647,0,-12.68238033255205
ZCTA5 44117,4942,5,4937,0.0010117361392148927,-12.683204881331841
ZCTA5 90266,13520,187,13333,0.013831360946745561,-12.688621046896579
ZCTA5 02184,14074,200,13874,0.014210601108426887,-12.695778313669564
ZCTA5 30277,7738,58,7680,0.007495476867407599,-12.698770138169948
ZCTA5 29860,5901,22,5879,0.0037281816641247245,-12.698821452031044
ZCTA5 19406,10311,113,10198,0.010959169818640287,-12.70284718880913
ZCTA5 60610,23269,430,22839,0.018479522110963084,-12.703135415589614
ZCTA5 55364,6381,31,6350,0.00485817270020373,-12.703224465187052
ZCTA5 46237,15005,222,14783,0.014795068310563146,-12.710824594565288
ZCTA5 55075,8087,65,8022,0.00803759119574626,-12.710871162061578
ZCTA5 18914,7650,56,7594,0.007320261437908497,-12.711580461012213
ZCTA5 52403,9777,101,9676,0.010330367188299069,-12.715302671825619
ZCTA5 75703,16692,263,16429,0.015756050802779774,-12.715879339776926
ZCTA5 15243,5589,16,5573,0.0028627661477903022,-12.718348937643157
ZCTA5 19610,6236,28,6208,0.004490057729313663,-12.719721795858169
ZCTA5 07076,8714,78,8636,0.008951113151250861,-12.720190022539093
ZCTA5 46750,10596,119,10477,0.011230653076632692,-12.72179698924392
ZCTA5 27021,7412,51,7361,0.006880733944954129,-12.722716900254454
ZCTA5 17044,9138,87,9051,0.009520682862770847,-12.723193860773954
ZCTA5 08050,9510,95,9415,0.009989484752891693,-12.725346230528809
ZCTA5 01085,15557,235,15322,0.015105740181268883,-12.727023804738788
ZCTA5 81212,11355,136,11219,0.01197710259797446,-12.72721267225695
ZCTA5 23703,9741,100,9641,0.01026588645929576,-12.727262669397636
ZCTA5 87124,20661,362,20299,0.01752093315909201,-12.736350166450874
ZCTA5 46952,8205,67,8138,0.008165752589884216,-12.73871009331175
ZCTA5 30549,8447,72,8375,0.008523736237717534,-12.74223503451773
ZCTA5 33569,9617,97,9520,0.010086305500675886,-12.74393230170807
ZCTA5 06385,6412,31,6381,0.004834684965689333,-12.744503569455723
ZCTA5 01001,7481,52,7429,0.0069509423873813665,-12.748028957060816
ZCTA5 78732,5831,20,5811,0.003429943405933802,-12.74992543351674
ZCTA5 73020,8549,74,8475,0.00865598315592467,-12.750937688296144
ZCTA5 66210,8455,72,8383,0.008515671200473094,-12.752391648872573
ZCTA5 44320,8836,80,8756,0.009053870529651425,-12.755208726431091
ZCTA5 15234,6267,28,6239,0.0044678474549226105,-12.761076260869697
ZCTA5 54703,17627,285,17342,0.016168378056390764,-12.762731261311593
ZCTA5 07016,8654,76,8578,0.008782066096602727,-12.763776029315494
ZCTA5 80401,16494,257,16237,0.015581423547956833,-12.764957258037105
ZCTA5 55438,7247,47,7200,0.006485442251966331,-12.767445564016347
ZCTA5 32444,8085,64,8021,0.007915893630179345,-12.770152727232185
ZCTA5 28739,9685,98,9587,0.010118740320082602,-12.77115684739533
ZCTA5 53716,8086,64,8022,0.007914914667326243,-12.771431995402713
ZCTA5 35016,6381,30,6351,0.004701457451810061,-12.772842021530614
ZCTA5 44023,6590,34,6556,0.005159332321699545,-12.773628444000048
ZCTA5 33764,11353,135,11218,0.011891130097771515,-12.777034014635214
ZCTA5 80503,13345,181,13164,0.013563132259273136,-12.778550990875281
ZCTA5 35758,18208,299,17909,0.0164213532513181,-12.781527739221588
ZCTA5 23060,13814,192,13622,0.01389894310120168,-12.781666885729338
ZCTA5 28117,15112,223,14889,0.014756484912652197,-12.782441205929471
ZCTA5 29673,10425,114,10311,0.010935251798561151,-12.786457305128328
ZCTA5 02090,5474,13,5461,0.0023748629886737303,-12.787568679824412
ZCTA5 55446,9237,88,9149,0.009526902674028365,-12.78860463322419
ZCTA5 80904,10247,110,10137,0.01073484922416317,-12.789641632744933
ZCTA5 22963,6394,30,6364,0.0046918986549890525,-12.790097069680051
ZCTA5 65101,10653,119,10534,0.011170562282924998,-12.790459939328064
ZCTA5 02871,7114,44,7070,0.006184987348889514,-12.790674950634065
ZCTA5 34786,13908,194,13714,0.013948806442335347,-12.7923786105262
ZCTA5 55449,9979,104,9875,0.010421885960517087,-12.795143547660782
ZCTA5 64157,6240,27,6213,0.004326923076923077,-12.79546469295968
ZCTA5 63126,6187,26,6161,0.004202359786649426,-12.795496149344496
ZCTA5 02809,8442,71,8371,0.008410329305851694,-12.796409506904833
ZCTA5 35674,7070,43,7027,0.006082036775106082,-12.799198023055041
ZCTA5 29640,12119,152,11967,0.012542288967736612,-12.802396913290966
ZCTA5 44614,5031,5,5026,9.938382031405286e-4,-12.803960400658552
ZCTA5 99163,12037,150,11887,0.012461576804851708,-12.808256287919058
ZCTA5 15147,8212,66,8146,0.008037018996590355,-12.80901819521113
ZCTA5 77573,29602,594,29008,0.020066211742449835,-12.809748352560407
ZCTA5 37660,17472,280,17192,0.016025641025641024,-12.811417016836296
ZCTA5 43950,5267,9,5258,0.0017087526105942661,-12.812295116961142
ZCTA5 11751,5038,5,5033,9.924573243350536e-4,-12.813409914248583
ZCTA5 11030,6360,29,6331,0.004559748427672956,-12.814654534320198
ZCTA5 07444,4747,0,4747,0,-12.818111727683725
ZCTA5 55906,7539,52,7487,0.006897466507494363,-12.823172404454237
ZCTA5 66071,5105,6,5099,0.0011753183153770813,-12.825673042174438
ZCTA5 34715,5669,16,5653,0.002822367260539778,-12.82596520570309
ZCTA5 35071,6316,28,6288,0.004433185560481318,-12.826186064584851
ZCTA5 01746,5278,9,5269,0.0017051913603637742,-12.827106020116435
ZCTA5 79109,18257,299,17958,0.016377279947417427,-12.831831715794957
ZCTA5 63124,4760,0,4760,0,-12.835651386691968
ZCTA5 60611,20726,361,20365,0.017417736176782786,-12.838989378972673
ZCTA5 27713,22993,419,22574,0.018222937415735222,-12.843940335929044
ZCTA5 80138,11499,137,11362,0.011914079485172624,-12.845242516594613
ZCTA5 49014,8241,66,8175,0.008008736803785948,-12.84589321871007
ZCTA5 33912,7905,59,7846,0.007463630613535737,-12.85081592933261
ZCTA5 73142,6283,27,6256,0.004297310202132739,-12.852529448353001
ZCTA5 75075,14219,200,14019,0.014065686757155919,-12.857107865826777
ZCTA5 27312,8974,81,8893,0.009026075328727436,-12.869070648514839
ZCTA5 20132,5702,16,5686,0.0028060329708874078,-12.87010111354183
ZCTA5 01824,9766,98,9668,0.010034814663116936,-12.870573968518721
ZCTA5 67502,9997,103,9894,0.010303090927278184,-12.872731778621873
ZCTA5 95819,7972,60,7912,0.007526342197691922,-12.874022243126937
ZCTA5 34471,9586,94,9492,0.009805967035259754,-12.876014616812213
ZCTA5 45236,11040,126,10914,0.01141304347826087,-12.879026447604543
ZCTA5 20016,13477,182,13295,0.013504489129628256,-12.879453684814045
ZCTA5 53562,10997,125,10872,0.011366736382649813,-12.88092576511671
ZCTA5 46142,11265,131,11134,0.011628939192188194,-12.882174255156023
ZCTA5 45242,8843,78,8765,0.008820536017188737,-12.882283219428466
ZCTA5 49341,12712,164,12548,0.012901195720578981,-12.886840249755197
ZCTA5 85387,4799,0,4799,0,-12.888127144492355
ZCTA5 46205,11360,133,11227,0.01170774647887324,-12.8896682431996
ZCTA5 19096,5438,11,5427,0.002022802500919456,-12.88982798755285
ZCTA5 34654,8854,78,8776,0.008809577592048791,-12.896027313899786
ZCTA5 15025,6790,36,6754,0.005301914580265096,-12.900675542035671
ZCTA5 49203,15677,234,15443,0.01492632518976845,-12.900941052998997
ZCTA5 64015,11547,137,11410,0.011864553563696199,-12.901620205283322
ZCTA5 64506,8812,77,8735,0.008738084430322288,-12.902726035124147
ZCTA5 08691,6000,21,5979,0.0035,-12.903193591123868
ZCTA5 75078,6897,38,6859,0.005509641873278237,-12.905988506038728
ZCTA5 43953,4813,0,4813,0,-12.906912555818446
ZCTA5 44128,12687,163,12524,0.012847796957515567,-12.90761037077811
ZCTA5 19422,7154,43,7111,0.006010623427453173,-12.90859889018953
ZCTA5 02180,9241,86,9155,0.009306352126393247,-12.909277935202748
ZCTA5 54913,8146,63,8083,0.007733857107782961,-12.909604506158725
ZCTA5 62236,5286,8,5278,0.001513431706394249,-12.914356057528346
ZCTA5 37932,6904,38,6866,0.005504055619930475,-12.915117482900994
ZCTA5 83854,15527,230,15297,0.014812906549880853,-12.917667947888242
ZCTA5 30017,7364,47,7317,0.006382400869092884,-12.91926920347814
ZCTA5 14620,11302,131,11171,0.011590868872765883,-12.925820227289751
ZCTA5 01915,16687,258,16429,0.015461137412356924,-12.925833638929463
ZCTA5 32080,9535,92,9443,0.009648662821185108,-12.927137916592148
ZCTA5 70816,17504,278,17226,0.015882084095063986,-12.92876610028318
ZCTA5 86305,8064,61,8003,0.007564484126984127,-12.929047142102885
ZCTA5 36305,6128,23,6105,0.0037532637075718017,-12.929847047524555
ZCTA5 06801,7272,45,7227,0.006188118811881188,-12.930448592675976
ZCTA5 20715,8884,78,8806,0.008779828905898244,-12.933449835837267
ZCTA5 07083,19239,321,18918,0.016684858880399188,-12.935156034082809
ZCTA5 46202,9403,89,9314,0.009465064341167713,-12.936353039757973
ZCTA5 44420,6768,35,6733,0.005171394799054373,-12.939472216981757
ZCTA5 30656,5646,14,5632,0.002479631597591215,-12.943136752900262
ZCTA5 55442,5479,11,5468,0.002007665632414674,-12.94455929288402
ZCTA5 44708,10917,122,10795,0.011175231290647614,-12.945262102136462
ZCTA5 31061,15802,236,15566,0.01493481837742058,-12.946334219912787
ZCTA5 08109,8514,70,8444,0.00822175240779892,-12.947627594260476
ZCTA5 56073,7032,40,6992,0.005688282138794084,-12.948378465172812
ZCTA5 57301,8086,61,8025,0.0075439030422953255,-12.956963443156525
ZCTA5 43140,7743,54,7689,0.006974041069352964,-12.958035746673213
ZCTA5 48085,8620,72,8548,0.008352668213457077,-12.96038367889744
ZCTA5 06716,5880,18,5862,0.003061224489795918,-12.9606187521203
ZCTA5 06473,8906,78,8828,0.008758140579384684,-12.960836199155397
ZCTA5 48104,16436,251,16185,0.015271355560963738,-12.96355801301747
ZCTA5 35080,6261,25,6236,0.003992972368631209,-12.963926686559502
ZCTA5 31750,6996,39,6957,0.005574614065180103,-12.968063721018824
ZCTA5 55313,8674,73,8601,0.00841595572976712,-12.968136831097661
ZCTA5 02045,4860,0,4860,0,-12.96977886799029
ZCTA5 44321,6268,25,6243,0.00398851308232291,-12.973135034854288
ZCTA5 44135,11787,141,11646,0.01196233138203105,-12.975973900273834
ZCTA5 02176,11256,129,11127,0.011460554371002133,-12.976374990010639
ZCTA5 98607,11126,126,11000,0.011324824734855294,-12.980840007408926
ZCTA5 62656,6904,37,6867,0.005359212050984936,-12.982046239372368
ZCTA5 28209,10593,114,10479,0.010761823845935995,-12.98833710143622
ZCTA5 64113,4875,0,4875,0,-12.989778538880078
ZCTA5 49770,7471,48,7423,0.0064248427252041225,-12.992389363254574
ZCTA5 14304,12848,165,12683,0.012842465753424657,-12.992612484081143
ZCTA5 15228,7273,44,7229,0.006049773133507494,-12.996949961112986
ZCTA5 12303,10283,107,10176,0.010405523679859963,-12.997804010742636
ZCTA5 60527,11408,132,11276,0.011570827489481066,-12.998197638948005
ZCTA5 25414,6865,36,6829,0.005243991260014566,-12.998417363990846
ZCTA5 02339,4882,0,4882,0,-12.999101188336871
ZCTA5 32503,11984,145,11839,0.012099465954606141,-13.000474931141026
ZCTA5 32250,12378,154,12224,0.012441428340604297,-13.000879938070206
ZCTA5 48118,5063,3,5060,5.925340707090658e-4,-13.003412495930739
ZCTA5 01940,4891,0,4891,0,-13.011077636666775
ZCTA5 47362,11204,127,11077,0.011335237415208853,-13.020132993894718
ZCTA5 35749,8088,60,8028,0.00741839762611276,-13.021334879978063
ZCTA5 85209,15916,237,15679,0.014890676049258608,-13.023919097857721
ZCTA5 37179,4902,0,4902,0,-13.025700563785314
ZCTA5 33066,8673,72,8601,0.008301625735039779,-13.026601044941541
ZCTA5 02346,9196,83,9113,0.009025663331883427,-13.027496296158274
ZCTA5 76226,8292,64,8228,0.007718282682103232,-13.032666423041833
ZCTA5 31419,21910,386,21524,0.017617526243724327,-13.036159321743153
ZCTA5 19804,6947,37,6910,0.005326040017273643,-13.037787017272892
ZCTA5 21211,7561,49,7512,0.006480624256050787,-13.043438153826964
ZCTA5 84093,7462,47,7415,0.006298579469311177,-13.045216472196532
ZCTA5 32779,10777,117,10660,0.010856453558504222,-13.046023860777296
ZCTA5 18036,5214,5,5209,9.589566551591868e-4,-13.048756107468057
ZCTA5 10804,4920,0,4920,0,-13.049593645125332
ZCTA5 87544,7567,49,7518,0.0064754856614246065,-13.051098228741218
ZCTA5 86406,10601,113,10488,0.010659371757381379,-13.051902743489064
ZCTA5 41018,10421,109,10312,0.01045964878610498,-13.05400321042677
ZCTA5 45449,8065,59,8006,0.00731556106633602,-13.054165753490272
ZCTA5 70503,11546,134,11412,0.011605750909405854,-13.05571072651808
ZCTA5 32127,12777,162,12615,0.012679032636769194,-13.05939799302513
ZCTA5 27529,18279,294,17985,0.0160840308550796,-13.060044149962236
ZCTA5 27408,8220,62,8158,0.00754257907542579,-13.064550282898864
ZCTA5 41076,7173,41,7132,0.005715878990659417,-13.064551501349898
ZCTA5 37604,16450,249,16201,0.01513677811550152,-13.065066261657012
ZCTA5 01923,10703,115,10588,0.010744651032420817,-13.065479793313255
ZCTA5 92284,10930,120,10810,0.010978956999085087,-13.067080839941845
ZCTA5 32578,12436,154,12282,0.012383403023480219,-13.067288625018438
ZCTA5 92211,12788,162,12626,0.012668126368470442,-13.071877026473759
ZCTA5 90403,12918,165,12753,0.012772875058058523,-13.071944099194287
ZCTA5 48473,8903,76,8827,0.008536448388183758,-13.074980398270823
ZCTA5 48442,8034,58,7976,0.007219317898929549,-13.077026227991837
ZCTA5 47803,8666,71,8595,0.008192937918301408,-13.077610030077178
ZCTA5 43130,23476,425,23051,0.018103595161015507,-13.079829595021627
ZCTA5 98370,12316,151,12165,0.012260474179928548,-13.079956821423837
ZCTA5 44721,5583,11,5572,0.001970266881604872,-13.082375882823605
ZCTA5 08534,4946,0,4946,0,-13.084028845027216
ZCTA5 29621,16142,241,15901,0.014929996282988477,-13.088278398709917
ZCTA5 81301,12247,149,12098,0.012166244794643587,-13.101256839493812
ZCTA5 34219,8349,64,8285,0.007665588693256678,-13.104159342202975
ZCTA5 70433,14276,196,14080,0.013729335948444943,-13.106342778860673
ZCTA5 04043,4966,0,4966,0,-13.110455914661406
ZCTA5 24301,6105,20,6085,0.003276003276003276,-13.112937067284578
ZCTA5 07470,18129,289,17840,0.01594130950410944,-13.113213367492271
ZCTA5 34108,8014,57,7957,0.007112553032193661,-13.11389056009146
ZCTA5 40356,16168,241,15927,0.014905987135081643,-13.11579211271887
ZCTA5 38018,13646,181,13465,0.013263960134838047,-13.1162102837254
ZCTA5 63115,7519,47,7472,0.006250831227556856,-13.117971000792535
ZCTA5 76016,11245,126,11119,0.011204979991107158,-13.120749105510356
ZCTA5 07042,10297,105,10192,0.010197144799456152,-13.124239554879763
ZCTA5 27612,17775,280,17495,0.015752461322081576,-13.124570133792439
ZCTA5 06084,5159,3,5156,5.815080441946114e-4,-13.130517211061202
ZCTA5 91604,14808,208,14600,0.014046461372231226,-13.133708991974466
ZCTA5 65251,7282,42,7240,0.005767646251029937,-13.138874354129799
ZCTA5 47025,8474,66,8408,0.007788529620014161,-13.138954981517367
ZCTA5 37221,17260,267,16993,0.015469293163383547,-13.139926234731874
ZCTA5 55403,11082,122,10960,0.01100884316910305,-13.140130826734593
ZCTA5 80130,9942,97,9845,0.00975658821162744,-13.140306996945073
ZCTA5 53222,11264,126,11138,0.011186079545454546,-13.142984404033523
ZCTA5 54143,6977,36,6941,0.005159810806937079,-13.143123515296768
ZCTA5 29501,18767,304,18463,0.016198646560451856,-13.145911656968984
ZCTA5 64131,10317,105,10212,0.010177377144518756,-13.148144997247137
ZCTA5 48386,6879,34,6845,0.0049425788632068614,-13.150687726460278
ZCTA5 29349,11674,135,11539,0.011564159671063903,-13.152870148927008
ZCTA5 80303,11183,124,11059,0.011088258964499687,-13.153170314527788
ZCTA5 29445,20771,354,20417,0.01704299263396081,-13.153268612617984
ZCTA5 64082,5467,8,5459,0.0014633254069873788,-13.154200813326845
ZCTA5 48130,5752,13,5739,0.002260083449235049,-13.156669449603367
ZCTA5 25801,13640,180,13460,0.013196480938416423,-13.157153285820183
ZCTA5 60561,9162,80,9082,0.008731717965509714,-13.159858752209878
ZCTA5 23434,18378,294,18084,0.015997388181521383,-13.160683015996057
ZCTA5 97520,11592,133,11459,0.011473429951690822,-13.16091885706154
ZCTA5 34491,11817,138,11679,0.011678090886011678,-13.164307955627518
ZCTA5 12054,6789,32,6757,0.004713507143909265,-13.169340626502379
ZCTA5 15212,13092,167,12925,0.012755881454323251,-13.170499540704736
ZCTA5 02885,5014,0,5014,0,-13.173664586019434
ZCTA5 12901,13012,165,12847,0.012680602520750078,-13.177951916621154
ZCTA5 77401,7008,36,6972,0.005136986301369863,-13.18291552080274
ZCTA5 77005,10118,100,10018,0.0098833761612967,-13.185182829344194
ZCTA5 55427,9608,89,9519,0.009263114071606994,-13.186692972885504
ZCTA5 48842,9001,76,8925,0.008443506277080324,-13.195781721645012
ZCTA5 98033,16204,240,15964,0.01481115773882992,-13.197516032399001
ZCTA5 53575,6064,18,6046,0.002968337730870712,-13.202066921443025
ZCTA5 21771,9917,95,9822,0.009579509932439246,-13.221841421738223
ZCTA5 95003,10153,100,10053,0.009849305623953511,-13.22705958101887
ZCTA5 58554,11429,128,11301,0.01119958001574941,-13.230870218792246
ZCTA5 83702,10889,116,10773,0.010652952520892644,-13.231731956509018
ZCTA5 53027,9031,76,8955,0.00841545786734581,-13.23257706417622
ZCTA5 68506,13025,164,12861,0.012591170825335892,-13.241293315196126
ZCTA5 40059,7107,37,7070,0.00520613479667933,-13.243286385903206
ZCTA5 97405,19468,319,19149,0.016385863981919047,-13.243911068860386
ZCTA5 46227,22759,402,22357,0.017663341974603453,-13.247893292263548
ZCTA5 06790,14406,196,14210,0.013605442176870748,-13.248577946775866
ZCTA5 56537,8171,58,8113,0.007098274385020194,-13.248900511571296
ZCTA5 80203,14409,196,14213,0.013602609480185995,-13.25184831080352
ZCTA5 45822,8026,55,7971,0.006852728631946175,-13.253152322718512
ZCTA5 02139,14414,196,14218,0.013597890939364506,-13.257297723780196
ZCTA5 20657,6911,33,6878,0.004774996382578498,-13.258714788805637
ZCTA5 75605,12213,145,12068,0.011872594776058298,-13.263528136265966
ZCTA5 63119,13867,183,13684,0.013196798153890531,-13.26597597301572
ZCTA5 22124,6662,28,6634,0.004202942059441609,-13.27732976093305
ZCTA5 23901,5734,11,5723,0.0019183815835367981,-13.279960323870712
ZCTA5 22980,13277,169,13108,0.012728779091662272,-13.280594558025863
ZCTA5 33983,5849,13,5836,0.0022226021542143958,-13.283081828249259
ZCTA5 17552,8201,58,8143,0.007072308255090843,-13.286276906905421
ZCTA5 29582,7904,52,7852,0.006578947368421052,-13.287398680802852
ZCTA5 44141,5572,8,5564,0.0014357501794687725,-13.291367683484047
ZCTA5 03055,6244,20,6224,0.0032030749519538757,-13.293423290305531
ZCTA5 92646,21352,365,20987,0.01709441738478831,-13.294171172863518
ZCTA5 50111,5107,0,5107,0,-13.295276257880127
ZCTA5 21009,11485,128,11357,0.011144971702220287,-13.29579026107024
ZCTA5 17403,14748,203,14545,0.01376457824789802,-13.297444105848676
ZCTA5 61614,12683,155,12528,0.012221083339903809,-13.298078699064426
ZCTA5 02919,11623,131,11492,0.011270756259141358,-13.300017087962239
ZCTA5 27617,9088,76,9012,0.008362676056338027,-13.302252885452178
ZCTA5 02790,6306,21,6285,0.003330161750713606,-13.30313604252673
ZCTA5 57401,13816,181,13635,0.01310075275043428,-13.304340109221778
ZCTA5 19473,5810,12,5798,0.002065404475043029,-13.305357475389588
ZCTA5 33776,5115,0,5115,0,-13.305685557777977
ZCTA5 15106,9235,79,9156,0.008554412560909583,-13.306936903923296
ZCTA5 31410,9895,93,9802,0.009398686205154117,-13.307196651289352
ZCTA5 53072,10635,109,10526,0.010249177244945933,-13.308062035772622
ZCTA5 40503,12342,147,12195,0.011910549343704424,-13.309943480863621
ZCTA5 80031,13445,172,13273,0.012792859799181853,-13.323032171207878
ZCTA5 39305,8280,59,8221,0.007125603864734299,-13.323147392932388
ZCTA5 23832,11913,137,11776,0.011500041970956098,-13.325744448776259
ZCTA5 46375,9489,84,9405,0.008852355358836548,-13.327292007689863
ZCTA5 66207,6111,17,6094,0.0027818687612502046,-13.334194126878794
ZCTA5 80922,9733,89,9644,0.009144148772218226,-13.337464136524998
ZCTA5 77459,21874,377,21497,0.017235073603364726,-13.340006185132683
ZCTA5 16506,10016,95,9921,0.00948482428115016,-13.340371454348432
ZCTA5 64063,8096,55,8041,0.006793478260869565,-13.34046915667106
ZCTA5 06795,5142,0,5142,0,-13.340756981922317
ZCTA5 19508,6006,15,5991,0.0024975024975024975,-13.341698650587658
ZCTA5 45255,8735,68,8667,0.007784773898111047,-13.341713060067562
ZCTA5 45244,10345,102,10243,0.00985983566940551,-13.345584038925084
ZCTA5 06840,7084,35,7049,0.004940711462450593,-13.346074056119718
ZCTA5 25526,8495,63,8432,0.007416127133608005,-13.3461038546121
ZCTA5 37377,5616,8,5608,0.0014245014245014246,-13.348430899900038
ZCTA5 90069,12640,153,12487,0.012104430379746836,-13.348451294602565
ZCTA5 80218,11445,126,11319,0.011009174311926606,-13.353407657187779
ZCTA5 54455,7039,34,7005,0.004830231566983947,-13.355163922054032
ZCTA5 43017,14929,206,14723,0.013798646928796303,-13.355644955510176
ZCTA5 55337,18372,289,18083,0.01573045939473111,-13.359738586190083
ZCTA5 60441,11854,135,11719,0.011388560823350768,-13.360204084199383
ZCTA5 32571,12210,143,12067,0.011711711711711712,-13.360761446759886
ZCTA5 37801,10727,110,10617,0.010254497995711756,-13.362435378408561
ZCTA5 52556,5171,0,5171,0,-13.378323881796039
ZCTA5 77379,27041,509,26532,0.01882326837025258,-13.379749026533661
ZCTA5 54952,11243,121,11122,0.010762252067953393,-13.380642746985371
ZCTA5 43402,13584,174,13410,0.012809187279151944,-13.381141916244292
ZCTA5 19709,13369,169,13200,0.012641184830578203,-13.382850900637921
ZCTA5 80237,10470,104,10366,0.009933142311365807,-13.384256359750282
ZCTA5 20832,8723,67,8656,0.007680843746417517,-13.386526189162055
ZCTA5 33544,9304,79,9225,0.008490971625107481,-13.390586725846468
ZCTA5 37923,12899,158,12741,0.012249011551283046,-13.393198815139593
ZCTA5 15143,8436,61,8375,0.007230915125651968,-13.39427906460652
ZCTA5 76092,9165,76,9089,0.0082924168030551,-13.39589237673445
ZCTA5 41102,7948,51,7897,0.006416708605938601,-13.404766811829885
ZCTA5 32303,21112,356,20756,0.016862447896930654,-13.406684153001164
ZCTA5 45371,7849,49,7800,0.006242833481972226,-13.406686421864281
ZCTA5 97221,5193,0,5193,0,-13.406752690576782
ZCTA5 64083,8837,69,8768,0.007808079665044698,-13.407199946140965
ZCTA5 72019,9466,82,9384,0.008662581871962814,-13.413809540663387
ZCTA5 30116,8654,65,8589,0.007510977582620753,-13.421354198965904
ZCTA5 24210,7301,38,7263,0.005204766470346528,-13.423470842337792
ZCTA5 70117,11777,132,11645,0.011208287339729983,-13.425537317634545
ZCTA5 43206,10182,97,10085,0.009526615596150069,-13.427014139277274
ZCTA5 33410,14869,203,14666,0.013652565740803013,-13.42783960976207
ZCTA5 72116,9383,80,9303,0.008526057764041351,-13.428415765890435
ZCTA5 14609,17380,263,17117,0.015132336018411968,-13.432562125005367
ZCTA5 06457,19054,304,18750,0.015954655190511178,-13.433346115347222
ZCTA5 15668,5214,0,5214,0,-13.433833159329566
ZCTA5 06062,7722,46,7676,0.005957005957005957,-13.43746059837604
ZCTA5 01027,7976,51,7925,0.006394182547642928,-13.43954557448132
ZCTA5 30134,14881,203,14678,0.01364155634701969,-13.440725632661296
ZCTA5 75025,18780,297,18483,0.015814696485623003,-13.44307165450734
ZCTA5 43606,9963,92,9871,0.009234166415738232,-13.444165138438384
ZCTA5 19006,8035,52,7983,0.006471686372121966,-13.450526586477059
ZCTA5 19465,6692,26,6666,0.0038852361028093247,-13.451723917742196
ZCTA5 02816,13304,166,13138,0.012477450390859892,-13.45530297820682
ZCTA5 51401,5234,0,5234,0,-13.459573426579261
ZCTA5 00641,9218,76,9142,0.008244738555001085,-13.460026571510749
ZCTA5 24502,16121,232,15889,0.014391166801066932,-13.460223302596038
ZCTA5 20815,12960,158,12802,0.012191358024691358,-13.461329895520086
ZCTA5 60189,11539,126,11413,0.010919490423780223,-13.461707517258867
ZCTA5 48075,9220,76,9144,0.00824295010845987,-13.462441684427503
ZCTA5 08081,16999,253,16746,0.014883228425201482,-13.465131950495813
ZCTA5 29566,7948,50,7898,0.006290890790135883,-13.467145209979826
ZCTA5 02324,8050,52,7998,0.006459627329192546,-13.469092588981171
ZCTA5 15116,6162,16,6146,0.002596559558584875,-13.470614356580883
ZCTA5 44484,9703,86,9617,0.008863238173760692,-13.470774005527902
ZCTA5 31605,8003,51,7952,0.006372610271148319,-13.473005951984504
ZCTA5 06074,9847,89,9758,0.009038285772316442,-13.473765504813985
ZCTA5 62305,7653,44,7609,0.00574937932836796,-13.478300071334065
ZCTA5 35160,10087,94,9993,0.009318925349459701,-13.48022965324917
ZCTA5 07461,6822,28,6794,0.004104368220463207,-13.481100660395255
ZCTA5 02886,12552,148,12404,0.011790949649458253,-13.497216699740898
ZCTA5 31322,9490,81,9409,0.008535300316122233,-13.499757753532673
ZCTA5 82801,11215,118,11097,0.010521622826571556,-13.505684014552129
ZCTA5 45601,20938,349,20589,0.016668258668449707,-13.507585423404155
ZCTA5 21702,15705,221,15484,0.014071951607768227,-13.507885740800486
ZCTA5 55124,19655,317,19338,0.016128211650979395,-13.50824492422753
ZCTA5 01938,5683,7,5676,0.0012317437972901636,-13.508629252461898
ZCTA5 17109,10530,103,10427,0.009781576448243115,-13.509044433942782
ZCTA5 38138,9877,89,9788,0.009010833248962236,-13.509447099560122
ZCTA5 48098,7004,31,6973,0.00442604226156482,-13.510033586920342
ZCTA5 34613,8142,53,8089,0.00650945713583886,-13.520835692391996
ZCTA5 19320,20232,331,19901,0.01636022143139581,-13.521565131114043
ZCTA5 98040,10123,94,10029,0.00928578484638941,-13.52280622839052
ZCTA5 98074,9370,78,9292,0.008324439701173959,-13.527643254524852
ZCTA5 70118,12669,150,12519,0.011839924224484964,-13.52932081944613
ZCTA5 73170,14065,182,13883,0.012939921791681479,-13.529766494066395
ZCTA5 21502,16146,231,15915,0.014306949089557786,-13.530167377970846
ZCTA5 65804,18010,276,17734,0.01532481954469739,-13.530197900986202
ZCTA5 38111,17029,252,16777,0.014798285278055082,-13.5386517372005
ZCTA5 12019,5994,12,5982,0.002002002002002002,-13.541700334193326
ZCTA5 60192,5301,0,5301,0,-13.545446927262246
ZCTA5 01056,7961,49,7912,0.006155005652556211,-13.545579037946057
ZCTA5 45238,18843,296,18547,0.01570875126041501,-13.546477039664042
ZCTA5 18706,6928,29,6899,0.0041859122401847575,-13.547686408294432
ZCTA5 17202,10932,111,10821,0.010153677277716796,-13.548135848779534
ZCTA5 98466,11573,125,11448,0.010801002333016504,-13.552411644205288
ZCTA5 60445,10568,103,10465,0.009746404239212718,-13.553505328128944
ZCTA5 02888,8223,54,8169,0.006566946369937978,-13.558933586435925
ZCTA5 45424,19432,310,19122,0.01595306710580486,-13.567170581510963
ZCTA5 33412,5320,0,5320,0,-13.569700208862958
ZCTA5 06804,6240,16,6224,0.002564102564102564,-13.569861471412517
ZCTA5 36207,8288,55,8233,0.006636100386100386,-13.577406392339524
ZCTA5 07410,11463,122,11341,0.01064293814882666,-13.581962995827526
ZCTA5 14127,12094,136,11958,0.011245245576318836,-13.582421614183314
ZCTA5 56303,10686,105,10581,0.009825940482874789,-13.583239914991548
ZCTA5 62959,11055,113,10942,0.010221619176843057,-13.584413726664957
ZCTA5 30189,13904,177,13727,0.012730149597238205,-13.589663431556048
ZCTA5 48324,6477,20,6457,0.003087849312953528,-13.590749407355034
ZCTA5 02906,10694,105,10589,0.009818589863474846,-13.59255070565229
ZCTA5 49441,15406,212,15194,0.01376087238738154,-13.593405993809814
ZCTA5 61604,12647,148,12499,0.011702380011069819,-13.603588691056212
ZCTA5 07652,8310,55,8255,0.006618531889290012,-13.604320975503908
ZCTA5 97034,7916,47,7869,0.005937342091965639,-13.61493775559512
ZCTA5 44278,7195,33,7162,0.0045865184155663655,-13.617305950184175
ZCTA5 21229,17934,272,17662,0.015166722426675588,-13.619360276723185
ZCTA5 92107,13758,173,13585,0.012574502107864515,-13.619652815374277
ZCTA5 00926,36420,751,35669,0.020620538165842944,-13.620259421944521
ZCTA5 27526,16108,228,15880,0.014154457412465855,-13.621865408015912
ZCTA5 85266,5361,0,5361,0,-13.621889108255367
ZCTA5 57106,18717,291,18426,0.015547363359512742,-13.623896512437174
ZCTA5 89149,14585,192,14393,0.013164209804593761,-13.626968673058174
ZCTA5 49316,8080,50,8030,0.006188118811881188,-13.629889573524968
ZCTA5 02021,9021,69,8952,0.007648819421350183,-13.6301798915826
ZCTA5 98512,11960,132,11828,0.011036789297658863,-13.633744208703986
ZCTA5 60513,6997,29,6968,0.0041446334143204235,-13.634185920020744
ZCTA5 80003,14420,188,14232,0.0130374479889043,-13.634319944277966
ZCTA5 28270,13072,157,12915,0.012010403916768666,-13.634425244274635
ZCTA5 04106,10915,109,10806,0.009986257443884563,-13.634868289810017
ZCTA5 29625,12365,141,12224,0.011403154063890012,-13.63610615771842
ZCTA5 97401,20474,334,20140,0.016313373058513235,-13.639470704673414
ZCTA5 21215,22032,373,21659,0.016929920116194624,-13.639986740333912
ZCTA5 33596,9893,87,9806,0.008794096836146771,-13.640268212758151
ZCTA5 28712,8541,59,8482,0.006907856222924716,-13.643413124888884
ZCTA5 63385,14515,190,14325,0.013089906992766104,-13.64401087888241
ZCTA5 94022,7165,32,7133,0.004466154919748779,-13.64554581962059
ZCTA5 75082,8543,59,8484,0.006906239026103243,-13.64584168287483
ZCTA5 18976,7325,35,7290,0.00477815699658703,-13.648563109305595
ZCTA5 29532,8304,54,8250,0.006502890173410405,-13.658011983275738
ZCTA5 29910,15045,202,14843,0.013426387504154204,-13.66135667836678
ZCTA5 48080,10522,100,10422,0.009503896597605019,-13.662312360016996
ZCTA5 63366,18429,283,18146,0.015356232025611807,-13.662967395081779
ZCTA5 36608,14876,198,14678,0.013310029577843507,-13.6633339461845
ZCTA5 67601,9679,82,9597,0.008471949581568343,-13.66818371335615
ZCTA5 74006,10852,107,10745,0.009859933652782897,-13.668643794924552
ZCTA5 19468,10059,90,9969,0.008947211452430659,-13.668830993305574
ZCTA5 72223,9303,74,9229,0.007954423304310438,-13.677662259878005
ZCTA5 04103,13246,160,13086,0.012079118224369622,-13.680888716444088
ZCTA5 47421,11277,116,11161,0.010286423694244923,-13.681862258630973
ZCTA5 80228,14252,183,14069,0.012840303115352232,-13.68554802906165
ZCTA5 52402,16928,246,16682,0.014532136105860113,-13.691013850019367
ZCTA5 55317,7827,44,7783,0.0056215663728120605,-13.69354480385837
ZCTA5 29680,11242,115,11127,0.010229496530866394,-13.694180196687064
ZCTA5 66049,12863,151,12712,0.011739096633755733,-13.696107941784613
ZCTA5 34212,6942,27,6915,0.0038893690579083835,-13.698770090152276
ZCTA5 63131,6453,18,6435,0.002789400278940028,-13.69887211441134
ZCTA5 44053,7985,47,7938,0.005886036318096431,-13.699642169125719
ZCTA5 12110,7419,36,7383,0.004852405984634048,-13.700293048961282
ZCTA5 44601,13921,175,13746,0.0125709359959773,-13.702435586042247
ZCTA5 35209,12335,139,12196,0.011268747466558574,-13.702568507764587
ZCTA5 75068,19329,304,19025,0.015727663096901028,-13.705438921580635
ZCTA5 45419,6624,21,6603,0.003170289855072464,-13.706796526249425
ZCTA5 48162,11528,121,11407,0.01049618320610687,-13.708042240205913
ZCTA5 25705,9331,74,9257,0.0079305540670882,-13.711052480209924
ZCTA5 21114,9763,83,9680,0.00850148519922155,-13.711136476884892
ZCTA5 14219,5433,0,5433,0,-13.71305725867138
ZCTA5 20772,16073,225,15848,0.013998631244944939,-13.716921478859327
ZCTA5 37216,8050,48,8002,0.005962732919254659,-13.717020372853096
ZCTA5 37931,11266,115,11151,0.0102077045979052,-13.72165296825378
ZCTA5 33761,8951,66,8885,0.007373477823706848,-13.722061470825945
ZCTA5 37919,13064,155,12909,0.011864666258420085,-13.722887060166473
ZCTA5 67205,6312,15,6297,0.002376425855513308,-13.730844163569406
ZCTA5 46060,14554,189,14365,0.012986120654115706,-13.731958163115667
ZCTA5 60463,5448,0,5448,0,-13.731974438666194
ZCTA5 55129,8763,62,8701,0.007075202556202214,-13.732469762803117
ZCTA5 87111,24223,426,23797,0.017586591256244066,-13.73377556387807
ZCTA5 23838,5803,6,5797,0.001033947957952783,-13.734298449975391
ZCTA5 45385,15753,217,15536,0.013775153938932267,-13.7356721135568
ZCTA5 01501,6703,22,6681,0.0032821124869461434,-13.7373772887529
ZCTA5 86303,8269,52,8217,0.006288547587374531,-13.737590667853127
ZCTA5 29585,6976,27,6949,0.0038704128440366975,-13.74108028203714
ZCTA5 11710,11329,116,11213,0.010239209109365346,-13.7413175694448
ZCTA5 42701,20301,327,19974,0.016107580907344467,-13.744784673659321
ZCTA5 32137,16689,239,16450,0.014320810114446641,-13.74584195157905
ZCTA5 46825,12329,138,12191,0.0111931219076973,-13.745933214886557
ZCTA5 43016,14954,198,14756,0.013240604520529624,-13.746320518366035
ZCTA5 60048,10315,94,10221,0.009112942317014058,-13.748067567810784
ZCTA5 18040,6326,15,6311,0.002371166613974075,-13.748389438451605
ZCTA5 24179,7670,40,7630,0.005215123859191656,-13.753463291598711
ZCTA5 02842,6773,23,6750,0.00339583640927211,-13.756873113403238
ZCTA5 18504,8785,62,8723,0.0070574843483210015,-13.75893238238396
ZCTA5 04005,9565,78,9487,0.008154730789336121,-13.759982808679041
ZCTA5 02806,6111,11,6100,0.0018000327278677793,-13.761027389182999
ZCTA5 35022,8137,49,8088,0.006021875384048175,-13.761275765889172
ZCTA5 28379,10514,98,10416,0.009320905459387484,-13.761463897419954
ZCTA5 18042,15141,202,14939,0.01334125883363054,-13.763125684866143
ZCTA5 49417,12395,139,12256,0.011214199273900766,-13.769626925803157
ZCTA5 02766,6458,17,6441,0.0026323939300092907,-13.774344688915901
ZCTA5 18067,7430,35,7395,0.004710632570659489,-13.778405700186271
ZCTA5 94024,7845,43,7802,0.005481198215423837,-13.778421317155946
ZCTA5 53185,7167,30,7137,0.004185851820845542,-13.779415459070155
ZCTA5 15206,14558,188,14370,0.012913861794202501,-13.782329813425857
ZCTA5 80211,16390,231,16159,0.014093959731543624,-13.783657525542242
ZCTA5 24073,12765,147,12618,0.011515863689776733,-13.784093922779963
ZCTA5 18603,8209,50,8159,0.006090875867949811,-13.787258340264998
ZCTA5 42134,6638,20,6618,0.0030129557095510697,-13.792559803986466
ZCTA5 00659,14093,177,13916,0.012559426665720571,-13.794423762241069
ZCTA5 85310,6696,21,6675,0.0031362007168458782,-13.79660133257084
ZCTA5 97701,27943,520,27423,0.01860931181333429,-13.799966662562493
ZCTA5 44641,8223,50,8173,0.0060805058980907215,-13.8042394862543
ZCTA5 16648,6204,12,6192,0.0019342359767891683,-13.806558422461066
ZCTA5 36542,6706,21,6685,0.003131524008350731,-13.809029393077317
ZCTA5 34134,7139,29,7110,0.0040621935845356495,-13.81057628900257
ZCTA5 33027,21138,346,20792,0.016368625224713787,-13.814206445003968
ZCTA5 91361,8583,57,8526,0.006641034603285564,-13.814386101319693
ZCTA5 80504,18789,288,18501,0.015328117515567619,-13.817202258036525
ZCTA5 53219,14978,197,14781,0.013152623848310856,-13.817226366150935
ZCTA5 49445,8134,48,8086,0.005901155642980083,-13.819285860530856
ZCTA5 45233,5813,5,5808,8.60141063134354e-4,-13.81982083882997
ZCTA5 14072,8288,51,8237,0.006153474903474903,-13.82174847282424
ZCTA5 13104,5991,8,5983,0.0013353363378400935,-13.825270786462763
ZCTA5 92679,10711,101,10610,0.009429558397908691,-13.827254827375107
ZCTA5 50322,12982,151,12831,0.011631489755045448,-13.827498438748814
ZCTA5 53719,13645,166,13479,0.012165628435324295,-13.829212367675614
ZCTA5 40241,12495,140,12355,0.011204481792717087,-13.831101098912024
ZCTA5 13219,6224,12,6212,0.0019280205655526992,-13.831521692077313
ZCTA5 34110,10901,105,10796,0.009632143840014677,-13.831728668646164
ZCTA5 90049,16647,236,16411,0.014176728539676818,-13.831915199564875
ZCTA5 39211,9917,84,9833,0.008470303519209438,-13.836120431967569
ZCTA5 55331,7002,26,6976,0.0037132247929163096,-13.839809941299343
ZCTA5 33062,12053,130,11923,0.01078569650709367,-13.839950005616146
ZCTA5 71457,10017,86,9931,0.008585404811819906,-13.841641336643828
ZCTA5 02861,9971,85,9886,0.008524721692909437,-13.843520730387398
ZCTA5 06070,5949,7,5942,0.001176668347621449,-13.844781672351498
ZCTA5 47172,6404,15,6389,0.0023422860712054966,-13.845741736061665
ZCTA5 87120,23559,406,23153,0.017233329088670996,-13.845768399212325
ZCTA5 43537,11283,113,11170,0.010015066914827616,-13.845795111741726
ZCTA5 78248,5539,0,5539,0,-13.846184665290021
ZCTA5 63501,8005,45,7960,0.005621486570893191,-13.84841703505381
ZCTA5 38139,5542,0,5542,0,-13.849933801510712
ZCTA5 70634,9304,71,9233,0.007631126397248496,-13.851817507346427
ZCTA5 37643,13930,172,13758,0.012347451543431443,-13.853549325468864
ZCTA5 14564,6014,8,6006,0.0013302294645826404,-13.853986026556251
ZCTA5 12304,8164,48,8116,0.005879470847623714,-13.855642777029315
ZCTA5 98225,20498,329,20169,0.01605034637525612,-13.85688284553409
ZCTA5 48188,14887,194,14693,0.01303150399677571,-13.857371618302242
ZCTA5 02072,10784,102,10682,0.009458456973293769,-13.857605143849202
ZCTA5 34788,7810,41,7769,0.005249679897567221,-13.861433276494202
ZCTA5 44140,6078,9,6069,0.0014807502467917078,-13.862247934719955
ZCTA5 29341,7500,35,7465,0.004666666666666667,-13.86433288625311
ZCTA5 33904,13854,170,13684,0.012270824310668399,-13.865863458916236
ZCTA5 76262,12350,136,12214,0.011012145748987854,-13.86948033131707
ZCTA5 84124,7922,43,7879,0.005427922241858117,-13.872245081448739
ZCTA5 04072,7768,40,7728,0.005149330587023687,-13.873296513229118
ZCTA5 84105,9420,73,9347,0.007749469214437367,-13.87402562236205
ZCTA5 02865,6315,13,6302,0.002058590657165479,-13.87456653489711
ZCTA5 48094,7564,36,7528,0.004759386567953464,-13.8785169356578
ZCTA5 49315,8081,46,8035,0.00569236480633585,-13.878567578189466
ZCTA5 63005,6376,14,6362,0.00219573400250941,-13.88051719506495
ZCTA5 53092,8589,56,8533,0.006519967400162999,-13.881610379088313
ZCTA5 34684,13167,154,13013,0.011695906432748537,-13.884568331560704
ZCTA5 40517,16193,224,15969,0.013833137775582042,-13.885144784685039
ZCTA5 05641,7093,27,7066,0.0038065698576060904,-13.885733768858586
ZCTA5 28403,17836,263,17573,0.014745458623009643,-13.894969449372068
ZCTA5 32065,12373,136,12237,0.010991675422290471,-13.895051898656204
ZCTA5 17025,7108,27,7081,0.0037985368598761958,-13.904174815347893
ZCTA5 48323,6454,15,6439,0.0023241400681747754,-13.907794760673719
ZCTA5 80302,11888,125,11763,0.010514804845222072,-13.909145252436087
ZCTA5 33434,9694,78,9616,0.008046214153084381,-13.9118772598569
ZCTA5 44146,13942,171,13771,0.012265098264237556,-13.913591363732706
ZCTA5 27284,22124,368,21756,0.016633520159103236,-13.913608885251785
ZCTA5 31008,7384,32,7352,0.004333694474539545,-13.915814704118482
ZCTA5 49783,7963,43,7920,0.00539997488383775,-13.921965292357262
ZCTA5 07928,6466,15,6451,0.0023198267862666253,-13.92264702880268
ZCTA5 66044,10617,97,10520,0.00913629085429029,-13.934492908791077
ZCTA5 15122,8585,55,8530,0.0064065230052417,-13.936831869993755
ZCTA5 66216,9035,64,8971,0.007083563918096292,-13.939546468661902
ZCTA5 06461,5614,0,5614,0,-13.939610568743396
ZCTA5 55330,13307,156,13151,0.011723153227624558,-13.9407088966837
ZCTA5 48195,12692,142,12550,0.011188150015757958,-13.949939408422127
ZCTA5 60047,13757,166,13591,0.012066584284364324,-13.95045557098342
ZCTA5 60516,11973,126,11847,0.010523678276121273,-13.953382812487996
ZCTA5 47715,13102,151,12951,0.01152495802167608,-13.95907182941943
ZCTA5 36109,10118,86,10032,0.00849970349871516,-13.959187970564113
ZCTA5 11787,11842,123,11719,0.010386758993413275,-13.959698013614883
ZCTA5 12804,10639,97,10542,0.009117398251715387,-13.959759513276014
ZCTA5 15009,6552,16,6536,0.002442002442002442,-13.959932703306213
ZCTA5 27265,19834,310,19524,0.015629726731874558,-13.96002541809149
ZCTA5 06484,16351,226,16125,0.013821784600330254,-13.960794452317009
ZCTA5 06776,10029,84,9945,0.008375710439724798,-13.966712506103885
ZCTA5 83709,20623,329,20294,0.015953062115114193,-13.976762300943802
ZCTA5 48230,6454,14,6440,0.0021691973969631237,-13.977017481714741
ZCTA5 43611,7907,41,7866,0.005185278866826863,-13.979093480128288
ZCTA5 82009,13653,163,13490,0.011938768036329012,-13.980678808795576
ZCTA5 85028,7962,42,7920,0.0052750565184626974,-13.98307808597839
ZCTA5 98072,9273,68,9205,0.0073331176534023506,-13.988310570026208
ZCTA5 32223,9566,74,9492,0.007735730712941668,-13.988601087589675
ZCTA5 94526,12233,131,12102,0.010708738657729094,-13.990245238968742
ZCTA5 27614,12504,137,12367,0.010956493921944978,-13.990293355594629
ZCTA5 44820,7498,33,7465,0.004401173646305681,-13.990330723712042
ZCTA5 01776,6355,12,6343,0.0018882769472856019,-13.99394289130337
ZCTA5 21015,10245,88,10157,0.00858955588091752,-13.995945359500837
ZCTA5 17745,7187,27,7160,0.003756783080562126,-14.000913338773072
ZCTA5 28412,17236,246,16990,0.014272453005337665,-14.004598605472678
ZCTA5 68106,9484,72,9412,0.007591733445803458,-14.006502099589635
ZCTA5 01020,12609,139,12470,0.011023871837576334,-14.006836289062168
ZCTA5 31904,13103,150,12953,0.011447760054949248,-14.008746702549045
ZCTA5 83616,10637,96,10541,0.009025101062329604,-14.011384549650392
ZCTA5 40502,12258,131,12127,0.01068689835209659,-14.017980735758497
ZCTA5 83716,6318,11,6307,0.0017410572966128522,-14.018221428396027
ZCTA5 45324,17041,241,16800,0.014142362537409777,-14.019592580247457
ZCTA5 64111,10127,85,10042,0.008393403772094401,-14.024883833649808
ZCTA5 60134,10510,93,10417,0.00884871550903901,-14.028049744107848
ZCTA5 01845,11121,106,11015,0.009531516949914576,-14.029618122595435
ZCTA5 32828,21327,345,20982,0.0161766774511183,-14.031714535233974
ZCTA5 99203,9015,62,8953,0.006877426511369939,-14.032953116185842
ZCTA5 33541,8868,59,8809,0.006653134866937303,-14.035530859504687
ZCTA5 66209,8319,48,8271,0.00576992426974396,-14.042119018439093
ZCTA5 46229,10946,102,10844,0.009318472501370363,-14.042749572972808
ZCTA5 28405,13448,157,13291,0.011674598453301606,-14.045684592777958
ZCTA5 49431,7548,33,7515,0.0043720190779014305,-14.05098602726989
ZCTA5 48047,15673,208,15465,0.013271230779046768,-14.051585617559962
ZCTA5 24450,5709,0,5709,0,-14.057058700308131
ZCTA5 44622,7290,28,7262,0.003840877914951989,-14.060953285939423
ZCTA5 44144,9629,74,9555,0.007685117873091702,-14.062208146305204
ZCTA5 53012,7402,30,7372,0.00405295865982167,-14.06708409230142
ZCTA5 54115,17343,247,17096,0.014242057314190162,-14.070261802982467
ZCTA5 52803,8851,58,8793,0.006552931872104847,-14.0744965055208
ZCTA5 16046,6135,7,6128,0.0011409942950285248,-14.075088668154885
ZCTA5 23236,9792,77,9715,0.007863562091503268,-14.082533696561885
ZCTA5 12078,9890,79,9811,0.007987866531850353,-14.084082369693064
ZCTA5 78232,15536,204,15332,0.013130792996910402,-14.087383019896574
ZCTA5 78731,12458,134,12324,0.010756140632525285,-14.088896619744734
ZCTA5 02359,6489,13,6476,0.002003390352904916,-14.089141989296701
ZCTA5 17522,12778,141,12637,0.011034590702770387,-14.093653344158485
ZCTA5 22903,14645,183,14462,0.012495732331853875,-14.10484717392315
ZCTA5 17033,6390,11,6379,0.0017214397496087637,-14.106591893990988
ZCTA5 17543,17048,239,16809,0.014019239793524168,-14.111871856952469
ZCTA5 19138,11334,109,11225,0.009617081348155991,-14.112677226344541
ZCTA5 48640,13377,154,13223,0.011512297226582941,-14.11294905956095
ZCTA5 44138,9337,67,9270,0.007175752382992396,-14.121061623696418
ZCTA5 63110,8129,43,8086,0.0052897035305695655,-14.121618063682222
ZCTA5 20105,6521,13,6508,0.001993559270050606,-14.1282539281743
ZCTA5 15017,7347,28,7319,0.00381107935211651,-14.130021148100584
ZCTA5 43302,20215,315,19900,0.015582488251298541,-14.130820201308259
ZCTA5 37128,18737,279,18458,0.014890323957944174,-14.13132842942509
ZCTA5 34695,7295,27,7268,0.0037011651816312545,-14.13213528607912
ZCTA5 15201,6194,7,6187,0.0011301259283177268,-14.147363232827946
ZCTA5 19971,6761,17,6744,0.0025144209436473892,-14.147721954599072
ZCTA5 07006,9606,72,9534,0.007495315427857589,-14.148854854430752
ZCTA5 44092,7739,35,7704,0.004522548132833699,-14.154011432271279
ZCTA5 56601,13463,155,13308,0.011513035727549581,-14.157765543314737
ZCTA5 02879,8418,48,8370,0.005702066999287242,-14.160048747762165
ZCTA5 07748,9617,72,9545,0.007486742227305812,-14.161629065343275
ZCTA5 48025,5796,0,5796,0,-14.163762155955745
ZCTA5 00969,14325,174,14151,0.012146596858638744,-14.182280407506033
ZCTA5 37069,7014,21,6993,0.0029940119760479044,-14.186632267643796
ZCTA5 14610,7014,21,6993,0.0029940119760479044,-14.186632267643796
ZCTA5 20187,5820,0,5820,0,-14.193056421286267
ZCTA5 53132,13498,155,13343,0.011483182693732405,-14.195444656850137
ZCTA5 23139,9304,65,9239,0.0069862424763542565,-14.197740593471396
ZCTA5 45042,10564,91,10473,0.008614161302536918,-14.198107970570481
ZCTA5 19150,9551,70,9481,0.007329075489477542,-14.19864036522458
ZCTA5 55448,10472,89,10383,0.008498854087089381,-14.201768107757534
ZCTA5 83835,8455,48,8407,0.005677114133648729,-14.203893463246189
ZCTA5 48858,17224,241,16983,0.0139921040408732,-14.204333698444968
ZCTA5 15010,11186,104,11082,0.00929733595565886,-14.208296031878666
ZCTA5 46368,15354,197,15157,0.012830532760192784,-14.21153036868071
ZCTA5 08021,18072,261,17811,0.01444223107569721,-14.213285487345232
ZCTA5 60439,8258,44,8214,0.005328166626301768,-14.213788089427382
ZCTA5 60622,23410,392,23018,0.016744980777445535,-14.217436387460193
ZCTA5 49301,6763,16,6747,0.002365813987875203,-14.217777260590255
ZCTA5 39402,15706,205,15501,0.013052336686616579,-14.218927112142113
ZCTA5 06488,7900,37,7863,0.0046835443037974685,-14.220903770525268
ZCTA5 11762,7425,28,7397,0.003771043771043771,-14.224014168157622
ZCTA5 33913,8271,44,8227,0.005319792044492806,-14.229207088934194
ZCTA5 21207,18423,269,18154,0.014601313575422027,-14.230570507212537
ZCTA5 25314,5852,0,5852,0,-14.232021646071825
ZCTA5 22039,5858,0,5858,0,-14.239315755193076
ZCTA5 08108,7385,27,7358,0.0036560595802301965,-14.240599702386621
ZCTA5 29072,21632,347,21285,0.01604105029585799,-14.24262530499735
ZCTA5 54956,18394,268,18126,0.014569968467978688,-14.243007068980258
ZCTA5 38120,6331,8,6323,0.001263623440214816,-14.243893741099924
ZCTA5 70124,8181,42,8139,0.005133846718005134,-14.245108684433577
ZCTA5 63640,10798,95,10703,0.008797925541766994,-14.24830272766378
ZCTA5 59601,13864,162,13702,0.011684939411425274,-14.254503166871817
ZCTA5 23222,9703,72,9631,0.00742038544779965,-14.261158054982362
ZCTA5 06107,7295,25,7270,0.003427004797806717,-14.262356126789204
ZCTA5 58078,13567,155,13412,0.011424780717918479,-14.269510703747864
ZCTA5 68134,12354,128,12226,0.010361016674761211,-14.274196701038443
ZCTA5 48182,8518,48,8470,0.005635125616341864,-14.27826412134813
ZCTA5 37664,11436,108,11328,0.00944386149003148,-14.279052694574432
ZCTA5 97702,18930,280,18650,0.014791336502905442,-14.279660503375611
ZCTA5 21601,10447,87,10360,0.008327749593184646,-14.282062791976903
ZCTA5 45251,8777,53,8724,0.0060385097413694884,-14.283550120605323
ZCTA5 21204,7689,32,7657,0.004161789569514892,-14.28413414414963
ZCTA5 36330,14119,167,13952,0.01182803314682343,-14.290441843425574
ZCTA5 60466,8386,45,8341,0.0053660863343668016,-14.304211184288548
ZCTA5 10309,11464,108,11356,0.00942079553384508,-14.310256663911174
ZCTA5 48221,15325,194,15131,0.01265905383360522,-14.316155166458051
ZCTA5 25704,6677,13,6664,0.0019469821776246818,-14.317413602878515
ZCTA5 85296,13703,157,13546,0.011457345106910896,-14.319654527727291
ZCTA5 48169,8296,43,8253,0.005183220829315333,-14.31987172750567
ZCTA5 98311,10146,80,10066,0.007884880741178789,-14.322887485785843
ZCTA5 62269,11756,114,11642,0.00969717591017353,-14.324711242768855
ZCTA5 14043,10966,97,10869,0.008845522524165603,-14.330997274577422
ZCTA5 06820,6858,16,6842,0.0023330417031204435,-14.332380485517218
ZCTA5 32789,11015,98,10917,0.008896958692691784,-14.332958670633628
ZCTA5 04074,7624,30,7594,0.003934942287513116,-14.33378050399295
ZCTA5 43055,24572,418,24154,0.017011232296923327,-14.333917741713144
ZCTA5 30094,11718,113,11605,0.009643283836832224,-14.333983498290555
ZCTA5 53105,11487,108,11379,0.009401932619482894,-14.335847485479182
ZCTA5 62864,10303,83,10220,0.008055906046782491,-14.336739243754574
ZCTA5 44116,9183,60,9123,0.006533812479581836,-14.346221863793879
ZCTA5 23113,9488,66,9422,0.006956155143338955,-14.353741646877593
ZCTA5 12180,21551,342,21209,0.015869333209595844,-14.356122726950062
ZCTA5 19707,5955,0,5955,0,-14.356722955432877
ZCTA5 19802,10465,86,10379,0.008217869087434305,-14.356871933493363
ZCTA5 62301,13872,160,13712,0.011534025374855825,-14.357461974238488
ZCTA5 53545,9942,75,9867,0.007543753771876886,-14.367319388605114
ZCTA5 23323,13302,147,13155,0.011050969778980605,-14.369220775845712
ZCTA5 87112,18063,257,17806,0.014227979848308698,-14.369879090891292
ZCTA5 74114,7276,23,7253,0.0031610775151181968,-14.369916377241621
ZCTA5 32765,21128,331,20797,0.015666414237031426,-14.378561405099623
ZCTA5 19342,7284,23,7261,0.003157605711147721,-14.379461901488055
ZCTA5 84103,10438,85,10353,0.008143322475570033,-14.380693915616755
ZCTA5 30135,21861,349,21512,0.015964502996203285,-14.38075444257703
ZCTA5 64804,13984,162,13822,0.01158466819221968,-14.382001196563005
ZCTA5 19428,7834,33,7801,0.004212407454684708,-14.393276073446028
ZCTA5 51503,14758,179,14579,0.012129014771649274,-14.406905830134837
ZCTA5 15101,9996,75,9921,0.007503001200480192,-14.428943124341057
ZCTA5 48331,8443,44,8399,0.005211417742508587,-14.431775971825212
ZCTA5 85044,17072,232,16840,0.01358950328022493,-14.43405534573179
ZCTA5 70119,16090,209,15881,0.012989434431323804,-14.436070378540075
ZCTA5 46725,9412,63,9349,0.006693582660433489,-14.437800463639332
ZCTA5 15229,6023,0,6023,0,-14.438459814900332
ZCTA5 48185,21601,341,21260,0.01578630618952826,-14.440627626786943
ZCTA5 48124,11863,114,11749,0.009609710865716934,-14.442731367384187
ZCTA5 54241,6556,9,6547,0.0013727882855399634,-14.445639035449913
ZCTA5 44123,7932,34,7898,0.004286434694906707,-14.446358620287986
ZCTA5 19064,8559,46,8513,0.005374459633134712,-14.446695253439842
ZCTA5 45458,12788,134,12654,0.010478573662808884,-14.448832398817018
ZCTA5 84037,10691,89,10602,0.008324759143204564,-14.449605504880127
ZCTA5 18017,15457,194,15263,0.012550947790645015,-14.452422084222096
ZCTA5 32963,7181,20,7161,0.002785127419579446,-14.452965060960805
ZCTA5 02882,6039,0,6039,0,-14.457624860422701
ZCTA5 43452,6278,4,6274,6.371455877668047e-4,-14.460191791071962
ZCTA5 35633,8260,40,8220,0.004842615012106538,-14.46091711883292
ZCTA5 68310,6049,0,6049,0,-14.46959012346585
ZCTA5 45005,12396,125,12271,0.010083898031623104,-14.470021357729173
ZCTA5 22485,8938,53,8885,0.005929738196464533,-14.471146392509898
ZCTA5 32176,7090,18,7072,0.002538787023977433,-14.476447859146893
ZCTA5 60491,7854,32,7822,0.004074357015533486,-14.479674386481998
ZCTA5 99205,17969,252,17717,0.014024152707440592,-14.48438507970186
ZCTA5 44241,6761,12,6749,0.0017748853719863926,-14.485886197320227
ZCTA5 48180,23706,392,23314,0.01653589808487303,-14.486061513642255
ZCTA5 50501,11532,106,11426,0.009191814082552896,-14.48938171620162
ZCTA5 08873,19854,297,19557,0.014959202175883953,-14.492476321492143
ZCTA5 02726,6070,0,6070,0,-14.494685025467623
ZCTA5 07675,9958,73,9885,0.007330789315123519,-14.497059010349668
ZCTA5 43612,12009,116,11893,0.009659422100091597,-14.501039178136637
ZCTA5 68154,10109,76,10033,0.007518053219903057,-14.501853958910711
ZCTA5 48205,12974,137,12837,0.010559580699861262,-14.502218912662428
ZCTA5 08087,10595,86,10509,0.008117036337895234,-14.503488349593177
ZCTA5 55426,12247,121,12126,0.009879970605046133,-14.508296437014947
ZCTA5 06002,8613,46,8567,0.0053407639614536165,-14.509587365387663
ZCTA5 47725,6320,4,6316,6.329113924050633e-4,-14.510352653793234
ZCTA5 22153,10183,77,10106,0.007561622311695964,-14.530385445535513
ZCTA5 14526,8215,38,8177,0.0046256847230675595,-14.530814232370098
ZCTA5 49426,12406,124,12282,0.00999516363050137,-14.530819829473186
ZCTA5 46385,14527,171,14356,0.011771184690576168,-14.53355238919141
ZCTA5 45227,8584,45,8539,0.005242311276794035,-14.535866432455665
ZCTA5 55122,13369,145,13224,0.010845986984815618,-14.537167463826917
ZCTA5 75214,15887,202,15685,0.012714798262730535,-14.537219661051964
ZCTA5 54501,8383,41,8342,0.0048908505308362165,-14.543628222446172
ZCTA5 29229,17353,236,17117,0.01359995389846136,-14.544704793996745
ZCTA5 85388,8697,47,8650,0.0054041623548350005,-14.547289942967565
ZCTA5 62223,6870,13,6857,0.0018922852983988354,-14.54807517974401
ZCTA5 56003,6119,0,6119,0,-14.553071514144925
ZCTA5 52302,16507,216,16291,0.0130853577270249,-14.553405170715097
ZCTA5 52601,12530,126,12404,0.01005586592178771,-14.565471114276745
ZCTA5 05403,8560,44,8516,0.0051401869158878505,-14.568076555578308
ZCTA5 32118,9024,53,8971,0.00587322695035461,-14.570452908669598
ZCTA5 78703,9479,62,9417,0.0065407743432851564,-14.571833002158325
ZCTA5 44001,8513,43,8470,0.00505109832021614,-14.573738986691602
ZCTA5 98112,11471,103,11368,0.008979164850492546,-14.577665714894362
ZCTA5 44130,22238,353,21885,0.015873729651947117,-14.579502993089859
ZCTA5 07753,15583,194,15389,0.01244946415966117,-14.581658642144179
ZCTA5 25701,9840,69,9771,0.00701219512195122,-14.586660939352175
ZCTA5 59718,14799,176,14623,0.011892695452395432,-14.586778517640036
ZCTA5 56001,18622,265,18357,0.014230480077327893,-14.5886415575665
ZCTA5 35630,14890,178,14712,0.011954331766286097,-14.589731225384385
ZCTA5 38104,12323,121,12202,0.0098190375720198,-14.590859301398046
ZCTA5 94123,13918,156,13762,0.011208506969392153,-14.594810717110008
ZCTA5 21050,6568,7,6561,0.0010657734470158344,-14.597222617575277
ZCTA5 48446,12145,117,12028,0.009633594071634418,-14.59874797245172
ZCTA5 35763,6519,6,6513,9.203865623561896e-4,-14.607949825922436
ZCTA5 32605,10107,74,10033,0.007321658256653804,-14.610219917014762
ZCTA5 33703,10694,86,10608,0.008041892650084159,-14.614305439174608
ZCTA5 77546,17894,247,17647,0.013803509556275847,-14.618262922016664
ZCTA5 70508,16357,211,16146,0.012899675979702879,-14.619194398832706
ZCTA5 62226,12258,119,12139,0.009707945831293849,-14.620727079780554
ZCTA5 60142,11564,104,11460,0.008993427879626427,-14.6281103113426
ZCTA5 71201,8767,47,8720,0.005361012889243755,-14.628184363573727
ZCTA5 60467,9779,67,9712,0.006851416300235198,-14.62979563110273
ZCTA5 73703,12315,120,12195,0.0097442143727162,-14.632298427790772
ZCTA5 02852,8927,50,8877,0.005600985773496135,-14.63497563117626
ZCTA5 52405,10761,87,10674,0.008084750487872874,-14.635290640413581
ZCTA5 75093,19131,276,18855,0.014426846479535831,-14.635632533788097
ZCTA5 08033,6193,0,6193,0,-14.640805693167561
ZCTA5 30736,15557,192,15365,0.012341711126823939,-14.644229352444677
ZCTA5 94941,13429,144,13285,0.010723062029935214,-14.648970522313522
ZCTA5 36303,11678,106,11572,0.009076896728891934,-14.649875107002272
ZCTA5 22032,9851,68,9783,0.006902852502284032,-14.655163930304749
ZCTA5 45356,10150,74,10076,0.00729064039408867,-14.65864468330672
ZCTA5 19114,12988,134,12854,0.010317215891592239,-14.663645806667297
ZCTA5 14051,7800,28,7772,0.0035897435897435897,-14.667827049287977
ZCTA5 49085,10307,77,10230,0.007470651013874066,-14.66994817049823
ZCTA5 42431,10601,83,10518,0.007829450051881898,-14.672260769966323
ZCTA5 33774,8237,36,8201,0.0043705232487556145,-14.679042445773813
ZCTA5 94611,17494,236,17258,0.013490339544986853,-14.684301993558975
ZCTA5 73012,12688,127,12561,0.010009457755359394,-14.686087413753134
ZCTA5 18064,9584,62,9522,0.006469115191986645,-14.69133058486194
ZCTA5 11747,7048,14,7034,0.0019863791146424517,-14.691408871423134
ZCTA5 68022,8460,40,8420,0.004728132387706856,-14.693499863224057
ZCTA5 85308,24544,407,24137,0.01658246414602347,-14.699306858005734
ZCTA5 12020,13525,145,13380,0.010720887245841035,-14.70264441070551
ZCTA5 63368,15968,200,15768,0.012525050100200401,-14.707573311687321
ZCTA5 14217,10734,85,10649,0.007918762809763369,-14.712554339613748
ZCTA5 50021,10444,79,10365,0.007564151666028342,-14.713983609519877
ZCTA5 24551,9353,57,9296,0.006094301293702555,-14.714783714953215
ZCTA5 70001,17312,231,17081,0.013343345656192237,-14.715274074255149
ZCTA5 13413,6552,5,6547,7.631257631257631e-4,-14.715666575889449
ZCTA5 01960,21576,333,21243,0.015433815350389322,-14.720205068948374
ZCTA5 44087,8496,40,8456,0.004708097928436911,-14.734998911060222
ZCTA5 75089,10997,90,10907,0.008184050195507865,-14.736994602220761
ZCTA5 98926,13058,134,12924,0.010261908408638382,-14.738254995108136
ZCTA5 23188,17211,228,16983,0.013247341816280286,-14.742327464987254
ZCTA5 54901,13886,152,13734,0.01094627682557972,-14.749866994140222
ZCTA5 63104,9485,59,9426,0.006220347917764892,-14.749988313114834
ZCTA5 34606,11723,105,11618,0.00895675168472234,-14.750415525793292
ZCTA5 53207,16535,212,16323,0.012821288176595102,-14.754578517974773
ZCTA5 82609,7382,19,7363,0.002573828230831753,-14.7548018653104
ZCTA5 61550,7495,21,7474,0.002801867911941294,-14.757513431911827
ZCTA5 76210,14656,169,14487,0.011531113537117905,-14.759564721708708
ZCTA5 57006,9798,65,9733,0.006634006940191876,-14.763677971242222
ZCTA5 62901,10489,79,10410,0.007531699876060635,-14.764131409948984
ZCTA5 60544,9347,56,9291,0.00599122713170001,-14.765480925682484
ZCTA5 28311,14485,165,14320,0.011391094235415948,-14.766923172187369
ZCTA5 14211,9250,54,9196,0.0058378378378378375,-14.770706179244467
ZCTA5 14052,6890,10,6880,0.001451378809869376,-14.772761723441713
ZCTA5 12047,9153,52,9101,0.005681197421610401,-14.776394748084392
ZCTA5 53090,8649,42,8607,0.004856052722858134,-14.790564295641627
ZCTA5 28443,8183,33,8150,0.00403275082488085,-14.800766657236318
ZCTA5 60002,9073,50,9023,0.005510856387082552,-14.801909376499504
ZCTA5 99004,7753,25,7728,0.0032245582355217334,-14.802386812192806
ZCTA5 12866,17363,230,17133,0.013246558774405344,-14.807857048660678
ZCTA5 32505,10926,87,10839,0.007962657880285558,-14.818037694842902
ZCTA5 29206,8146,32,8114,0.003928308372207218,-14.819689260701448
ZCTA5 76028,24119,393,23726,0.016294207885899085,-14.820441075112145
ZCTA5 08857,14986,175,14811,0.011677565728012812,-14.825104149542605
ZCTA5 54902,10053,69,9984,0.006863622799164429,-14.82653131720608
ZCTA5 08690,6994,11,6983,0.0015727766657134686,-14.827377190368344
ZCTA5 95628,16087,200,15887,0.01243239883135451,-14.827625952861817
ZCTA5 85635,14276,159,14117,0.01113757355001401,-14.828455606503613
ZCTA5 48430,14727,169,14558,0.011475521151626264,-14.832790031955977
ZCTA5 54915,17049,222,16827,0.013021291571353158,-14.836922914389994
ZCTA5 72120,12922,129,12793,0.009982974771707166,-14.837635216027367
ZCTA5 20720,7676,23,7653,0.002996352266805628,-14.839885333744116
ZCTA5 35640,9210,52,9158,0.005646036916395223,-14.841098068564577
ZCTA5 06770,11712,103,11609,0.008794398907103824,-14.841203412279281
ZCTA5 48176,8378,36,8342,0.004296968250179041,-14.841587236562146
ZCTA5 21409,7571,21,7550,0.0027737419099194294,-14.845755671677274
ZCTA5 98407,9321,54,9267,0.005793369810106212,-14.851160329849554
ZCTA5 44122,13259,136,13123,0.010257183799683234,-14.854279190319398
ZCTA5 33433,18180,248,17932,0.013641364136413642,-14.856202490196022
ZCTA5 19901,13988,152,13836,0.010866456963111238,-14.856439764652933
ZCTA5 29407,14973,174,14799,0.011620917651773192,-14.857220618770326
ZCTA5 66213,11632,101,11531,0.008682943603851445,-14.857277799304114
ZCTA5 48304,6379,0,6379,0,-14.859039526224583
ZCTA5 01945,8236,33,8203,0.004006799417192812,-14.861717726191792
ZCTA5 33408,9025,48,8977,0.005318559556786704,-14.864295131226175
ZCTA5 07039,9994,67,9927,0.006704022413448069,-14.871688855939752
ZCTA5 35661,6744,6,6738,8.896797153024911e-4,-14.871927894940907
ZCTA5 48910,15738,191,15547,0.012136230779006227,-14.872526588387512
ZCTA5 35603,13050,131,12919,0.01003831417624521,-14.875785595414536
ZCTA5 14617,9548,58,9490,0.006074570590699623,-14.878107790593015
ZCTA5 37205,10983,87,10896,0.007921332969134116,-14.88072401251147
ZCTA5 43613,13833,148,13685,0.010699052989228656,-14.883392099317515
ZCTA5 70301,17059,221,16838,0.012955038396154523,-14.889395863489886
ZCTA5 32953,9861,64,9797,0.006490213974241963,-14.890473737178755
ZCTA5 32119,10021,67,9954,0.006685959485081329,-14.901819712731541
ZCTA5 16148,7455,18,7437,0.002414486921529175,-14.904086409510706
ZCTA5 16365,8006,28,7978,0.0034973769672745443,-14.906215978725484
ZCTA5 32725,16693,212,16481,0.012699934104115497,-14.912098137333823
ZCTA5 80108,9477,56,9421,0.005909042946079983,-14.912299538680715
ZCTA5 45230,11876,105,11771,0.008841360727517683,-14.916290342382437
ZCTA5 55422,12626,121,12505,0.009583399334706161,-14.91639666538503
ZCTA5 19460,16309,203,16106,0.012447115089827702,-14.919134346361277
ZCTA5 48327,9335,53,9282,0.005677557579003749,-14.924535661975872
ZCTA5 06443,6911,8,6903,0.0011575748806250904,-14.931086102577558
ZCTA5 78249,20073,291,19782,0.014497085637423404,-14.936287009792432
ZCTA5 44077,22099,340,21759,0.01538531155255894,-14.937643180000837
ZCTA5 60137,14295,157,14138,0.010982861140258832,-14.941187977754963
ZCTA5 60014,17585,232,17353,0.013193062268979244,-14.941672747427152
ZCTA5 19803,8520,37,8483,0.004342723004694835,-14.943348371822088
ZCTA5 44129,11665,100,11565,0.008572653236176597,-14.944581406264405
ZCTA5 65203,24341,395,23946,0.016227763855223697,-14.946139736143824
ZCTA5 62704,18951,264,18687,0.013930663289536172,-14.946475834179843
ZCTA5 20165,11285,92,11193,0.008152414709791759,-14.947409825724034
ZCTA5 21230,14928,171,14757,0.011454983922829582,-14.947623149573706
ZCTA5 06437,8314,33,8281,0.0039692085638681745,-14.950987908700268
ZCTA5 30005,13260,134,13126,0.010105580693815988,-14.951922297841042
ZCTA5 03051,9054,47,9007,0.005191075767616523,-14.955616430551089
ZCTA5 44022,6877,7,6870,0.0010178857059764432,-14.958733332297259
ZCTA5 19701,14089,152,13937,0.010788558449854496,-14.96139860715207
ZCTA5 32952,8432,35,8397,0.004150853889943074,-14.96395495967776
ZCTA5 48101,10819,82,10737,0.007579258711526019,-14.967074108555634
ZCTA5 02920,14140,153,13987,0.01082036775106082,-14.96741814591768
ZCTA5 78739,6476,0,6476,0,-14.97158764075701
ZCTA5 60448,9122,48,9074,0.00526200394650296,-14.974000675737468
ZCTA5 43616,8549,37,8512,0.004327991577962335,-14.97633322568119
ZCTA5 32533,10190,69,10121,0.006771344455348381,-14.979018169805975
ZCTA5 85298,9840,62,9778,0.006300813008130081,-14.97909223847236
ZCTA5 06037,7743,22,7721,0.002841275991217874,-14.980395882397398
ZCTA5 37174,11703,100,11603,0.00854481756814492,-14.985649499294642
ZCTA5 02066,6846,6,6840,8.764241893076249e-4,-14.990070759229088
ZCTA5 63901,13487,138,13349,0.010232075331800993,-14.997666817240589
ZCTA5 15701,13226,132,13094,0.009980341751096326,-15.012837964259731
ZCTA5 01930,13137,130,13007,0.0098957143944584,-15.016182109471993
ZCTA5 42001,12674,120,12554,0.009468202619536058,-15.016844171824802
ZCTA5 33472,7940,25,7915,0.0031486146095717885,-15.017470347898733
ZCTA5 61571,9881,62,9819,0.006274668555814189,-15.024718747041897
ZCTA5 85749,7676,20,7656,0.0026055237102657635,-15.030307244623756
ZCTA5 89511,10877,82,10795,0.0075388434310931325,-15.030579577613404
ZCTA5 34787,21956,334,21622,0.015212242667152487,-15.03184776740492
ZCTA5 20744,18662,255,18407,0.01366413031829386,-15.034557356203203
ZCTA5 18901,10440,73,10367,0.006992337164750958,-15.03607975076998
ZCTA5 48183,17560,229,17331,0.013041002277904327,-15.043105288458515
ZCTA5 48197,25262,415,24847,0.01642783627582931,-15.049434400141973
ZCTA5 29020,8888,42,8846,0.004725472547254726,-15.061988286563396
ZCTA5 33432,10269,69,10200,0.006719252118025124,-15.066326256651992
ZCTA5 30013,9465,53,9412,0.0055995773903856315,-15.070286358878569
ZCTA5 22556,9366,51,9315,0.005445227418321589,-15.074335180682942
ZCTA5 94114,16860,212,16648,0.012574139976275208,-15.07733907146472
ZCTA5 46236,10230,68,10162,0.006647116324535679,-15.078263676093899
ZCTA5 45013,21059,311,20748,0.01476803267011729,-15.080071479987359
ZCTA5 22315,10686,77,10609,0.007205689687441512,-15.089547259711566
ZCTA5 24740,12842,122,12720,0.009500077869490734,-15.095956451481305
ZCTA5 60565,13810,143,13667,0.010354815351194787,-15.095980466090287
ZCTA5 40207,13727,141,13586,0.010271727252859329,-15.104684090294034
ZCTA5 36532,12248,109,12139,0.008899412148922273,-15.112377560481011
ZCTA5 15239,8618,36,8582,0.004177303318635414,-15.114443599334074
ZCTA5 43054,9924,61,9863,0.006146715034260379,-15.128261161314427
ZCTA5 97068,11162,86,11076,0.007704712417129547,-15.128768581588542
ZCTA5 66212,14433,156,14277,0.010808563708168779,-15.129581928382033
ZCTA5 60030,14209,151,14058,0.010627067351678513,-15.132030425848264
ZCTA5 30308,11168,86,11082,0.007700573065902579,-15.135266849483978
ZCTA5 27518,8374,31,8343,0.0037019345593503703,-15.140854498380977
ZCTA5 18902,7663,18,7645,0.002348949497585802,-15.142478034281389
ZCTA5 55126,11226,87,11139,0.00774986638161411,-15.145473288897216
ZCTA5 40219,15657,183,15474,0.011688062847288752,-15.146063357546302
ZCTA5 44149,7499,15,7484,0.0020002667022269638,-15.147482763221435
ZCTA5 60510,10789,78,10711,0.007229585689127816,-15.148292096689284
ZCTA5 80209,13496,135,13361,0.010002963841138114,-15.150687349289699
ZCTA5 21208,15132,171,14961,0.011300555114988104,-15.155053397915633
ZCTA5 53189,9898,60,9838,0.006061830672863205,-15.155394756568315
ZCTA5 94506,8279,29,8250,0.003502838507066071,-15.155468735952791
ZCTA5 49855,12431,112,12319,0.009009733730190652,-15.156454373703271
ZCTA5 50023,13280,130,13150,0.009789156626506024,-15.16597707856358
ZCTA5 77006,12862,121,12741,0.009407557145078526,-15.166059113775177
ZCTA5 18974,16518,202,16316,0.01222908342414336,-15.170258185623698
ZCTA5 29223,20532,296,20236,0.01441652055328268,-15.170290974407843
ZCTA5 80020,19398,269,19129,0.013867409011238271,-15.170713544570999
ZCTA5 36535,11973,102,11871,0.00851916812828865,-15.173138628971126
ZCTA5 21236,15153,171,14982,0.011284894080380123,-15.176286689615504
ZCTA5 33477,7356,12,7344,0.0016313213703099511,-15.17833533695424
ZCTA5 60156,9614,54,9560,0.005616808820470148,-15.17904709570309
ZCTA5 27909,14801,163,14638,0.011012769407472468,-15.18309014274459
ZCTA5 70458,14215,150,14065,0.010552233556102708,-15.184842411480902
ZCTA5 60543,13167,127,13040,0.009645325434799118,-15.193097758273497
ZCTA5 03054,10034,62,9972,0.006178991429140921,-15.193892932669444
ZCTA5 44446,8909,40,8869,0.004489841733078909,-15.20345445604096
ZCTA5 46219,15834,185,15649,0.011683718580270305,-15.234474737346112
ZCTA5 43147,13946,143,13803,0.010253836225440986,-15.236446676609633
ZCTA5 85253,7583,15,7568,0.001978108927864961,-15.24281397306983
ZCTA5 80109,7470,13,7457,0.0017402945113788486,-15.24311940479774
ZCTA5 46140,15754,183,15571,0.011616097499047861,-15.243140385860904
ZCTA5 56401,12325,108,12217,0.008762677484787018,-15.244224967836066
ZCTA5 55987,13818,140,13678,0.010131712259371834,-15.246197239073748
ZCTA5 48420,9001,41,8960,0.004555049438951228,-15.247349222767582
ZCTA5 55123,9524,51,9473,0.0053548929021419575,-15.249977894823369
ZCTA5 43160,9056,42,9014,0.004637809187279152,-15.250064603541226
ZCTA5 43220,11710,95,11615,0.008112724167378309,-15.25015803550852
ZCTA5 46901,16256,194,16062,0.011934055118110236,-15.258652389521803
ZCTA5 30281,23732,371,23361,0.015632900724759816,-15.267603866251305
ZCTA5 44410,7495,13,7482,0.0017344896597731821,-15.27140005845227
ZCTA5 72701,16401,197,16204,0.012011462715688068,-15.271424021390908
ZCTA5 80439,10056,61,9995,0.006066030230708035,-15.273535315756543
ZCTA5 89436,15834,184,15650,0.011620563344701275,-15.278669196862367
ZCTA5 46077,9859,57,9802,0.005781519423876661,-15.280289596747512
ZCTA5 18062,10266,65,10201,0.006331579972725502,-15.282563439291355
ZCTA5 77381,14137,146,13991,0.010327509372568438,-15.291714949190874
ZCTA5 06001,7112,6,7106,8.43644544431946e-4,-15.293886917955646
ZCTA5 24019,11121,82,11039,0.007373437640499955,-15.295235614835237
ZCTA5 60451,11561,91,11470,0.007871291410777614,-15.29718802071884
ZCTA5 32707,14371,151,14220,0.010507271588615962,-15.297911239561229
ZCTA5 31324,8890,38,8852,0.0042744656917885265,-15.300164334216628
ZCTA5 44202,7803,18,7785,0.002306805074971165,-15.30087856102728
ZCTA5 14226,12526,111,12415,0.00886156793868753,-15.306476698939976
ZCTA5 27012,10592,71,10521,0.006703172205438066,-15.310642189919443
ZCTA5 97229,24393,386,24007,0.01582421186405936,-15.312601869652577
ZCTA5 03053,8963,39,8924,0.004351221689166573,-15.322443111577927
ZCTA5 46038,16585,200,16385,0.012059089538739826,-15.322739562916713
ZCTA5 20814,13060,122,12938,0.009341500765696785,-15.324328519135802
ZCTA5 30269,13437,130,13307,0.00967477859641289,-15.329094107987645
ZCTA5 19073,7885,19,7866,0.0024096385542168677,-15.33028453718705
ZCTA5 32803,9497,49,9448,0.005159524060229547,-15.334225589402173
ZCTA5 28216,19911,277,19634,0.013911907990557982,-15.335088216112267
ZCTA5 33436,17401,218,17183,0.012528015631285559,-15.351164387242486
ZCTA5 45248,9775,54,9721,0.005524296675191816,-15.356481827947992
ZCTA5 15108,16717,202,16515,0.012083507806424598,-15.366038272555043
ZCTA5 80212,9059,40,9019,0.00441549839938183,-15.370259829511808
ZCTA5 21701,15664,178,15486,0.011363636363636364,-15.375252322905625
ZCTA5 15241,7646,14,7632,0.0018310227569971226,-15.37752614562675
ZCTA5 44511,8961,38,8923,0.004240598147528178,-15.378969146783847
ZCTA5 44131,8325,26,8299,0.003123123123123123,-15.390183740514404
ZCTA5 68130,7884,18,7866,0.00228310502283105,-15.391792542331432
ZCTA5 21113,13411,128,13283,0.0095444038475878,-15.398219225807308
ZCTA5 18020,7723,15,7708,0.0019422504208209245,-15.40040413842469
ZCTA5 27565,9816,54,9762,0.005501222493887531,-15.40136679163816
ZCTA5 06109,10843,74,10769,0.00682467951673891,-15.420626815667895
ZCTA5 44125,11582,89,11493,0.007684337765498187,-15.422964399599284
ZCTA5 27889,10747,72,10675,0.006699544058807109,-15.424352550825407
ZCTA5 30815,13992,140,13852,0.010005717552887363,-15.424770129587989
ZCTA5 45377,6875,0,6875,0,-15.425909819739942
ZCTA5 48203,9891,55,9836,0.005560610656152058,-15.427246521256004
ZCTA5 46311,7927,18,7909,0.0022707203229468905,-15.439841544722976
ZCTA5 98116,12751,113,12638,0.00886205003529135,-15.44303444864236
ZCTA5 30350,17060,208,16852,0.012192262602579133,-15.443883036333428
ZCTA5 24401,15201,166,15035,0.010920334188540227,-15.450263184110737
ZCTA5 30214,10824,73,10751,0.006744271988174427,-15.453631748653983
ZCTA5 34202,9193,41,9152,0.004459915152833678,-15.459837253771795
ZCTA5 17050,15219,166,15053,0.010907418358630658,-15.46826897208818
ZCTA5 77584,29612,512,29100,0.01729028772119411,-15.46837985666619
ZCTA5 48313,13293,124,13169,0.0093282178590235465,-15.468939469361294
ZCTA5 14845,8614,30,8584,0.003482702577199907,-15.469445175046038
ZCTA5 98277,15809,179,15630,0.01132266430514264,-15.4749005209912
ZCTA5 19606,13396,126,13270,0.009405792773962376,-15.478822690559754
ZCTA5 37849,10048,57,9991,0.005672770700636942,-15.486679746280045
ZCTA5 51106,10616,68,10548,0.00640542577241899,-15.498582646074244
ZCTA5 33496,9701,50,9651,0.005154107823935676,-15.50101037680809
ZCTA5 54601,20217,280,19937,0.013849730424889944,-15.501641627307421
ZCTA5 44709,8481,27,8454,0.0031835868411743897,-15.502745053685503
ZCTA5 60067,15571,173,15398,0.011110397533877079,-15.505273889449951
ZCTA5 47546,8538,28,8510,0.0032794565472007496,-15.505490855879872
ZCTA5 44133,12623,109,12514,0.008635031292085874,-15.5071694711602
ZCTA5 08057,7186,4,7182,5.566379070414695e-4,-15.508547356801751
ZCTA5 29209,13565,129,13436,0.00950976778474014,-15.508810331302335
ZCTA5 54729,13473,127,13346,0.0094262599272619315,-15.510033444910926
ZCTA5 19810,9819,52,9767,0.005295854975048375,-15.516889396393346
ZCTA5 60015,9768,51,9717,0.005221130221130221,-15.51761002689447
ZCTA5 98503,15450,170,15280,0.011003236245954692,-15.518985686015588
ZCTA5 35211,11437,84,11353,0.007344583369764799,-15.528178825036274
ZCTA5 62711,6974,0,6974,0,-15.536579384053312
ZCTA5 11530,9423,44,9379,0.004669425872864268,-15.538937266227688
ZCTA5 45331,9844,52,9792,0.005282405526208858,-15.544051337929103
ZCTA5 95120,12516,106,12410,0.008469159475870885,-15.54450298246543
ZCTA5 14020,9646,48,9598,0.004976155919552146,-15.554200275396218
ZCTA5 48168,8204,21,8183,0.002559726962457338,-15.561715053651945
ZCTA5 98382,13479,126,13353,0.009347874471399956,-15.564095608698791
ZCTA5 53402,13386,124,13262,0.009263409532347229,-15.564655167184386
ZCTA5 07747,11771,90,11681,0.007645909438450429,-15.571480174888237
ZCTA5 60089,15596,172,15424,0.011028468838163632,-15.574615287063631
ZCTA5 84109,8927,34,8893,0.003808670325977372,-15.57671421145249
ZCTA5 06824,11631,87,11544,0.00748001031725561,-15.578100742538053
ZCTA5 85755,7012,0,7012,0,-15.578849814901767
ZCTA5 60450,8496,26,8470,0.0030602636534839923,-15.579662806754092
ZCTA5 44118,15428,168,15260,0.010889292196007259,-15.58663895513163
ZCTA5 15301,20311,280,20031,0.013785633400620353,-15.58843802737027
ZCTA5 31522,7493,8,7485,0.0010676631522754572,-15.590361517592282
ZCTA5 60004,20061,274,19787,0.013658342056726983,-15.592467502147878
ZCTA5 03110,7787,13,7774,0.001669449081803005,-15.597957094146135
ZCTA5 42104,13468,125,13343,0.009281259281259282,-15.600735537661993
ZCTA5 44483,10864,71,10793,0.0065353460972017675,-15.603261512704455
ZCTA5 84092,9059,36,9023,0.003973948559443647,-15.603972904112268
ZCTA5 22901,14905,156,14749,0.010466286481046628,-15.60736634393473
ZCTA5 46614,12344,101,12243,0.008182112767336358,-15.614679117319932
ZCTA5 49707,9970,53,9917,0.005315947843530591,-15.62458911311262
ZCTA5 18944,9348,41,9307,0.0043859649122807015,-15.629385396980789
ZCTA5 27519,19163,252,18911,0.013150341804519126,-15.630559511355465
ZCTA5 21014,14012,136,13876,0.009705966314587497,-15.633111589639727
ZCTA5 89044,8819,31,8788,0.0035151377707223043,-15.635498327835226
ZCTA5 63130,12028,94,11934,0.007815098104423013,-15.637362404472618
ZCTA5 21286,8054,17,8037,0.002110752421157189,-15.642868991350731
ZCTA5 94563,7071,0,7071,0,-15.644253890804572
ZCTA5 48066,19956,270,19686,0.013529765484064944,-15.652617585675236
ZCTA5 28590,9477,43,9434,0.00453730083359713,-15.654927093190256
ZCTA5 30338,14219,140,14079,0.009845980730009142,-15.655315071218046
ZCTA5 88310,14685,150,14535,0.010214504596527068,-15.661432266153488
ZCTA5 89113,11321,79,11242,0.00697818213938698,-15.666032291765882
ZCTA5 55127,7566,8,7558,0.00105736188210415,-15.671104373760024
ZCTA5 37920,17040,202,16838,0.011854460093896714,-15.680050475994971
ZCTA5 16602,12455,102,12353,0.00818948213568848,-15.680153660582794
ZCTA5 11793,10381,60,10321,0.005779790000963298,-15.680571534269353
ZCTA5 17402,13642,127,13515,0.009309485412696085,-15.682855234447503
ZCTA5 53051,15074,158,14916,0.010481623988324267,-15.685126764219161
ZCTA5 02144,10891,70,10821,0.006427325314479846,-15.685329535981639
ZCTA5 46250,9355,40,9315,0.00427578834847675,-15.694497847666828
ZCTA5 32003,10292,58,10234,0.005635445005829771,-15.694644976200504
ZCTA5 85268,11693,86,11607,0.0073548276746771574,-15.694844105361438
ZCTA5 45322,8656,27,8629,0.0031192236598890943,-15.695174127309418
ZCTA5 44312,13518,124,13394,0.009172954579079745,-15.699694791199017
ZCTA5 27104,12717,107,12610,0.008413934103955335,-15.703457196789367
ZCTA5 32084,12861,110,12751,0.008552989658657958,-15.704417555011158
ZCTA5 30253,19125,249,18876,0.013019607843137255,-15.7155973187979
ZCTA5 30306,11022,72,10950,0.0065323897659227,-15.718040571259237
ZCTA5 55105,10572,63,10509,0.005959137343927355,-15.721617205325844
ZCTA5 48390,10369,59,10310,0.005690037612113029,-15.722330897596207
ZCTA5 40515,14609,147,14462,0.010062290368950648,-15.723165492841375
ZCTA5 53095,11916,90,11826,0.0075528700906344415,-15.723574605027192
ZCTA5 48382,8354,21,8333,0.0025137658606655495,-15.726695521576648
ZCTA5 28374,7797,11,7786,0.001410799025266128,-15.734979724459839
ZCTA5 38125,13934,132,13802,0.009473230945887756,-15.742317700991919
ZCTA5 10541,8972,32,8940,0.0035666518056174765,-15.743409294125115
ZCTA5 56308,11296,77,11219,0.00681657223796034,-15.744245006866866
ZCTA5 56560,16576,190,16386,0.011462355212355212,-15.745833421098286
ZCTA5 06033,11498,81,11417,0.007044703426682901,-15.748356360418938
ZCTA5 44514,9619,44,9575,0.004574280070693419,-15.751605872399834
ZCTA5 17022,11155,74,11081,0.00663379650380995,-15.753027856547932
ZCTA5 54904,8981,32,8949,0.0035630776082841552,-15.753187252246033
ZCTA5 46706,7644,8,7636,0.0010465724751439038,-15.75692204828973
ZCTA5 42503,9201,36,9165,0.0039126181936746,-15.758509363040979
ZCTA5 54494,11803,87,11716,0.007371007371007371,-15.75871935495268
ZCTA5 98685,10607,63,10544,0.005939473932308852,-15.758882017191361
ZCTA5 22406,8990,32,8958,0.003559510567296997,-15.762959369626614
ZCTA5 89052,21558,305,21253,0.014147880137304017,-15.764056706551681
ZCTA5 45247,9473,41,9432,0.0043280903620817055,-15.764860487825135
ZCTA5 44212,16865,196,16669,0.011621701749184702,-15.767423616822152
ZCTA5 20169,7655,8,7647,0.001045068582625735,-15.76898710344729
ZCTA5 14534,11765,86,11679,0.007309817254568636,-15.770240833890881
ZCTA5 44406,8787,28,8759,0.0031865255491066347,-15.778409485537878
ZCTA5 29505,9704,45,9659,0.004637262984336356,-15.786545376678772
ZCTA5 50010,14588,145,14443,0.009939676446394296,-15.794217694494607
ZCTA5 11725,9823,47,9776,0.004784688995215311,-15.801788783962976
ZCTA5 30533,9678,44,9634,0.0045463938830336845,-15.815095940884277
ZCTA5 08234,14011,132,13879,0.009421169081436014,-15.820024466341131
ZCTA5 21037,8103,15,8088,0.0018511662347278786,-15.820329336617819
ZCTA5 44105,15349,161,15188,0.01048928268942602,-15.822277954766829
ZCTA5 22015,14664,146,14518,0.009956355701036552,-15.824074071140243
ZCTA5 77008,16262,181,16081,0.011130242282622063,-15.831507719007186
ZCTA5 39042,14027,132,13895,0.00941042275611321,-15.836132723738459
ZCTA5 30004,22152,317,21835,0.01431022029613579,-15.845391113630034
ZCTA5 33914,14735,147,14588,0.009976247030878859,-15.84890851734348
ZCTA5 30327,9178,34,9144,0.0037045107866637613,-15.84967376567277
ZCTA5 33572,7613,6,7607,7.881255746748983e-4,-15.850343028274754
ZCTA5 87114,25056,387,24669,0.015445402298850575,-15.85276154751641
ZCTA5 98335,10028,50,9978,0.00498603909054647,-15.85369412085363
ZCTA5 75225,8804,27,8777,0.0030667878237164927,-15.856144181378065
ZCTA5 95816,9874,47,9827,0.004759975693741138,-15.856412838054892
ZCTA5 45211,15887,172,15715,0.010826461887077485,-15.860840067859966
ZCTA5 32708,16702,190,16512,0.01137588312776913,-15.867712382303962
ZCTA5 08054,17281,203,17078,0.011747005381633008,-15.869099008427055
ZCTA5 73162,11811,85,11726,0.0071966810600287865,-15.869417493217334
ZCTA5 78746,10867,66,10801,0.006073433330265943,-15.873195599715075
ZCTA5 02186,8881,28,8853,0.003152798108321135,-15.880256437129708
ZCTA5 08753,23403,346,23057,0.014784429346664957,-15.883238035730628
ZCTA5 29579,15504,163,15341,0.01051341589267286,-15.885256041465516
ZCTA5 46804,11926,87,11839,0.007294985745430153,-15.886786678591562
ZCTA5 43221,13568,121,13447,0.00891804245283019,-15.89382730525617
ZCTA5 11768,7830,9,7821,0.0011494252873563218,-15.896862158223914
ZCTA5 38117,10739,63,10676,0.005866468013781544,-15.898708385082445
ZCTA5 20155,11144,71,11073,0.006371141421392678,-15.89945359379956
ZCTA5 35226,13344,116,13228,0.00869304556354916,-15.906620448869784
ZCTA5 44512,14614,143,14471,0.009785137539345833,-15.91217916178115
ZCTA5 80122,12595,100,12495,0.007939658594680429,-15.923951274775124
ZCTA5 53217,11717,82,11635,0.0069983784245113935,-15.925512794411329
ZCTA5 34957,10772,63,10709,0.005848496101002599,-15.933490341991508
ZCTA5 83714,9789,44,9745,0.004494841148227602,-15.933896585830537
ZCTA5 34609,15419,160,15259,0.010376807834489915,-15.93598493620239
ZCTA5 14850,24788,378,24410,0.015249314184282717,-15.939438839682843
ZCTA5 13126,13715,123,13592,0.008968282901932191,-15.946974631392644
ZCTA5 85374,21551,300,21251,0.01392046772771565,-15.947154029615232
ZCTA5 61350,10017,48,9969,0.004791853848457622,-15.95307726378499
ZCTA5 55345,8898,27,8871,0.0030343897505057315,-15.957562470764831
ZCTA5 44256,24276,365,23911,0.015035425935079914,-15.95929108402392
ZCTA5 21042,13917,127,13790,0.009125529927426887,-15.960820401620538
ZCTA5 45039,9125,31,9094,0.003397260273972603,-15.967063680216086
ZCTA5 35243,7724,6,7718,7.767995857068876e-4,-15.971011983289282
ZCTA5 80550,10092,49,10043,0.004855330955212049,-15.977225939449644
ZCTA5 77406,15096,152,14944,0.010068892421833599,-15.978576776628497
ZCTA5 32082,12745,102,12643,0.008003138485680659,-15.978639918131803
ZCTA5 19808,15374,158,15216,0.010277091192923117,-15.981471697397717
ZCTA5 11731,10044,48,9996,0.0047789725209080045,-15.98174211716779
ZCTA5 47374,18465,227,18238,0.012293528296777687,-15.990729085861568
ZCTA5 01950,7918,9,7909,0.0011366506693609498,-15.992265071791442
ZCTA5 08088,9261,33,9228,0.0035633300939423387,-15.99673538372842
ZCTA5 12189,8212,14,8198,0.0017048222113979542,-16.00013000028501
ZCTA5 34231,14425,137,14288,0.00949740034662045,-16.00113369149308
ZCTA5 52732,11394,74,11320,0.006494646305072845,-16.00349167259252
ZCTA5 44221,13155,110,13045,0.008361839604713038,-16.004825530500643
ZCTA5 77356,11315,72,11243,0.006363234644277508,-16.025651659055267
ZCTA5 44333,7421,0,7421,0,-16.026757019856944
ZCTA5 72113,10507,56,10451,0.005329780146568954,-16.031968399110955
ZCTA5 20817,13281,112,13169,0.008433099917174912,-16.035621335704587
ZCTA5 28226,15892,168,15724,0.010571356657437704,-16.042178689418442
ZCTA5 94595,9628,39,9589,0.004050685500623183,-16.044683709886755
ZCTA5 29841,13052,107,12945,0.008197977321483297,-16.0461529100979
ZCTA5 16601,13455,115,13340,0.008547008547008548,-16.066845514725618
ZCTA5 30157,16911,190,16721,0.011235290639228904,-16.06835780886032
ZCTA5 15644,8390,16,8374,0.0019070321811680572,-16.069604314802863
ZCTA5 38002,13036,106,12930,0.008131328628413623,-16.078632857294224
ZCTA5 77095,24175,359,23816,0.01485005170630817,-16.08634332058806
ZCTA5 08330,10714,59,10655,0.005506813515027067,-16.087217592987248
ZCTA5 46321,8697,21,8676,0.002414625733011383,-16.097718504500126
ZCTA5 14225,15224,152,15072,0.009984235417761429,-16.10426403537092
ZCTA5 48423,14076,127,13949,0.00902244955953396,-16.119747593296346
ZCTA5 89012,14219,130,14089,0.009142696392151347,-16.12168293878326
ZCTA5 11566,11113,66,11047,0.005938990371636822,-16.130670103289795
ZCTA5 30115,13662,118,13544,0.008637095593617333,-16.131407390527745
ZCTA5 32966,7934,7,7927,8.822788001008318e-4,-16.1344170584777
ZCTA5 32507,12952,103,12849,0.007952439777640518,-16.139964071970475
ZCTA5 77345,9508,35,9473,0.0036811106436684896,-16.14478829548795
ZCTA5 48433,10260,49,10211,0.004775828460038986,-16.154445740165947
ZCTA5 46123,12580,95,12485,0.007551669316375199,-16.156470505684432
ZCTA5 32309,12391,91,12300,0.007344040029053345,-16.163175156377992
ZCTA5 73120,17459,200,17259,0.011455409817286214,-16.164884342183935
ZCTA5 98103,24438,363,24075,0.014853916032408545,-16.1702488840102
ZCTA5 57105,9642,37,9605,0.0038373781373159097,-16.172825018214155
ZCTA5 43209,11808,79,11729,0.006690379403794038,-16.173359138000816
ZCTA5 80016,18354,220,18134,0.011986487959028005,-16.173919251653956
ZCTA5 35802,10128,46,10082,0.004541864139020537,-16.181132538542847
ZCTA5 64055,14564,136,14428,0.009338093930238945,-16.18495724609746
ZCTA5 43512,11319,69,11250,0.0060959448714550755,-16.186626881802507
ZCTA5 28104,10728,57,10671,0.005313199105145414,-16.20924666943081
ZCTA5 60914,10372,50,10322,0.0048206710374084074,-16.21698168252807
ZCTA5 32937,11349,69,11280,0.006079830822098863,-16.217609846869273
ZCTA5 39047,14691,138,14553,0.009393506228303043,-16.21802117734784
ZCTA5 29707,11353,69,11284,0.006077688716638774,-16.221736860986
ZCTA5 53202,15443,154,15289,0.009972155669235252,-16.22802990516375
ZCTA5 58102,13378,110,13268,0.008222454776498729,-16.22956513696501
ZCTA5 22405,10388,50,10338,0.004813246053138236,-16.233693613878067
ZCTA5 01701,12997,102,12895,0.00784796491498038,-16.234214207765802
ZCTA5 33928,10908,60,10848,0.005500550055005501,-16.23584890422504
ZCTA5 55025,9162,27,9135,0.0029469548133595285,-16.2391011165678
ZCTA5 76034,8886,22,8864,0.002475804636506865,-16.23962183457257
ZCTA5 21209,11525,72,11453,0.006247288503253796,-16.242902820125753
ZCTA5 41042,20475,267,20208,0.013040293040293041,-16.24434795319471
ZCTA5 19119,11930,80,11850,0.006705783738474434,-16.247339053147066
ZCTA5 60615,21122,282,20840,0.01335100842723227,-16.24788153240791
ZCTA5 28105,17147,191,16956,0.011138974747769289,-16.25022792277206
ZCTA5 20721,9612,35,9577,0.0036412817311693717,-16.254560704581998
ZCTA5 78759,20454,266,20188,0.013004791238877482,-16.264251348100217
ZCTA5 63367,8629,17,8612,0.0019701008228068142,-16.264298424378907
ZCTA5 19002,12097,83,12014,0.00686120525750186,-16.2655982495579
ZCTA5 33076,11501,71,11430,0.006173376228154073,-16.270062258507572
ZCTA5 36695,18736,226,18510,0.012062339880444065,-16.28362671848851
ZCTA5 62025,12079,82,11997,0.006788641443828131,-16.297842887537524
ZCTA5 11756,13499,111,13388,0.008222831320838581,-16.302552405287017
ZCTA5 27215,18189,213,17976,0.011710374402111166,-16.30814260712036
ZCTA5 49506,12242,85,12157,0.006943309916680281,-16.31227192190251
ZCTA5 48603,11847,77,11770,0.0064995357474466105,-16.315562952640782
ZCTA5 60175,7990,5,7985,6.257822277847309e-4,-16.318759478285017
ZCTA5 48348,8645,16,8629,0.0018507807981492192,-16.341066454332186
ZCTA5 80129,11164,63,11101,0.005643138659978502,-16.341480303080633
ZCTA5 20602,10073,42,10031,0.004169562195969423,-16.344933318017482
ZCTA5 01867,9099,24,9075,0.002637652489284537,-16.34724821031321
ZCTA5 80525,21710,293,21417,0.013496084753569783,-16.353610847251204
ZCTA5 30215,12432,88,12344,0.007078507078507079,-16.35454019503997
ZCTA5 55024,12002,79,11923,0.0065822362939510085,-16.37156362948257
ZCTA5 53211,14290,126,14164,0.008817354793561931,-16.37816441291989
ZCTA5 85373,8906,20,8886,0.0022456770716370988,-16.378660989143846
ZCTA5 35801,9839,37,9802,0.003760544770810042,-16.379589410610574
ZCTA5 18951,13580,111,13469,0.00817378497790869,-16.383175345659833
ZCTA5 75077,12912,97,12815,0.007512391573729863,-16.3930959191285
ZCTA5 84095,20167,256,19911,0.012694005057767641,-16.395182531959534
ZCTA5 95746,8249,8,8241,9.698145229724816e-4,-16.407375379527398
ZCTA5 19047,12932,97,12835,0.007500773275595422,-16.413134504295464
ZCTA5 29036,8664,15,8649,0.0017313019390581717,-16.42086007359868
ZCTA5 45056,8497,12,8485,0.0014122631517006002,-16.425378477016938
ZCTA5 48329,9727,34,9693,0.003495425105376786,-16.43150602562369
ZCTA5 60423,10271,44,10227,0.004283906143510856,-16.440349688466842
ZCTA5 29205,10695,52,10643,0.004862085086489013,-16.44373888898185
ZCTA5 49024,11622,70,11552,0.006023059714334882,-16.445543292978428
ZCTA5 34292,7814,0,7814,0,-16.445653675472506
ZCTA5 14626,12638,90,12548,0.0071213799651843645,-16.462678912281085
ZCTA5 49428,10080,40,10040,0.003968253968253968,-16.46300865641492
ZCTA5 48843,17198,187,17011,0.010873357367135713,-16.4680892834884
ZCTA5 54016,12347,84,12263,0.006803272049890662,-16.46861249509731
ZCTA5 48009,9117,22,9095,0.0024130744762531535,-16.482659049618857
ZCTA5 12205,11149,60,11089,0.005381648578347834,-16.48404359894269
ZCTA5 19426,12366,84,12282,0.006792819019893256,-16.487743142702325
ZCTA5 80210,15206,143,15063,0.009404182559515981,-16.49251649826945
ZCTA5 32256,20410,259,20151,0.01268985791278785,-16.496957554918513
ZCTA5 19355,9805,34,9771,0.0034676185619581844,-16.512567986452876
ZCTA5 02472,15607,151,15456,0.009675145767924649,-16.520315655709663
ZCTA5 17404,13673,110,13563,0.008045052292839904,-16.52288939052592
ZCTA5 63139,11088,58,11030,0.005230880230880231,-16.527174465797323
ZCTA5 61611,10777,52,10725,0.0048250904704463205,-16.528014205380288
ZCTA5 62526,14116,119,13997,0.008430150184188155,-16.533980632401327
ZCTA5 44120,15902,157,15745,0.009872971953213433,-16.536985628830166
ZCTA5 07960,17839,199,17640,0.011155333819160267,-16.56273840041844
ZCTA5 55369,15235,142,15093,0.009320643255661306,-16.565578107718252
ZCTA5 14624,14105,118,13987,0.00836582772066643,-16.57001998660176
ZCTA5 48867,11338,62,11276,0.0054683365672958196,-16.571844518205022
ZCTA5 29710,13436,104,13332,0.007740398928252456,-16.575447345564776
ZCTA5 44143,10772,51,10721,0.004734496843668771,-16.57646850117378
ZCTA5 45208,8985,18,8967,0.002003338898163606,-16.578888475451993
ZCTA5 95070,11091,57,11034,0.005139302136867731,-16.583044122863132
ZCTA5 45066,8705,13,8692,0.0014933946008041355,-16.58310766730259
ZCTA5 14094,20203,252,19951,0.012473395040340543,-16.58418933538125
ZCTA5 17901,9838,33,9805,0.0033543403130717625,-16.602815414408486
ZCTA5 48220,11273,60,11213,0.005322451876164287,-16.61041116971998
ZCTA5 06095,10859,52,10807,0.0047886545722442215,-16.61188902581417
ZCTA5 08003,10820,51,10769,0.004713493530499076,-16.62550947007262
ZCTA5 55304,16272,163,16109,0.010017207472959685,-16.62594774236397
ZCTA5 70808,13536,105,13431,0.00775709219858156,-16.626215321195996
ZCTA5 19083,12902,92,12810,0.0071306774143543635,-16.627864850024007
ZCTA5 48708,10934,53,10881,0.004847265410645693,-16.635074655028994
ZCTA5 68144,10043,36,10007,0.003584586279000299,-16.646586907551214
ZCTA5 38016,18646,215,18431,0.011530623189960313,-16.648241807639934
ZCTA5 06880,10062,36,10026,0.0035778175313059034,-16.666101854818443
ZCTA5 29708,12302,79,12223,0.006421720045521054,-16.6739191420334
ZCTA5 54449,11646,66,11580,0.005667181865018032,-16.676090986506058
ZCTA5 45231,16005,156,15849,0.009746954076850984,-16.67911470498299
ZCTA5 34698,18237,205,18032,0.011240883917310962,-16.68223395839826
ZCTA5 32164,16303,162,16141,0.00993682144390603,-16.69885651058632
ZCTA5 15090,9004,16,8988,0.001776988005330964,-16.71585203131595
ZCTA5 21239,11843,69,11774,0.005826226462889471,-16.72029051582308
ZCTA5 35803,11125,55,11070,0.004943820224719101,-16.72310479564651
ZCTA5 48315,10723,47,10676,0.004383101743914949,-16.741080183943584
ZCTA5 02043,8743,11,8732,0.0012581493766441725,-16.741588144917007
ZCTA5 15216,10521,43,10478,0.004087063967303488,-16.751510826699473
ZCTA5 13027,13860,109,13751,0.007864357864357864,-16.75379537077945
ZCTA5 97213,13966,111,13855,0.007947873406845196,-16.762852466445082
ZCTA5 68135,9630,26,9604,0.0026998961578400833,-16.783513741985143
ZCTA5 53593,9128,17,9111,0.0018624014022787028,-16.7851796368914
ZCTA5 63125,14020,111,13909,0.007917261055634808,-16.815385631090994
ZCTA5 13090,11994,70,11924,0.005836251459062865,-16.820440368184695
ZCTA5 68164,11893,68,11825,0.005717649037248802,-16.821397945456543
ZCTA5 37421,19734,235,19499,0.011908381473598864,-16.831960433401377
ZCTA5 03431,10336,38,10298,0.003676470588235294,-16.83572009006295
ZCTA5 13440,16173,156,16017,0.009645705805972918,-16.838029630129444
ZCTA5 48150,10237,36,10201,0.003516655270098662,-16.844820773044745
ZCTA5 28211,12633,82,12551,0.006490936436317581,-16.853482219023256
ZCTA5 27615,18207,200,18007,0.010984786071291261,-16.860678297129972
ZCTA5 40245,12035,70,11965,0.005816368923971749,-16.861295055160987
ZCTA5 17011,13586,101,13485,0.007434123362284705,-16.86624278139996
ZCTA5 01876,11529,60,11469,0.0052042674993494666,-16.868526200955856
ZCTA5 33467,19875,237,19638,0.011924528301886792,-16.8793266927717
ZCTA5 33484,14332,116,14216,0.008093776165224673,-16.883943865199907
ZCTA5 15221,16084,153,15931,0.009512559064909226,-16.885541320464736
ZCTA5 43050,11764,64,11700,0.005440326419585175,-16.897193783092522
ZCTA5 30064,18068,196,17872,0.010847907903475758,-16.898512260982656
ZCTA5 23233,12231,73,12158,0.005968440847028043,-16.904512339730587
ZCTA5 48116,11097,51,11046,0.0045958367126250335,-16.90590325178069
ZCTA5 52001,17446,182,17264,0.010432190760059613,-16.910452786590803
ZCTA5 43212,11313,55,11258,0.004861663572880756,-16.91240902763962
ZCTA5 15202,10039,31,10008,0.0030879569678254806,-16.919991625357273
ZCTA5 46835,14039,109,13930,0.007764085761094095,-16.927705863049205
ZCTA5 46032,19266,222,19044,0.011522890065400186,-16.928733764293384
ZCTA5 44236,9212,16,9196,0.0017368649587494573,-16.929240609314082
ZCTA5 35405,17060,173,16887,0.010140679953106682,-16.9340731513157
ZCTA5 23185,17433,181,17252,0.010382607698043939,-16.94055794967392
ZCTA5 26003,16933,170,16763,0.010039567708025748,-16.944094260766423
ZCTA5 32713,8297,0,8297,0,-16.946303569838545
ZCTA5 30052,21231,266,20965,0.01252884932410155,-16.955950557752672
ZCTA5 48152,12539,78,12461,0.006220591753728367,-16.95901293235334
ZCTA5 98501,17092,173,16919,0.010121694359934472,-16.963750934659043
ZCTA5 28546,17376,179,17197,0.010301565377532228,-16.972249015813574
ZCTA5 62040,17699,186,17513,0.010509068308944007,-16.975751166447644
ZCTA5 15102,12326,73,12253,0.0059224403699496995,-16.998436479471724
ZCTA5 17331,20975,259,20716,0.01234803337306317,-16.99904446791352
ZCTA5 43420,12435,75,12360,0.006031363088057901,-17.005883693102227
ZCTA5 32514,16816,166,16650,0.009871550903901046,-17.00661947092386
ZCTA5 80021,14477,116,14361,0.008012709815569525,-17.023381132963156
ZCTA5 17112,14576,118,14458,0.00809549945115258,-17.025903502026264
ZCTA5 68516,17162,173,16989,0.010080410208600397,-17.02852953870636
ZCTA5 44313,11905,64,11841,0.005375892482150357,-17.037251589001617
ZCTA5 80005,11176,50,11126,0.004473872584108805,-17.037676628831687
ZCTA5 20148,14880,124,14756,0.008333333333333333,-17.04119650948873
ZCTA5 01810,12474,75,12399,0.006012506012506013,-17.044242918218274
ZCTA5 19038,11131,49,11082,0.004402120204833348,-17.04543954615973
ZCTA5 61032,13238,90,13148,0.006798610061942892,-17.055460049765454
ZCTA5 71105,9790,24,9766,0.0024514811031664963,-17.05905490799483
ZCTA5 30152,15093,128,14965,0.008480752666799178,-17.062013765974235
ZCTA5 95630,27251,405,26846,0.014861839932479541,-17.068291190878124
ZCTA5 16335,11476,55,11421,0.00479261066573719,-17.074949738497114
ZCTA5 29909,9255,14,9241,0.0015126958400864397,-17.088635780599116
ZCTA5 63011,14504,115,14389,0.0079288472145615,-17.09541451590343
ZCTA5 19382,20120,237,19883,0.011779324055666004,-17.097583949377576
ZCTA5 17013,14169,108,14061,0.007622273978403557,-17.099773797387222
ZCTA5 48042,10491,36,10455,0.0034315127251930227,-17.101014185270355
ZCTA5 99208,21409,266,21143,0.012424681208837406,-17.1116422757614
ZCTA5 14086,13063,85,12978,0.0065069279644798285,-17.127745954822338
ZCTA5 15001,13477,93,13384,0.006900645544260592,-17.14285818965196
ZCTA5 89134,11398,52,11346,0.004562203895420249,-17.15361913288386
ZCTA5 08831,20977,255,20722,0.012156171044477285,-17.15438907010777
ZCTA5 60532,12354,70,12284,0.005666180994010037,-17.17612944145496
ZCTA5 43560,12204,67,12137,0.005490003277613897,-17.179770656260786
ZCTA5 55410,8532,0,8532,0,-17.184617117824903
ZCTA5 12309,10456,33,10423,0.0031560826319816373,-17.229087855903
ZCTA5 60091,9635,18,9617,0.001868188894654904,-17.24187408096945
ZCTA5 84121,15859,140,15719,0.00882779494293461,-17.246577951061994
ZCTA5 60564,13343,88,13255,0.006595218466611707,-17.253620006152435
ZCTA5 10583,13746,96,13650,0.006983849847228284,-17.258848362143286
ZCTA5 63146,14102,103,13999,0.007303928520777195,-17.269530229354952
ZCTA5 44039,12609,73,12536,0.00578951542548973,-17.27547380075147
ZCTA5 06489,12821,77,12744,0.006005771780672334,-17.283924426448735
ZCTA5 60302,13707,94,13613,0.006857809878164442,-17.316409766999094
ZCTA5 02740,18303,191,18112,0.010435447740807518,-17.3183693278952
ZCTA5 33437,18402,193,18209,0.010487990435822193,-17.325505595280738
ZCTA5 30331,23605,311,23294,0.013175174751112052,-17.32659733049792
ZCTA5 60515,11522,51,11471,0.004426314875889603,-17.327791629084338
ZCTA5 30066,20163,232,19931,0.011506224272181719,-17.331500743594493
ZCTA5 46234,9841,20,9821,0.00203231378924906,-17.334674727822335
ZCTA5 60068,14231,104,14127,0.007307989600168646,-17.345643970553592
ZCTA5 14616,11961,59,11902,0.004932697934955271,-17.34682661095032
ZCTA5 06877,8997,5,8992,5.557408024897188e-4,-17.353545435886485
ZCTA5 28173,17254,167,17087,0.00967891503419497,-17.36739478958044
ZCTA5 19607,9661,16,9645,0.001656143256391678,-17.38102732717808
ZCTA5 29212,12056,60,11996,0.004976775049767751,-17.388664794585335
ZCTA5 97219,16724,155,16569,0.009268117675197321,-17.39400696711134
ZCTA5 27455,12010,59,11951,0.004912572855953372,-17.39458734377606
ZCTA5 06611,12427,67,12360,0.0053914862798744665,-17.397094641658928
ZCTA5 48642,13154,81,13073,0.006157822715523795,-17.40996361538134
ZCTA5 44883,10915,38,10877,0.0034814475492441596,-17.41415313504046
ZCTA5 08055,9979,21,9958,0.002104419280489027,-17.41573668081908
ZCTA5 44319,9697,16,9681,0.0016499948437661133,-17.416747883814352
ZCTA5 48309,11188,43,11145,0.0038434036467643903,-17.417675189778585
ZCTA5 23227,11721,53,11668,0.004521798481358246,-17.41930023350133
ZCTA5 39564,14311,104,14207,0.007267137167214032,-17.421508087172004
ZCTA5 27502,14016,98,13918,0.006992009132420091,-17.42215203319048
ZCTA5 41017,15284,124,15160,0.008113059408531798,-17.422427498641536
ZCTA5 19958,11569,50,11519,0.004321894718644654,-17.425556071449822
ZCTA5 38135,10501,30,10471,0.0028568707742119798,-17.43663580080901
ZCTA5 17036,9384,10,9374,0.0010656436487638534,-17.448150527729393
ZCTA5 27520,14492,107,14385,0.00738338393596467,-17.45350913600982
ZCTA5 75019,15953,137,15816,0.008587726446436407,-17.466238730326268
ZCTA5 06410,10145,23,10122,0.002267126663380976,-17.468856679312044
ZCTA5 80602,10917,37,10880,0.0033892094897865713,-17.469343579637474
ZCTA5 03801,10327,26,10301,0.0025176721216229304,-17.483263302985907
ZCTA5 44095,14429,105,14324,0.0072770115739136465,-17.48658816438918
ZCTA5 67401,20787,242,20545,0.011641891566844663,-17.48886671908904
ZCTA5 46256,10619,31,10588,0.0029192956022224313,-17.498556503399573
ZCTA5 21146,9609,13,9596,0.0013528983244874596,-17.499496555676586
ZCTA5 34285,9741,15,9726,0.001539882968894364,-17.516653752919446
ZCTA5 13021,16813,154,16659,0.009159578897281865,-17.51849389767041
ZCTA5 27516,15194,120,15074,0.007897854416216928,-17.518575903925107
ZCTA5 47401,17839,176,17663,0.009866023880262347,-17.52038601356133
ZCTA5 43701,23016,292,22724,0.012686826555439694,-17.52107208339425
ZCTA5 60035,11563,48,11515,0.0041511718412176775,-17.52312842892527
ZCTA5 14120,18805,197,18608,0.010475937250731189,-17.523382469299023
ZCTA5 73013,18964,200,18764,0.01054629824931449,-17.543424332960647
ZCTA5 65109,16183,140,16043,0.008651053574738924,-17.546896144412628
ZCTA5 08757,16713,151,16562,0.009034883025189972,-17.55596651564099
ZCTA5 29803,16577,147,16430,0.008867708270495265,-17.604088817031855
ZCTA5 32958,10839,33,10806,0.003044561306393579,-17.606365786346718
ZCTA5 21122,21639,258,21381,0.011922916955497019,-17.613783191081946
ZCTA5 06460,16451,144,16307,0.008753267278584888,-17.61868613424102
ZCTA5 63128,12818,70,12748,0.005461070369792479,-17.624852934889105
ZCTA5 07090,10367,24,10343,0.0023150381016687565,-17.631826527056866
ZCTA5 80123,19433,208,19225,0.010703442597643184,-17.637209522251947
ZCTA5 64114,12220,58,12162,0.004746317512274959,-17.64820974681898
ZCTA5 48111,16674,148,16526,0.0088760945184119,-17.6494965483287
ZCTA5 85331,11644,47,11597,0.004036413603572655,-17.653261904155517
ZCTA5 34481,9769,13,9756,0.0013307400962227454,-17.656766945916395
ZCTA5 37659,11135,37,11098,0.0033228558599012123,-17.681840757535696
ZCTA5 89131,16188,137,16051,0.00846305905609093,-17.682622954985323
ZCTA5 22101,10477,25,10452,0.0023861792497852437,-17.684626652025067
ZCTA5 30305,12001,53,11948,0.004416298641779851,-17.690407167872326
ZCTA5 28409,13102,74,13028,0.00564799267287437,-17.70004914646207
ZCTA5 23059,12489,62,12427,0.004964368644407078,-17.70588384669192
ZCTA5 34238,9886,14,9872,0.0014161440420797087,-17.714964033567785
ZCTA5 30022,24134,312,23822,0.012927819673489683,-17.733367617259102
ZCTA5 02703,17378,161,17217,0.009264587409368167,-17.733433992360464
ZCTA5 36609,11352,40,11312,0.0035236081747709656,-17.734353414673883
ZCTA5 45429,11628,45,11583,0.003869969040247678,-17.740941654690502
ZCTA5 07920,9752,11,9741,0.0011279737489745694,-17.752751128492537
ZCTA5 18045,10327,21,10306,0.002033504405926213,-17.756882184398926
ZCTA5 66208,9110,0,9110,0,-17.757164803241167
ZCTA5 59715,14029,91,13938,0.006486563546938485,-17.763158235973812
ZCTA5 06082,16472,141,16331,0.008559980573093736,-17.76788310482405
ZCTA5 32168,11549,43,11506,0.0037232660836436053,-17.768248131732907
ZCTA5 44685,10189,18,10171,0.0017666110511335754,-17.78765922075753
ZCTA5 55416,16134,133,16001,0.008243461014007686,-17.808223590815487
ZCTA5 64068,13981,89,13892,0.006365782132894643,-17.812164472538417
ZCTA5 45459,12342,57,12285,0.004618376276130287,-17.815131138874147
ZCTA5 48706,16620,143,16477,0.008604091456077016,-17.815901772139124
ZCTA5 43026,23420,293,23127,0.01251067463706234,-17.82409150432647
ZCTA5 18940,11186,35,11151,0.0031289111389236545,-17.836359121362005
ZCTA5 77388,16553,141,16412,0.008518093396967318,-17.841485454576166
ZCTA5 85248,15597,121,15476,0.007757902160671924,-17.84658294918047
ZCTA5 29732,23220,287,22933,0.012360034453057708,-17.875476237690886
ZCTA5 15650,11134,33,11101,0.0029638943775821807,-17.891684707273697
ZCTA5 48306,9604,6,9598,6.247396917950854e-4,-17.89178287428116
ZCTA5 32129,9722,8,9714,8.228759514503189e-4,-17.8927176422057
ZCTA5 29576,14069,89,13980,0.006325964887340963,-17.894398014214925
ZCTA5 35244,12609,60,12549,0.004758505829169641,-17.919296340932696
ZCTA5 08053,17456,158,17298,0.009051329055912008,-17.929877208807806
ZCTA5 12203,13454,76,13378,0.005648877657202319,-17.93566831651284
ZCTA5 17601,20609,226,20383,0.010966082779368237,-17.95335656696522
ZCTA5 48236,11318,35,11283,0.0030924191553277965,-17.96287878117705
ZCTA5 85750,11325,35,11290,0.0030905077262693157,-17.969564000294785
ZCTA5 33908,17557,159,17398,0.009056216893546734,-17.97807163565624
ZCTA5 44515,11876,45,11831,0.0037891545975075784,-17.97810785826665
ZCTA5 29063,14011,86,13925,0.006138034401541646,-17.98118193675315
ZCTA5 15044,10390,18,10372,0.0017324350336862368,-17.981625139250305
ZCTA5 89135,11540,38,11502,0.003292894280762565,-18.018428097336937
ZCTA5 60631,11921,45,11876,0.003774851103095378,-18.020821405157623
ZCTA5 07726,15303,111,15192,0.007253479709860812,-18.024593755406812
ZCTA5 44012,9389,0,9389,0,-18.027026884505723
ZCTA5 30040,23931,299,23632,0.012494254314487484,-18.031619988054963
ZCTA5 67212,18649,181,18468,0.009705614242050513,-18.03555771164031
ZCTA5 20735,12366,53,12313,0.004285945333980268,-18.03802341314408
ZCTA5 64081,9405,0,9405,0,-18.04238047134892
ZCTA5 30809,13831,81,13750,0.005856409514857928,-18.04949385287653
ZCTA5 78633,11702,40,11662,0.003418219107844813,-18.06906695309396
ZCTA5 48038,20076,211,19865,0.01051006176529189,-18.079000862513066
ZCTA5 55110,16329,130,16199,0.007961295854002083,-18.116032685136016
ZCTA5 33418,16864,141,16723,0.008361005692599621,-18.121754713984693
ZCTA5 24018,16151,126,16025,0.0078013745278930095,-18.130045658488612
ZCTA5 79424,18627,178,18449,0.00955602082997799,-18.138455932505092
ZCTA5 23112,19554,198,19356,0.010125805461798098,-18.141229734015088
ZCTA5 23231,13728,77,13651,0.005608974358974359,-18.1433840570829
ZCTA5 02864,13492,72,13420,0.005336495701156241,-18.162763800315204
ZCTA5 16101,14214,86,14128,0.006050372871816519,-18.169095353534004
ZCTA5 57702,14633,94,14539,0.006423836533861819,-18.183710650309454
ZCTA5 18704,13520,72,13448,0.0053254437869822485,-18.1887470870313
ZCTA5 88011,13011,62,12949,0.004765198678041657,-18.198461042414134
ZCTA5 23116,10510,16,10494,0.001522359657469077,-18.204934707780186
ZCTA5 30252,14533,91,14442,0.006261611504851028,-18.230228946437087
ZCTA5 45150,12901,59,12842,0.004573288892333927,-18.242588711357627
ZCTA5 64152,10679,18,10661,0.001685551081561944,-18.256934624450167
ZCTA5 77845,23285,278,23007,0.011939016534249516,-18.25775261973748
ZCTA5 43123,24779,312,24467,0.012591307155252432,-18.263356218330138
ZCTA5 44720,15960,119,15841,0.007456140350877193,-18.265070424407067
ZCTA5 43214,12347,48,12299,0.0038875840285089495,-18.270322640195758
ZCTA5 48154,14331,86,14245,0.0060009769032168024,-18.276604559270073
ZCTA5 80126,15497,109,15388,0.007033619410208428,-18.29069180415978
ZCTA5 32159,15267,104,15163,0.006812078338900897,-18.306680909714583
ZCTA5 02038,11655,34,11621,0.002917202917202917,-18.333539377498077
ZCTA5 37215,9956,4,9952,4.017677782241864e-4,-18.340436306997766
ZCTA5 48192,11166,25,11141,0.0022389396381873546,-18.343390321485128
ZCTA5 19403,18071,161,17910,0.008909302196890045,-18.34916650715157
ZCTA5 19446,22069,248,21821,0.011237482441433685,-18.354194651857867
ZCTA5 75028,15826,114,15712,0.007203336282067484,-18.365093416609028
ZCTA5 80206,13093,60,13033,0.004582601390055755,-18.371909814797103
ZCTA5 46815,10688,16,10672,0.0014970059880239522,-18.373025585011458
ZCTA5 80634,22059,247,21812,0.01119724375538329,-18.38327113372337
ZCTA5 34655,16595,129,16466,0.007773425730641759,-18.39758100139717
ZCTA5 37934,9788,0,9788,0,-18.40608474327371
ZCTA5 72034,18703,173,18530,0.00924985296476501,-18.408272762621912
ZCTA5 55311,13764,72,13692,0.0052310374891020054,-18.41373611934402
ZCTA5 33308,15485,106,15379,0.00684533419438166,-18.41390596114676
ZCTA5 77007,19602,192,19410,0.009794918885827977,-18.42110975354084
ZCTA5 24112,12939,56,12883,0.004328000618285803,-18.424599561289856
ZCTA5 82001,15348,103,15245,0.00671097211363044,-18.424837620514747
ZCTA5 37043,17971,157,17814,0.008736297367981748,-18.427302008406855
ZCTA5 16066,11834,35,11799,0.0029575798546560756,-18.44936159987152
ZCTA5 45036,12000,38,11962,0.0031666666666666666,-18.450935177566855
ZCTA5 85614,13030,57,12973,0.004374520337682272,-18.459745544909005
ZCTA5 23320,22738,260,22478,0.011434602867446565,-18.46501312311126
ZCTA5 44107,24746,305,24441,0.0123252242786713,-18.48396383187244
ZCTA5 32746,16676,128,16548,0.007675701607100024,-18.512605132683493
ZCTA5 37922,13198,59,13139,0.004470374299136233,-18.517129256368694
ZCTA5 22207,11865,34,11831,0.0028655710071639274,-18.529245319905126
ZCTA5 14150,18759,171,18588,0.009115624500239885,-18.538048995127163
ZCTA5 48178,12644,48,12596,0.0037962670041126224,-18.545860691259094
ZCTA5 32259,15732,108,15624,0.006864988558352402,-18.54647505989471
ZCTA5 46514,16429,122,16307,0.007425893237567716,-18.55305585782629
ZCTA5 85383,15795,109,15686,0.006900918012029123,-18.558461793607652
ZCTA5 60062,15951,112,15839,0.007021503354021691,-18.565189539909685
ZCTA5 29466,13360,61,13299,0.004565868263473054,-18.569045522694275
ZCTA5 29414,17228,138,17090,0.008010215927559787,-18.57233617818911
ZCTA5 28411,14564,84,14480,0.005767646251029937,-18.581174305926403
ZCTA5 98117,14778,88,14690,0.0059547976722154556,-18.590668755476134
ZCTA5 85249,13504,63,13441,0.004665284360189573,-18.604603273492803
ZCTA5 55347,11278,22,11256,0.0019507004788082993,-18.60538546808315
ZCTA5 47130,18189,157,18032,0.008631590521743912,-18.617263989342636
ZCTA5 33919,14047,73,13974,0.005196839182743647,-18.624614578505685
ZCTA5 55082,13485,62,13423,0.004597701149425287,-18.635154707303446
ZCTA5 01201,19879,192,19687,0.00965843352281302,-18.65782490559505
ZCTA5 40299,15813,107,15706,0.006766584455827483,-18.662974321604377
ZCTA5 40205,10479,7,10472,6.680026720106881e-4,-18.664431642331333
ZCTA5 44281,12625,45,12580,0.0035643564356435645,-18.676831463851848
ZCTA5 30265,12846,49,12797,0.0038144169391250197,-18.681977723165488
ZCTA5 29483,29706,414,29292,0.013936578468996163,-18.70739111239609
ZCTA5 70115,14808,86,14722,0.005807671528903296,-18.709092872147714
ZCTA5 60046,12418,40,12378,0.003221130616846513,-18.735786322069462
ZCTA5 46062,13177,54,13123,0.004098049631934431,-18.74007194855622
ZCTA5 34952,16892,127,16765,0.007518351882547952,-18.74584252047374
ZCTA5 54313,14808,84,14724,0.005672609400324149,-18.80049260788826
ZCTA5 48067,12299,36,12263,0.0029270672412391252,-18.827157924069677
ZCTA5 30062,23407,265,23142,0.011321399581321827,-18.830999032125227
ZCTA5 30068,12166,33,12133,0.0027124773960217,-18.85671121233532
ZCTA5 06405,12337,36,12301,0.0029180513901272596,-18.86178942639707
ZCTA5 44203,16646,119,16527,0.007148864592094197,-18.873947856748902
ZCTA5 37122,20899,208,20691,0.009952629312407292,-18.893990855842084
ZCTA5 23464,27224,350,26874,0.012856303261827799,-18.900053454413968
ZCTA5 48103,23429,263,23166,0.011225404413333903,-18.921559154485323
ZCTA5 30907,18357,153,18204,0.008334695211635889,-18.926744866720774
ZCTA5 60643,17934,144,17790,0.008029441284710606,-18.93474292355941
ZCTA5 17815,11432,18,11414,0.0015745276417074878,-18.955654171601527
ZCTA5 92637,11156,13,11143,0.0011652922194334888,-18.96581100550256
ZCTA5 48187,18278,150,18128,0.008206587153955575,-18.9822922152562
ZCTA5 30127,22338,237,22101,0.01060972334139135,-18.987484926902702
ZCTA5 70122,14371,71,14300,0.004940505184051214,-19.009070906386686
ZCTA5 44124,17220,127,17093,0.007375145180023229,-19.031472421522324
ZCTA5 53151,13403,52,13351,0.0038797284190106693,-19.04065457837183
ZCTA5 08080,13028,45,12983,0.0034540988639852623,-19.042565385271043
ZCTA5 55044,18493,153,18340,0.008273400746228303,-19.043080094697487
ZCTA5 47906,23812,268,23544,0.011254829497732237,-19.05033903959058
ZCTA5 23111,14317,69,14248,0.004819445414542153,-19.05387771288702
ZCTA5 44224,16363,109,16254,0.006661370164395282,-19.059609493876078
ZCTA5 46902,15766,97,15669,0.0061524800202968416,-19.064029503101295
ZCTA5 29461,13334,50,13284,0.003749812509374531,-19.075006552335335
ZCTA5 13760,19027,163,18864,0.008566773532348767,-19.091021091753408
ZCTA5 24153,14628,74,14554,0.005058791359037462,-19.098730521078775
ZCTA5 80538,19281,168,19113,0.008713241014470205,-19.104924256872152
ZCTA5 23455,19759,178,19581,0.009008553064426337,-19.109443493797595
ZCTA5 30319,19336,169,19167,0.008740173769135292,-19.111326694870698
ZCTA5 34785,13482,52,13430,0.0038569945112001186,-19.11136647906023
ZCTA5 30519,14133,64,14069,0.004528408688884172,-19.12345315547124
ZCTA5 60010,16546,111,16435,0.006708570047141303,-19.13212854509032
ZCTA5 63021,21885,223,21662,0.010189627598811972,-19.139580676823307
ZCTA5 37363,14644,73,14571,0.004984976782299918,-19.15884737994478
ZCTA5 28078,21875,222,21653,0.010148571428571429,-19.1689762137628
ZCTA5 49686,14058,61,13997,0.004339166310997297,-19.197423688089184
ZCTA5 15146,12495,32,12463,0.0025610244097639054,-19.20412500098252
ZCTA5 45503,14262,63,14199,0.004417332772402188,-19.284299164160437
ZCTA5 32526,14320,64,14256,0.004469273743016759,-19.288905948889504
ZCTA5 52722,14594,68,14526,0.004659449088666575,-19.3448064393935
ZCTA5 63109,13602,49,13553,0.003602411410086752,-19.361348748783506
ZCTA5 06492,18535,146,18389,0.007876989479363366,-19.36481973429409
ZCTA5 44240,16173,98,16075,0.006059481852470167,-19.374301749186408
ZCTA5 89074,19940,175,19765,0.008776328986960883,-19.379130295373635
ZCTA5 77494,35342,526,34816,0.014883141870861864,-19.415407584406427
ZCTA5 85258,12684,31,12653,0.0024440239672027754,-19.42210003657184
ZCTA5 21228,18433,142,18291,0.007703575109857321,-19.4423950667528
ZCTA5 44145,13694,49,13645,0.0035782094347889585,-19.44246563808002
ZCTA5 34293,17457,122,17335,0.006988600561379389,-19.44600970585466
ZCTA5 80134,23450,249,23201,0.010618336886993603,-19.447014606525475
ZCTA5 45373,14037,55,13982,0.003918216143050509,-19.460431461733116
ZCTA5 19380,20464,184,20280,0.008991399530883503,-19.46101377293798
ZCTA5 43082,11792,14,11778,0.0011872455902306649,-19.48567803019777
ZCTA5 11743,15108,74,15034,0.004898067249139528,-19.519414123552252
ZCTA5 33573,12630,28,12602,0.0022169437846397467,-19.522632923681645
ZCTA5 80004,14964,71,14893,0.004744720662924352,-19.5304864275177
ZCTA5 60102,11616,10,11606,8.608815426997245e-4,-19.53532705895608
ZCTA5 44094,16280,96,16184,0.005896805896805897,-19.55371462035195
ZCTA5 14580,21334,200,21134,0.009374707040404988,-19.559039354539884
ZCTA5 48307,17864,127,17737,0.007109270040304523,-19.581698713578483
ZCTA5 17701,17706,121,17585,0.00683384163560375,-19.698723307026892
ZCTA5 63017,16624,99,16525,0.005955245428296439,-19.717319570543722
ZCTA5 60657,36624,546,36078,0.014908256880733946,-19.737680475044606
ZCTA5 34990,11919,11,11908,9.228962161255138e-4,-19.750822463669007
ZCTA5 40475,23016,231,22785,0.010036496350364963,-19.75710430676548
ZCTA5 77429,28386,351,28035,0.012365250475586557,-19.759284308624864
ZCTA5 15068,16325,92,16233,0.005635528330781011,-19.766369133338685
ZCTA5 61761,19689,159,19530,0.008075575194270913,-19.8035890937332
ZCTA5 15235,15048,66,14982,0.0043859649122807015,-19.829964638767482
ZCTA5 53066,13547,37,13510,0.0027312320070864396,-19.886052366784877
ZCTA5 21784,13607,38,13569,0.002792680238112736,-19.890180115518834
ZCTA5 14075,18060,123,17937,0.00681063122923588,-19.91201545331233
ZCTA5 75035,22460,214,22246,0.009528049866429208,-19.940761657154567
ZCTA5 48170,16597,93,16504,0.005603422305235886,-19.95336011074038
ZCTA5 19711,19401,149,19252,0.007680016493995155,-19.96461561288477
ZCTA5 43614,14420,51,14369,0.003536754507628294,-19.97887374176135
ZCTA5 27613,17572,111,17461,0.006316867744138402,-20.005144207522886
ZCTA5 28277,26695,305,26390,0.011425360554410938,-20.01569619248673
ZCTA5 01760,14310,48,14262,0.0033542976939203353,-20.02390435857936
ZCTA5 37343,16790,95,16695,0.005658129839189994,-20.029617956096168
ZCTA5 44134,15875,77,15798,0.004850393700787402,-20.04216309756178
ZCTA5 85260,17518,109,17409,0.006222171480762644,-20.04408282180143
ZCTA5 17055,15692,73,15619,0.004652052001019628,-20.064480461253147
ZCTA5 38501,16947,97,16850,0.005723726913317992,-20.07555746245496
ZCTA5 32034,15074,61,15013,0.004046702932201141,-20.07872788243166
ZCTA5 80127,16509,88,16421,0.005330425828336059,-20.095457370113575
ZCTA5 95762,14147,43,14104,0.00303951367781155,-20.117748313450694
ZCTA5 46220,16743,92,16651,0.005494833661828824,-20.119068855339105
ZCTA5 14221,23207,225,22982,0.009695350540785108,-20.127922718730908
ZCTA5 44266,13446,30,13416,0.0022311468094600626,-20.134263876212326
ZCTA5 16001,17657,109,17548,0.006173189103471711,-20.15964362222627
ZCTA5 48044,19125,138,18987,0.007215686274509804,-20.17919870891833
ZCTA5 15237,18165,117,18048,0.006440957886044592,-20.246891376800352
ZCTA5 37075,24276,244,24032,0.010051079255231504,-20.27805986364916
ZCTA5 14612,15151,58,15093,0.0038281301564253183,-20.279561596678455
ZCTA5 08540,17700,106,17594,0.005988700564971751,-20.32067179599092
ZCTA5 43065,14801,50,14751,0.0033781501249915548,-20.348396221559657
ZCTA5 48073,16196,76,16120,0.004692516670782909,-20.35551416706431
ZCTA5 19335,18026,111,17915,0.006157772106956619,-20.38071581475633
ZCTA5 30188,23495,224,23271,0.009533943392211109,-20.390017676740552
ZCTA5 43230,23542,225,23317,0.009557386798063037,-20.390398365644838
ZCTA5 85048,13339,22,13317,0.0016492990479046404,-20.427701583643913
ZCTA5 21234,28647,336,28311,0.01172897685621531,-20.44880595193486
ZCTA5 32940,15694,64,15630,0.004077991589142347,-20.465692367202372
ZCTA5 12065,17836,105,17731,0.005886970172684459,-20.474145419242515
ZCTA5 20854,16594,80,16514,0.004821019645655056,-20.51204815974495
ZCTA5 80526,18495,116,18379,0.006271965396052987,-20.557782174390162
ZCTA5 43015,19854,143,19711,0.007202578825425607,-20.57046461614701
ZCTA5 27587,23114,210,22904,0.009085402786190187,-20.603247293665166
ZCTA5 28269,29707,354,29353,0.011916383343992998,-20.644064921830424
ZCTA5 63033,16948,82,16866,0.0048383290063724336,-20.717153944334207
ZCTA5 29681,19915,140,19775,0.007029876977152899,-20.737575658161912
ZCTA5 21093,15333,51,15282,0.0033261592643318333,-20.746666052243192
ZCTA5 45069,18736,116,18620,0.006191289496157131,-20.752699151383144
ZCTA5 19067,19690,134,19556,0.006805485017775521,-20.7951990403718
ZCTA5 18966,14320,30,14290,0.002094972067039106,-20.86895494879759
ZCTA5 27858,22632,192,22440,0.008483563096500531,-20.89080101786104
ZCTA5 85254,18225,101,18124,0.005541838134430727,-20.955318712751712
ZCTA5 23454,22512,187,22325,0.008306680881307748,-20.98293264844836
ZCTA5 44035,26864,279,26585,0.010385646217986898,-21.026635407330506
ZCTA5 46033,13487,10,13477,7.414547341884778e-4,-21.127031169274755
ZCTA5 47150,19166,115,19051,0.006000208702911405,-21.13660160077706
ZCTA5 15642,18185,95,18090,0.005224085784987627,-21.170601356983425
ZCTA5 43551,15859,51,15808,0.003215839586354751,-21.17678340858284
ZCTA5 44870,16833,68,16765,0.004039683954137706,-21.222979034000343
ZCTA5 63122,15897,50,15847,0.003145247530980688,-21.2516359772085
ZCTA5 83646,20913,146,20767,0.006981303495433463,-21.289898327653507
ZCTA5 30101,19741,122,19619,0.006180031406716985,-21.310813485810254
ZCTA5 77382,13204,0,13204,0,-21.37800600445967
ZCTA5 60126,16837,64,16773,0.0038011522242679813,-21.397624567716598
ZCTA5 23456,17694,79,17615,0.004464790324403753,-21.4445170415119
ZCTA5 45040,19867,119,19748,0.0059898323853626615,-21.527801342453532
ZCTA5 46307,22876,178,22698,0.007781080608497989,-21.59397859506163
ZCTA5 63304,15061,27,15034,0.0017927096474337693,-21.608373717237075
ZCTA5 19063,14799,21,14778,0.0014190147982971822,-21.67241161635677
ZCTA5 85255,17354,67,17287,0.0038607813760516306,-21.67997643141891
ZCTA5 08724,16462,50,16412,0.003037298019681691,-21.70301791242312
ZCTA5 39110,15315,29,15286,0.0018935683969964088,-21.720409700153542
ZCTA5 50613,16270,46,16224,0.0028272894898586356,-21.72505142454725
ZCTA5 30024,23732,191,23541,0.00804820495533457,-21.76543592600811
ZCTA5 63129,21990,155,21835,0.007048658481127785,-21.77567629778013
ZCTA5 45140,20658,128,20530,0.006196146771226644,-21.787274512609784
ZCTA5 63301,19599,107,19492,0.005459462217460074,-21.795020071729194
ZCTA5 11758,18570,87,18483,0.004684975767366721,-21.802083337162955
ZCTA5 37027,19468,104,19364,0.005342099856174234,-21.813124077680836
ZCTA5 46037,14494,8,14486,5.519525320822409e-4,-22.02842727509667
ZCTA5 35242,21757,143,21614,0.006572597324998851,-22.050508454858775
ZCTA5 30041,22355,155,22200,0.006933571907850593,-22.051345705691535
ZCTA5 29464,22043,148,21895,0.006714149616658349,-22.078091066593743
ZCTA5 23452,22509,157,22352,0.006974987782664712,-22.092614656241
ZCTA5 63303,19742,102,19640,0.005166649782190254,-22.103182864177196
ZCTA5 29412,16539,42,16497,0.002539452203881734,-22.109767314308794
ZCTA5 80015,22408,153,22255,0.006827918600499821,-22.165422693266695
ZCTA5 14450,17112,50,17062,0.00292192613370734,-22.211269634585662
ZCTA5 60614,33584,391,33193,0.011642448785135779,-22.22904863382218
ZCTA5 48439,19509,87,19422,0.004459480239889282,-22.521655259714027
ZCTA5 15317,15399,10,15389,6.493928177154361e-4,-22.638494887909175
ZCTA5 32174,22123,132,21991,0.005966641052298513,-22.736421425367542
ZCTA5 08759,19295,77,19218,0.003990671158331174,-22.75993551125121
ZCTA5 43081,24234,172,24062,0.0070974663695634235,-22.817502129475248
ZCTA5 27410,24333,172,24161,0.007068589980684667,-22.88911108699074
ZCTA5 63376,28466,255,28211,0.008958055223775732,-22.983966758390096
ZCTA5 06010,24460,169,24291,0.0069092395748160266,-23.08735938015132
ZCTA5 66062,27970,240,27730,0.008580622095101895,-23.1338812739132
ZCTA5 85375,16778,22,16756,0.0013112409107164144,-23.153666027143853
ZCTA5 75070,34661,383,34278,0.011049883153977093,-23.196173795998313
ZCTA5 85351,17612,33,17579,0.001873722461957756,-23.30702581437555
ZCTA5 45840,24043,154,23889,0.006405190699995841,-23.324354370307276
ZCTA5 30075,19559,67,19492,0.00342553300270975,-23.354643280289707
ZCTA5 14224,17738,33,17705,0.0018604126733566355,-23.400106895048225
ZCTA5 08527,20183,75,20108,0.0037159986126938513,-23.49478235604258
ZCTA5 23322,20524,76,20448,0.0037029818748781913,-23.702798401456306
ZCTA5 63123,22604,103,22501,0.004556715625552999,-24.16109293596649
ZCTA5 02360,23101,112,22989,0.004848274966451668,-24.17883005540273
ZCTA5 44060,25194,106,25088,0.004207350956576963,-25.816152993598575
ZCTA5 15601,24791,90,24701,0.003630349723690049,-26.114072110491595
ZCTA5 32162,30152,1,30151,3.316529583443884e-5,-32.27317866101449
ZCTA5 29208,0,0,0,NaN,NaN
ZCTA5 29117,0,0,0,NaN,NaN
ZCTA5 29147,0,0,0,NaN,NaN
ZCTA5 29225,0,0,0,NaN,NaN
ZCTA5 29424,0,0,0,NaN,NaN
ZCTA5 29613,0,0,0,NaN,NaN
ZCTA5 29733,0,0,0,NaN,NaN
ZCTA5 29899,0,0,0,NaN,NaN
ZCTA5 29904,0,0,0,NaN,NaN
ZCTA5 29912,0,0,0,NaN,NaN
ZCTA5 29423,0,0,0,NaN,NaN
ZCTA5 30602,0,0,0,NaN,NaN
ZCTA5 28017,0,0,0,NaN,NaN
ZCTA5 28629,0,0,0,NaN,NaN
ZCTA5 28244,0,0,0,NaN,NaN
ZCTA5 28280,0,0,0,NaN,NaN
ZCTA5 28282,0,0,0,NaN,NaN
ZCTA5 28310,0,0,0,NaN,NaN
ZCTA5 28652,0,0,0,NaN,NaN
ZCTA5 28019,0,0,0,NaN,NaN
ZCTA5 29207,0,0,0,NaN,NaN
ZCTA5 32432,0,0,0,NaN,NaN
ZCTA5 32447,0,0,0,NaN,NaN
ZCTA5 32399,0,0,0,NaN,NaN
ZCTA5 32026,0,0,0,NaN,NaN
ZCTA5 32228,0,0,0,NaN,NaN
ZCTA5 32509,0,0,0,NaN,NaN
ZCTA5 32511,0,0,0,NaN,NaN
ZCTA5 32530,0,0,0,NaN,NaN
ZCTA5 30118,0,0,0,NaN,NaN
ZCTA5 30164,0,0,0,NaN,NaN
ZCTA5 30332,0,0,0,NaN,NaN
ZCTA5 30334,0,0,0,NaN,NaN
ZCTA5 30460,0,0,0,NaN,NaN
ZCTA5 30475,0,0,0,NaN,NaN
ZCTA5 30609,0,0,0,NaN,NaN
ZCTA5 30812,0,0,0,NaN,NaN
ZCTA5 30912,0,0,0,NaN,NaN
ZCTA5 30275,0,0,0,NaN,NaN
ZCTA5 30250,0,0,0,NaN,NaN
ZCTA5 30726,0,0,0,NaN,NaN
ZCTA5 30322,0,0,0,NaN,NaN
ZCTA5 31039,0,0,0,NaN,NaN
ZCTA5 31699,0,0,0,NaN,NaN
ZCTA5 31062,0,0,0,NaN,NaN
ZCTA5 31213,0,0,0,NaN,NaN
ZCTA5 31304,0,0,0,NaN,NaN
ZCTA5 31409,0,0,0,NaN,NaN
ZCTA5 31524,0,0,0,NaN,NaN
ZCTA5 31698,0,0,0,NaN,NaN
ZCTA5 31314,0,0,0,NaN,NaN
ZCTA5 34101,0,0,0,NaN,NaN
ZCTA5 34445,0,0,0,NaN,NaN
ZCTA5 35074,0,0,0,NaN,NaN
ZCTA5 35457,0,0,0,NaN,NaN
ZCTA5 35229,0,0,0,NaN,NaN
ZCTA5 35896,0,0,0,NaN,NaN
ZCTA5 35082,0,0,0,NaN,NaN
ZCTA5 33101,0,0,0,NaN,NaN
ZCTA5 33744,0,0,0,NaN,NaN
ZCTA5 33855,0,0,0,NaN,NaN
ZCTA5 33965,0,0,0,NaN,NaN
ZCTA5 33945,0,0,0,NaN,NaN
ZCTA5 37730,0,0,0,NaN,NaN
ZCTA5 37132,0,0,0,NaN,NaN
ZCTA5 37240,0,0,0,NaN,NaN
ZCTA5 37243,0,0,0,NaN,NaN
ZCTA5 37246,0,0,0,NaN,NaN
ZCTA5 37315,0,0,0,NaN,NaN
ZCTA5 38132,0,0,0,NaN,NaN
ZCTA5 36849,0,0,0,NaN,NaN
ZCTA5 36082,0,0,0,NaN,NaN
ZCTA5 36112,0,0,0,NaN,NaN
ZCTA5 36590,0,0,0,NaN,NaN
ZCTA5 36615,0,0,0,NaN,NaN
ZCTA5 36688,0,0,0,NaN,NaN
ZCTA5 37614,0,0,0,NaN,NaN
ZCTA5 40231,0,0,0,NaN,NaN
ZCTA5 40404,0,0,0,NaN,NaN
ZCTA5 40434,0,0,0,NaN,NaN
ZCTA5 40506,0,0,0,NaN,NaN
ZCTA5 40604,0,0,0,NaN,NaN
ZCTA5 38131,0,0,0,NaN,NaN
ZCTA5 38029,0,0,0,NaN,NaN
ZCTA5 38152,0,0,0,NaN,NaN
ZCTA5 38505,0,0,0,NaN,NaN
ZCTA5 38704,0,0,0,NaN,NaN
ZCTA5 38958,0,0,0,NaN,NaN
ZCTA5 40339,0,0,0,NaN,NaN
ZCTA5 39061,0,0,0,NaN,NaN
ZCTA5 41062,0,0,0,NaN,NaN
ZCTA5 41099,0,0,0,NaN,NaN
ZCTA5 41848,0,0,0,NaN,NaN
ZCTA5 41762,0,0,0,NaN,NaN
ZCTA5 39269,0,0,0,NaN,NaN
ZCTA5 39167,0,0,0,NaN,NaN
ZCTA5 39193,0,0,0,NaN,NaN
ZCTA5 39217,0,0,0,NaN,NaN
ZCTA5 39309,0,0,0,NaN,NaN
ZCTA5 39406,0,0,0,NaN,NaN
ZCTA5 39534,0,0,0,NaN,NaN
ZCTA5 40048,0,0,0,NaN,NaN
ZCTA5 40049,0,0,0,NaN,NaN
ZCTA5 40063,0,0,0,NaN,NaN
ZCTA5 43733,0,0,0,NaN,NaN
ZCTA5 43336,0,0,0,NaN,NaN
ZCTA5 44243,0,0,0,NaN,NaN
ZCTA5 42356,0,0,0,NaN,NaN
ZCTA5 42370,0,0,0,NaN,NaN
ZCTA5 42638,0,0,0,NaN,NaN
ZCTA5 42060,0,0,0,NaN,NaN
ZCTA5 43967,0,0,0,NaN,NaN
ZCTA5 45051,0,0,0,NaN,NaN
ZCTA5 45428,0,0,0,NaN,NaN
ZCTA5 46771,0,0,0,NaN,NaN
ZCTA5 47876,0,0,0,NaN,NaN
ZCTA5 47406,0,0,0,NaN,NaN
ZCTA5 44101,0,0,0,NaN,NaN
ZCTA5 44265,0,0,0,NaN,NaN
ZCTA5 44881,0,0,0,NaN,NaN
ZCTA5 44901,0,0,0,NaN,NaN
ZCTA5 45624,0,0,0,NaN,NaN
ZCTA5 45642,0,0,0,NaN,NaN
ZCTA5 48143,0,0,0,NaN,NaN
ZCTA5 48109,0,0,0,NaN,NaN
ZCTA5 48242,0,0,0,NaN,NaN
ZCTA5 47836,0,0,0,NaN,NaN
ZCTA5 47536,0,0,0,NaN,NaN
ZCTA5 47434,0,0,0,NaN,NaN
ZCTA5 47809,0,0,0,NaN,NaN
ZCTA5 47907,0,0,0,NaN,NaN
ZCTA5 48233,0,0,0,NaN,NaN
ZCTA5 48243,0,0,0,NaN,NaN
ZCTA5 48397,0,0,0,NaN,NaN
ZCTA5 48551,0,0,0,NaN,NaN
ZCTA5 48553,0,0,0,NaN,NaN
ZCTA5 48554,0,0,0,NaN,NaN
ZCTA5 48667,0,0,0,NaN,NaN
ZCTA5 48710,0,0,0,NaN,NaN
ZCTA5 48825,0,0,0,NaN,NaN
ZCTA5 48921,0,0,0,NaN,NaN
ZCTA5 50011,0,0,0,NaN,NaN
ZCTA5 50319,0,0,0,NaN,NaN
ZCTA5 49104,0,0,0,NaN,NaN
ZCTA5 54561,0,0,0,NaN,NaN
ZCTA5 52557,0,0,0,NaN,NaN
ZCTA5 53031,0,0,0,NaN,NaN
ZCTA5 53295,0,0,0,NaN,NaN
ZCTA5 53792,0,0,0,NaN,NaN
ZCTA5 52242,0,0,0,NaN,NaN
ZCTA5 55155,0,0,0,NaN,NaN
ZCTA5 55814,0,0,0,NaN,NaN
ZCTA5 55905,0,0,0,NaN,NaN
ZCTA5 58076,0,0,0,NaN,NaN
ZCTA5 58105,0,0,0,NaN,NaN
ZCTA5 58205,0,0,0,NaN,NaN
ZCTA5 58402,0,0,0,NaN,NaN
ZCTA5 58405,0,0,0,NaN,NaN
ZCTA5 58702,0,0,0,NaN,NaN
ZCTA5 58705,0,0,0,NaN,NaN
ZCTA5 58707,0,0,0,NaN,NaN
ZCTA5 59636,0,0,0,NaN,NaN
ZCTA5 54985,0,0,0,NaN,NaN
ZCTA5 54307,0,0,0,NaN,NaN
ZCTA5 54946,0,0,0,NaN,NaN
ZCTA5 87554,0,0,0,NaN,NaN
ZCTA5 87117,0,0,0,NaN,NaN
ZCTA5 55455,0,0,0,NaN,NaN
ZCTA5 57799,0,0,0,NaN,NaN
ZCTA5 58202,0,0,0,NaN,NaN
ZCTA5 58505,0,0,0,NaN,NaN
ZCTA5 57117,0,0,0,NaN,NaN
ZCTA5 57197,0,0,0,NaN,NaN
ZCTA5 57776,0,0,0,NaN,NaN
ZCTA5 63045,0,0,0,NaN,NaN
ZCTA5 63057,0,0,0,NaN,NaN
ZCTA5 63155,0,0,0,NaN,NaN
ZCTA5 63902,0,0,0,NaN,NaN
ZCTA5 60539,0,0,0,NaN,NaN
ZCTA5 62829,0,0,0,NaN,NaN
ZCTA5 64102,0,0,0,NaN,NaN
ZCTA5 64192,0,0,0,NaN,NaN
ZCTA5 65728,0,0,0,NaN,NaN
ZCTA5 66622,0,0,0,NaN,NaN
ZCTA5 66031,0,0,0,NaN,NaN
ZCTA5 66045,0,0,0,NaN,NaN
ZCTA5 66760,0,0,0,NaN,NaN
ZCTA5 65215,0,0,0,NaN,NaN
ZCTA5 66778,0,0,0,NaN,NaN
ZCTA5 66115,0,0,0,NaN,NaN
ZCTA5 66118,0,0,0,NaN,NaN
ZCTA5 70163,0,0,0,NaN,NaN
ZCTA5 68178,0,0,0,NaN,NaN
ZCTA5 68849,0,0,0,NaN,NaN
ZCTA5 71209,0,0,0,NaN,NaN
ZCTA5 71272,0,0,0,NaN,NaN
ZCTA5 71998,0,0,0,NaN,NaN
ZCTA5 71999,0,0,0,NaN,NaN
ZCTA5 67260,0,0,0,NaN,NaN
ZCTA5 56711,0,0,0,NaN,NaN
ZCTA5 56741,0,0,0,NaN,NaN
ZCTA5 70836,0,0,0,NaN,NaN
ZCTA5 70451,0,0,0,NaN,NaN
ZCTA5 70558,0,0,0,NaN,NaN
ZCTA5 70139,0,0,0,NaN,NaN
ZCTA5 70402,0,0,0,NaN,NaN
ZCTA5 70803,0,0,0,NaN,NaN
ZCTA5 56321,0,0,0,NaN,NaN
ZCTA5 56593,0,0,0,NaN,NaN
ZCTA5 56658,0,0,0,NaN,NaN
ZCTA5 72467,0,0,0,NaN,NaN
ZCTA5 72379,0,0,0,NaN,NaN
ZCTA5 74078,0,0,0,NaN,NaN
ZCTA5 74477,0,0,0,NaN,NaN
ZCTA5 75270,0,0,0,NaN,NaN
ZCTA5 72099,0,0,0,NaN,NaN
ZCTA5 72035,0,0,0,NaN,NaN
ZCTA5 72119,0,0,0,NaN,NaN
ZCTA5 72149,0,0,0,NaN,NaN
ZCTA5 72515,0,0,0,NaN,NaN
ZCTA5 73019,0,0,0,NaN,NaN
ZCTA5 73705,0,0,0,NaN,NaN
ZCTA5 75858,0,0,0,NaN,NaN
ZCTA5 76523,0,0,0,NaN,NaN
ZCTA5 77428,0,0,0,NaN,NaN
ZCTA5 76949,0,0,0,NaN,NaN
ZCTA5 76874,0,0,0,NaN,NaN
ZCTA5 77507,0,0,0,NaN,NaN
ZCTA5 80294,0,0,0,NaN,NaN
ZCTA5 80264,0,0,0,NaN,NaN
ZCTA5 80293,0,0,0,NaN,NaN
ZCTA5 79051,0,0,0,NaN,NaN
ZCTA5 79016,0,0,0,NaN,NaN
ZCTA5 79058,0,0,0,NaN,NaN
ZCTA5 79105,0,0,0,NaN,NaN
ZCTA5 79699,0,0,0,NaN,NaN
ZCTA5 79920,0,0,0,NaN,NaN
ZCTA5 79406,0,0,0,NaN,NaN
ZCTA5 77973,0,0,0,NaN,NaN
ZCTA5 75390,0,0,0,NaN,NaN
ZCTA5 75962,0,0,0,NaN,NaN
ZCTA5 76798,0,0,0,NaN,NaN
ZCTA5 76129,0,0,0,NaN,NaN
ZCTA5 76402,0,0,0,NaN,NaN
ZCTA5 76508,0,0,0,NaN,NaN
ZCTA5 76596,0,0,0,NaN,NaN
ZCTA5 76597,0,0,0,NaN,NaN
ZCTA5 76598,0,0,0,NaN,NaN
ZCTA5 76599,0,0,0,NaN,NaN
ZCTA5 76908,0,0,0,NaN,NaN
ZCTA5 76957,0,0,0,NaN,NaN
ZCTA5 77201,0,0,0,NaN,NaN
ZCTA5 77342,0,0,0,NaN,NaN
ZCTA5 78001,0,0,0,NaN,NaN
ZCTA5 83233,0,0,0,NaN,NaN
ZCTA5 83460,0,0,0,NaN,NaN
ZCTA5 83844,0,0,0,NaN,NaN
ZCTA5 82005,0,0,0,NaN,NaN
ZCTA5 82073,0,0,0,NaN,NaN
ZCTA5 82630,0,0,0,NaN,NaN
ZCTA5 82638,0,0,0,NaN,NaN
ZCTA5 82646,0,0,0,NaN,NaN
ZCTA5 82715,0,0,0,NaN,NaN
ZCTA5 88004,0,0,0,NaN,NaN
ZCTA5 88354,0,0,0,NaN,NaN
ZCTA5 88033,0,0,0,NaN,NaN
ZCTA5 88323,0,0,0,NaN,NaN
ZCTA5 88003,0,0,0,NaN,NaN
ZCTA5 88417,0,0,0,NaN,NaN
ZCTA5 78029,0,0,0,NaN,NaN
ZCTA5 78150,0,0,0,NaN,NaN
ZCTA5 78243,0,0,0,NaN,NaN
ZCTA5 78335,0,0,0,NaN,NaN
ZCTA5 78712,0,0,0,NaN,NaN
ZCTA5 78951,0,0,0,NaN,NaN
ZCTA5 81642,0,0,0,NaN,NaN
ZCTA5 83121,0,0,0,NaN,NaN
ZCTA5 84515,0,0,0,NaN,NaN
ZCTA5 88103,0,0,0,NaN,NaN
ZCTA5 88355,0,0,0,NaN,NaN
ZCTA5 87750,0,0,0,NaN,NaN
ZCTA5 82936,0,0,0,NaN,NaN
ZCTA5 80419,0,0,0,NaN,NaN
ZCTA5 80471,0,0,0,NaN,NaN
ZCTA5 80511,0,0,0,NaN,NaN
ZCTA5 80939,0,0,0,NaN,NaN
ZCTA5 83826,0,0,0,NaN,NaN
ZCTA5 83874,0,0,0,NaN,NaN
ZCTA5 84180,0,0,0,NaN,NaN
ZCTA5 84304,0,0,0,NaN,NaN
ZCTA5 81038,0,0,0,NaN,NaN
ZCTA5 81231,0,0,0,NaN,NaN
ZCTA5 81612,0,0,0,NaN,NaN
ZCTA5 81633,0,0,0,NaN,NaN
ZCTA5 80290,0,0,0,NaN,NaN
ZCTA5 83677,0,0,0,NaN,NaN
ZCTA5 85608,0,0,0,NaN,NaN
ZCTA5 85309,0,0,0,NaN,NaN
ZCTA5 85535,0,0,0,NaN,NaN
ZCTA5 01063,0,0,0,NaN,NaN
ZCTA5 01086,0,0,0,NaN,NaN
ZCTA5 01199,0,0,0,NaN,NaN
ZCTA5 01937,0,0,0,NaN,NaN
ZCTA5 02457,0,0,0,NaN,NaN
ZCTA5 02643,0,0,0,NaN,NaN
ZCTA5 02651,0,0,0,NaN,NaN
ZCTA5 02841,0,0,0,NaN,NaN
ZCTA5 02912,0,0,0,NaN,NaN
ZCTA5 02366,0,0,0,NaN,NaN
ZCTA5 85654,0,0,0,NaN,NaN
ZCTA5 85341,0,0,0,NaN,NaN
ZCTA5 85707,0,0,0,NaN,NaN
ZCTA5 85723,0,0,0,NaN,NaN
ZCTA5 85724,0,0,0,NaN,NaN
ZCTA5 85726,0,0,0,NaN,NaN
ZCTA5 82061,0,0,0,NaN,NaN
ZCTA5 00936,0,0,0,NaN,NaN
ZCTA5 00950,0,0,0,NaN,NaN
ZCTA5 00951,0,0,0,NaN,NaN
ZCTA5 00960,0,0,0,NaN,NaN
ZCTA5 08074,0,0,0,NaN,NaN
ZCTA5 04271,0,0,0,NaN,NaN
ZCTA5 04469,0,0,0,NaN,NaN
ZCTA5 04570,0,0,0,NaN,NaN
ZCTA5 04644,0,0,0,NaN,NaN
ZCTA5 04940,0,0,0,NaN,NaN
ZCTA5 04975,0,0,0,NaN,NaN
ZCTA5 04629,0,0,0,NaN,NaN
ZCTA5 04228,0,0,0,NaN,NaN
ZCTA5 05405,0,0,0,NaN,NaN
ZCTA5 05481,0,0,0,NaN,NaN
ZCTA5 05439,0,0,0,NaN,NaN
ZCTA5 06020,0,0,0,NaN,NaN
ZCTA5 06059,0,0,0,NaN,NaN
ZCTA5 06160,0,0,0,NaN,NaN
ZCTA5 06856,0,0,0,NaN,NaN
ZCTA5 07495,0,0,0,NaN,NaN
ZCTA5 07939,0,0,0,NaN,NaN
ZCTA5 07961,0,0,0,NaN,NaN
ZCTA5 11042,0,0,0,NaN,NaN
ZCTA5 11371,0,0,0,NaN,NaN
ZCTA5 11351,0,0,0,NaN,NaN
ZCTA5 11359,0,0,0,NaN,NaN
ZCTA5 11424,0,0,0,NaN,NaN
ZCTA5 11425,0,0,0,NaN,NaN
ZCTA5 11451,0,0,0,NaN,NaN
ZCTA5 11549,0,0,0,NaN,NaN
ZCTA5 11556,0,0,0,NaN,NaN
ZCTA5 11794,0,0,0,NaN,NaN
ZCTA5 11973,0,0,0,NaN,NaN
ZCTA5 12007,0,0,0,NaN,NaN
ZCTA5 12024,0,0,0,NaN,NaN
ZCTA5 12222,0,0,0,NaN,NaN
ZCTA5 12527,0,0,0,NaN,NaN
ZCTA5 08240,0,0,0,NaN,NaN
ZCTA5 08320,0,0,0,NaN,NaN
ZCTA5 08217,0,0,0,NaN,NaN
ZCTA5 10110,0,0,0,NaN,NaN
ZCTA5 10168,0,0,0,NaN,NaN
ZCTA5 10174,0,0,0,NaN,NaN
ZCTA5 10311,0,0,0,NaN,NaN
ZCTA5 10545,0,0,0,NaN,NaN
ZCTA5 10910,0,0,0,NaN,NaN
ZCTA5 10911,0,0,0,NaN,NaN
ZCTA5 10119,0,0,0,NaN,NaN
ZCTA5 10112,0,0,0,NaN,NaN
ZCTA5 10152,0,0,0,NaN,NaN
ZCTA5 10177,0,0,0,NaN,NaN
ZCTA5 10170,0,0,0,NaN,NaN
ZCTA5 10171,0,0,0,NaN,NaN
ZCTA5 10172,0,0,0,NaN,NaN
ZCTA5 10103,0,0,0,NaN,NaN
ZCTA5 10154,0,0,0,NaN,NaN
ZCTA5 10173,0,0,0,NaN,NaN
ZCTA5 10271,0,0,0,NaN,NaN
ZCTA5 10111,0,0,0,NaN,NaN
ZCTA5 10115,0,0,0,NaN,NaN
ZCTA5 10153,0,0,0,NaN,NaN
ZCTA5 10169,0,0,0,NaN,NaN
ZCTA5 10020,0,0,0,NaN,NaN
ZCTA5 10165,0,0,0,NaN,NaN
ZCTA5 10167,0,0,0,NaN,NaN
ZCTA5 10278,0,0,0,NaN,NaN
ZCTA5 11430,0,0,0,NaN,NaN
ZCTA5 14109,0,0,0,NaN,NaN
ZCTA5 14627,0,0,0,NaN,NaN
ZCTA5 14778,0,0,0,NaN,NaN
ZCTA5 14853,0,0,0,NaN,NaN
ZCTA5 14893,0,0,0,NaN,NaN
ZCTA5 13290,0,0,0,NaN,NaN
ZCTA5 13024,0,0,0,NaN,NaN
ZCTA5 13138,0,0,0,NaN,NaN
ZCTA5 16444,0,0,0,NaN,NaN
ZCTA5 16546,0,0,0,NaN,NaN
ZCTA5 16563,0,0,0,NaN,NaN
ZCTA5 16699,0,0,0,NaN,NaN
ZCTA5 15260,0,0,0,NaN,NaN
ZCTA5 15290,0,0,0,NaN,NaN
ZCTA5 15510,0,0,0,NaN,NaN
ZCTA5 15616,0,0,0,NaN,NaN
ZCTA5 18936,0,0,0,NaN,NaN
ZCTA5 19367,0,0,0,NaN,NaN
ZCTA5 19519,0,0,0,NaN,NaN
ZCTA5 19345,0,0,0,NaN,NaN
ZCTA5 19710,0,0,0,NaN,NaN
ZCTA5 19112,0,0,0,NaN,NaN
ZCTA5 19902,0,0,0,NaN,NaN
ZCTA5 19109,0,0,0,NaN,NaN
ZCTA5 19383,0,0,0,NaN,NaN
ZCTA5 19442,0,0,0,NaN,NaN
ZCTA5 19477,0,0,0,NaN,NaN
ZCTA5 19542,0,0,0,NaN,NaN
ZCTA5 19716,0,0,0,NaN,NaN
ZCTA5 19717,0,0,0,NaN,NaN
ZCTA5 20045,0,0,0,NaN,NaN
ZCTA5 20052,0,0,0,NaN,NaN
ZCTA5 20053,0,0,0,NaN,NaN
ZCTA5 20057,0,0,0,NaN,NaN
ZCTA5 20064,0,0,0,NaN,NaN
ZCTA5 20202,0,0,0,NaN,NaN
ZCTA5 20204,0,0,0,NaN,NaN
ZCTA5 20228,0,0,0,NaN,NaN
ZCTA5 20230,0,0,0,NaN,NaN
ZCTA5 20240,0,0,0,NaN,NaN
ZCTA5 20245,0,0,0,NaN,NaN
ZCTA5 20260,0,0,0,NaN,NaN
ZCTA5 20307,0,0,0,NaN,NaN
ZCTA5 20373,0,0,0,NaN,NaN
ZCTA5 20427,0,0,0,NaN,NaN
ZCTA5 20390,0,0,0,NaN,NaN
ZCTA5 20405,0,0,0,NaN,NaN
ZCTA5 20418,0,0,0,NaN,NaN
ZCTA5 20506,0,0,0,NaN,NaN
ZCTA5 17120,0,0,0,NaN,NaN
ZCTA5 17261,0,0,0,NaN,NaN
ZCTA5 17822,0,0,0,NaN,NaN
ZCTA5 18016,0,0,0,NaN,NaN
ZCTA5 18068,0,0,0,NaN,NaN
ZCTA5 18105,0,0,0,NaN,NaN
ZCTA5 18195,0,0,0,NaN,NaN
ZCTA5 21105,0,0,0,NaN,NaN
ZCTA5 22035,0,0,0,NaN,NaN
ZCTA5 22185,0,0,0,NaN,NaN
ZCTA5 22214,0,0,0,NaN,NaN
ZCTA5 22807,0,0,0,NaN,NaN
ZCTA5 23160,0,0,0,NaN,NaN
ZCTA5 23173,0,0,0,NaN,NaN
ZCTA5 23187,0,0,0,NaN,NaN
ZCTA5 23250,0,0,0,NaN,NaN
ZCTA5 23460,0,0,0,NaN,NaN
ZCTA5 23551,0,0,0,NaN,NaN
ZCTA5 23709,0,0,0,NaN,NaN
ZCTA5 23806,0,0,0,NaN,NaN
ZCTA5 23891,0,0,0,NaN,NaN
ZCTA5 23909,0,0,0,NaN,NaN
ZCTA5 23461,0,0,0,NaN,NaN
ZCTA5 20510,0,0,0,NaN,NaN
ZCTA5 20520,0,0,0,NaN,NaN
ZCTA5 20535,0,0,0,NaN,NaN
ZCTA5 20540,0,0,0,NaN,NaN
ZCTA5 20551,0,0,0,NaN,NaN
ZCTA5 20553,0,0,0,NaN,NaN
ZCTA5 20560,0,0,0,NaN,NaN
ZCTA5 20565,0,0,0,NaN,NaN
ZCTA5 20566,0,0,0,NaN,NaN
ZCTA5 20593,0,0,0,NaN,NaN
ZCTA5 20742,0,0,0,NaN,NaN
ZCTA5 20319,0,0,0,NaN,NaN
ZCTA5 20701,0,0,0,NaN,NaN
ZCTA5 21902,0,0,0,NaN,NaN
ZCTA5 21031,0,0,0,NaN,NaN
ZCTA5 21240,0,0,0,NaN,NaN
ZCTA5 21250,0,0,0,NaN,NaN
ZCTA5 21251,0,0,0,NaN,NaN
ZCTA5 21252,0,0,0,NaN,NaN
ZCTA5 21746,0,0,0,NaN,NaN
ZCTA5 21705,0,0,0,NaN,NaN
ZCTA5 21802,0,0,0,NaN,NaN
ZCTA5 21890,0,0,0,NaN,NaN
ZCTA5 21916,0,0,0,NaN,NaN
ZCTA5 24316,0,0,0,NaN,NaN
ZCTA5 24142,0,0,0,NaN,NaN
ZCTA5 25112,0,0,0,NaN,NaN
ZCTA5 25185,0,0,0,NaN,NaN
ZCTA5 25305,0,0,0,NaN,NaN
ZCTA5 25002,0,0,0,NaN,NaN
ZCTA5 86052,0,0,0,NaN,NaN
ZCTA5 86433,0,0,0,NaN,NaN
ZCTA5 86028,0,0,0,NaN,NaN
ZCTA5 86313,0,0,0,NaN,NaN
ZCTA5 86443,0,0,0,NaN,NaN
ZCTA5 90822,0,0,0,NaN,NaN
ZCTA5 89191,0,0,0,NaN,NaN
ZCTA5 89420,0,0,0,NaN,NaN
ZCTA5 89826,0,0,0,NaN,NaN
ZCTA5 89831,0,0,0,NaN,NaN
ZCTA5 89022,0,0,0,NaN,NaN
ZCTA5 89026,0,0,0,NaN,NaN
ZCTA5 92364,0,0,0,NaN,NaN
ZCTA5 92132,0,0,0,NaN,NaN
ZCTA5 92134,0,0,0,NaN,NaN
ZCTA5 92135,0,0,0,NaN,NaN
ZCTA5 92140,0,0,0,NaN,NaN
ZCTA5 92147,0,0,0,NaN,NaN
ZCTA5 92155,0,0,0,NaN,NaN
ZCTA5 92222,0,0,0,NaN,NaN
ZCTA5 89446,0,0,0,NaN,NaN
ZCTA5 89702,0,0,0,NaN,NaN
ZCTA5 27110,0,0,0,NaN,NaN
ZCTA5 27531,0,0,0,NaN,NaN
ZCTA5 27109,0,0,0,NaN,NaN
ZCTA5 95250,0,0,0,NaN,NaN
ZCTA5 95431,0,0,0,NaN,NaN
ZCTA5 95364,0,0,0,NaN,NaN
ZCTA5 91608,0,0,0,NaN,NaN
ZCTA5 91330,0,0,0,NaN,NaN
ZCTA5 91371,0,0,0,NaN,NaN
ZCTA5 94128,0,0,0,NaN,NaN
ZCTA5 92338,0,0,0,NaN,NaN
ZCTA5 90263,0,0,0,NaN,NaN
ZCTA5 90071,0,0,0,NaN,NaN
ZCTA5 90073,0,0,0,NaN,NaN
ZCTA5 90079,0,0,0,NaN,NaN
ZCTA5 90090,0,0,0,NaN,NaN
ZCTA5 90095,0,0,0,NaN,NaN
ZCTA5 90506,0,0,0,NaN,NaN
ZCTA5 90747,0,0,0,NaN,NaN
ZCTA5 90831,0,0,0,NaN,NaN
ZCTA5 97752,0,0,0,NaN,NaN
ZCTA5 97208,0,0,0,NaN,NaN
ZCTA5 97373,0,0,0,NaN,NaN
ZCTA5 97384,0,0,0,NaN,NaN
ZCTA5 94575,0,0,0,NaN,NaN
ZCTA5 94850,0,0,0,NaN,NaN
ZCTA5 95211,0,0,0,NaN,NaN
ZCTA5 95314,0,0,0,NaN,NaN
ZCTA5 95375,0,0,0,NaN,NaN
ZCTA5 95724,0,0,0,NaN,NaN
ZCTA5 95915,0,0,0,NaN,NaN
ZCTA5 93262,0,0,0,NaN,NaN
ZCTA5 93042,0,0,0,NaN,NaN
ZCTA5 93064,0,0,0,NaN,NaN
ZCTA5 93410,0,0,0,NaN,NaN
ZCTA5 93524,0,0,0,NaN,NaN
ZCTA5 93633,0,0,0,NaN,NaN
ZCTA5 93943,0,0,0,NaN,NaN
ZCTA5 99034,0,0,0,NaN,NaN
ZCTA5 96863,0,0,0,NaN,NaN
ZCTA5 96155,0,0,0,NaN,NaN
ZCTA5 96850,0,0,0,NaN,NaN
ZCTA5 96853,0,0,0,NaN,NaN
ZCTA5 96857,0,0,0,NaN,NaN
ZCTA5 96859,0,0,0,NaN,NaN
ZCTA5 96860,0,0,0,NaN,NaN
ZCTA5 99695,0,0,0,NaN,NaN
ZCTA5 99704,0,0,0,NaN,NaN
ZCTA5 97331,0,0,0,NaN,NaN
ZCTA5 99903,0,0,0,NaN,NaN
ZCTA5 99513,0,0,0,NaN,NaN
ZCTA5 99164,0,0,0,NaN,NaN
ZCTA5 98559,0,0,0,NaN,NaN
ZCTA5 98562,0,0,0,NaN,NaN
ZCTA5 99510,0,0,0,NaN,NaN
ZCTA5 99519,0,0,0,NaN,NaN
ZCTA5 99734,0,0,0,NaN,NaN
ZCTA5 98421,0,0,0,NaN,NaN
ZCTA5 98158,0,0,0,NaN,NaN
ZCTA5 98195,0,0,0,NaN,NaN
ZCTA5 98207,0,0,0,NaN,NaN
ZCTA5 98278,0,0,0,NaN,NaN
ZCTA5 98416,0,0,0,NaN,NaN
ZCTA5 98430,0,0,0,NaN,NaN
ZCTA5 98447,0,0,0,NaN,NaN
ZCTA5 98929,0,0,0,NaN,NaN
ZCTA5 99020,0,0,0,NaN,NaN
ZCTA5 98154,0,0,0,NaN,NaN
ZCTA5 98238,0,0,0,NaN,NaN
ZCTA5 98174,0,0,0,NaN,NaN
